name,instance_name,primary_graph,secondary_graph,time_ns,primary_cost,secondary_cost,total_cost
EASolver,kroA100,13-2-45-28-33-82-54-11-26-85-34-19-56-6-8-86-50-60-24-80-68-72-49-43-1-53-39-63-67-84-38-29-95-77-51-4-36-32-75-12-94-81-47-99-70-40-42-61-59-76,58-73-20-71-9-83-35-37-23-17-78-52-87-15-21-93-69-65-64-3-96-55-79-30-88-41-7-91-0-62-5-48-89-18-74-25-98-16-14-10-31-90-97-22-44-46-92-27-66-57,4945054061,13124,14726,27850
EASolver,kroA100,57-27-92-66-0-62-5-48-89-9-83-71-20-73-58-16-14-10-31-90-97-22-44-46-91-7-41-88-30-79-55-96-74-18-52-78-17-23-37-35-98-93-21-15-87-69-65-64-3-25,82-54-33-28-45-2-42-13-70-40-99-47-51-77-95-4-36-32-75-12-94-81-49-43-72-67-84-38-29-8-6-56-86-50-60-24-80-68-63-39-53-1-19-11-26-85-34-61-59-76,2757853538,13603,12418,26021
EASolver,kroA100,24-80-60-50-86-8-6-56-19-11-26-85-34-61-59-76-22-97-90-44-31-10-14-16-73-20-58-71-9-83-35-37-23-17-78-52-87-15-21-93-69-65-64-3-96-55-79-30-88-41,32-75-12-94-81-49-43-72-67-84-38-29-95-77-51-4-36-47-99-70-40-13-2-45-28-33-82-54-42-68-63-39-53-1-66-27-92-57-0-62-5-48-89-18-74-91-7-46-98-25,2712609686,10338,20729,31067
EASolver,kroA100,33-82-54-11-26-85-34-19-56-6-8-86-50-60-24-80-68-72-49-43-1-53-39-63-67-84-38-29-95-77-51-4-36-32-75-12-94-81-47-99-70-40-13-2-45-28-42-61-59-76,78-52-87-15-21-93-69-65-64-3-96-55-79-30-88-41-7-91-0-62-5-48-89-9-83-71-20-73-58-16-14-10-31-90-97-22-44-46-92-27-66-57-74-18-17-23-37-35-98-25,2671608849,12395,14403,26798
EASolver,kroA100,24-80-60-50-86-8-6-56-19-11-26-85-34-61-59-76-22-97-90-44-31-10-14-16-73-20-58-71-9-83-35-37-23-17-78-52-87-15-21-93-69-65-64-3-96-55-79-30-88-41,82-54-33-28-45-2-42-13-70-40-99-47-51-77-95-4-36-32-75-12-94-81-49-43-72-67-84-38-29-68-63-39-53-1-66-27-92-57-0-62-5-48-89-18-74-91-7-46-98-25,2721793265,10338,19311,29649
EASolver,kroA100,24-80-60-50-86-8-6-56-19-11-26-85-34-61-59-76-22-97-90-44-31-10-14-16-73-20-58-71-9-83-35-37-23-17-78-52-87-15-21-93-69-65-64-3-96-55-79-30-88-41,70-40-99-47-13-2-45-28-33-82-54-42-29-38-95-77-51-4-36-32-75-12-94-81-49-43-72-67-84-68-63-39-53-1-66-27-92-57-0-62-5-48-89-18-74-91-7-46-98-25,3061887213,10338,20228,30566
EASolver,kroA100,63-39-53-1-43-49-72-67-84-38-29-95-77-51-4-36-32-75-12-94-81-68-80-24-60-50-86-8-6-56-19-11-26-85-34-61-59-76-22-97-90-44-31-10-14-16-73-20-58-71,46-62-5-48-89-9-83-35-37-23-17-78-52-87-15-21-93-69-65-64-3-96-55-79-30-88-41-7-91-0-92-27-66-57-54-82-33-28-45-2-42-13-70-40-99-47-74-18-25-98,3342758896,11808,17506,29314
EASolver,kroA100,54-82-33-28-45-2-42-13-70-40-99-47-51-77-95-4-36-32-75-12-94-81-49-43-72-67-84-38-29-8-6-56-86-50-60-24-80-68-63-39-53-1-66-27-92-57-76-59-61-85,35-37-23-17-78-52-87-15-21-93-69-65-64-3-96-55-79-30-88-41-7-91-0-62-5-48-89-9-83-71-20-73-58-16-14-10-31-90-97-22-44-46-74-18-25-98-34-26-11-19,3105644004,12291,16755,29046
EASolver,kroA100,33-82-54-11-26-85-34-19-56-6-8-86-50-60-24-80-68-72-49-43-1-53-39-63-67-84-38-29-95-77-51-4-36-32-75-12-94-81-47-99-70-40-13-2-45-28-42-61-59-76,69-21-15-87-93-17-23-37-35-98-83-9-71-20-73-58-16-14-10-31-90-97-22-44-46-62-5-48-89-78-52-18-74-96-55-79-30-88-41-7-91-0-92-27-66-57-3-64-65-25,3094862857,12395,12781,25176
EASolver,kroA100,26-85-34-19-11-6-8-56-86-50-60-24-80-68-72-49-43-1-53-39-63-67-84-38-29-95-77-51-4-36-32-75-12-94-81-47-99-70-40-13-2-45-28-33-82-54-42-61-59-76,83-9-71-20-73-58-16-14-10-31-90-97-22-44-46-62-5-48-89-78-52-87-15-21-93-69-65-64-3-96-55-79-30-88-41-7-91-0-92-27-66-57-74-18-17-23-37-35-98-25,3548174187,12340,14821,27161
EASolver,kroA100,7-91-0-62-5-48-89-9-83-71-20-73-58-16-14-10-31-90-97-22-44-46-92-27-66-57-60-24-80-68-72-49-43-1-53-39-63-67-84-38-29-95-77-51-4-36-32-75-12-94,78-52-87-15-21-93-69-65-64-3-96-55-79-30-88-41-74-18-17-23-37-35-98-25-76-59-61-85-26-11-19-56-6-8-86-50-54-82-33-28-45-2-42-13-70-40-99-47-81-34,3059404691,12977,19705,32682
EASolver,kroA100,7-91-0-62-5-48-89-9-83-71-20-73-58-16-14-10-31-90-97-22-44-46-92-27-66-57-60-24-80-68-72-49-43-1-53-39-63-67-84-38-29-95-77-51-4-36-32-75-12-94,74-18-52-78-17-23-37-35-98-93-21-15-87-69-65-64-3-96-55-79-30-88-41-25-76-59-61-85-26-11-19-56-6-8-86-50-54-82-33-28-45-2-42-13-70-40-99-47-81-34,2832552548,12977,18728,31705
EASolver,kroA100,84-67-72-49-43-1-53-39-63-68-80-24-60-50-86-8-6-56-19-11-26-85-34-61-59-76-22-97-90-44-31-10-14-16-73-20-58-71-9-83-35-37-23-17-78-52-87-15-21-93,82-54-33-28-45-2-42-13-70-40-99-47-51-77-95-4-36-32-75-12-94-81-38-29-57-27-92-66-0-62-5-48-89-18-74-96-55-79-30-88-41-7-91-46-98-69-65-64-3-25,2703141944,11855,18017,29872
EASolver,kroA100,1-43-49-72-67-84-38-29-95-77-51-4-36-32-75-12-94-81-63-39-53-68-80-24-60-50-86-8-6-56-19-11-26-85-34-61-59-76-22-97-90-44-31-10-14-16-73-20-58-71,25-64-65-3-96-55-79-30-88-41-7-91-0-62-5-48-89-9-83-35-37-23-17-78-52-87-15-21-93-69-18-74-46-92-27-66-57-54-82-33-28-45-2-42-13-70-40-99-47-98,2767451617,12161,17509,29670
EASolver,kroA100,39-63-53-1-43-49-72-67-84-38-29-95-77-51-4-36-32-75-12-94-81-68-80-24-60-50-86-8-6-56-19-11-26-85-34-61-59-76-22-97-90-44-31-10-14-16-73-20-58-71,23-37-35-98-17-78-52-87-15-21-93-69-65-64-3-96-55-79-30-88-41-7-91-0-62-5-48-89-9-83-18-74-25-46-92-27-66-57-54-82-33-28-45-2-42-13-70-40-99-47,2629930925,11889,17923,29812
EASolver,kroA100,44-90-97-22-59-61-76-19-11-26-85-34-56-6-8-86-50-60-24-80-68-72-49-43-1-53-39-63-67-84-38-29-95-77-51-4-36-32-75-12-94-81-47-99-70-40-13-2-45-28,73-20-58-71-9-83-35-37-23-17-78-52-87-15-21-93-69-65-64-3-96-55-79-30-88-41-7-91-0-62-5-48-89-18-74-25-98-16-14-10-31-46-92-27-66-57-54-82-33-42,2604269935,12696,16864,29560
EASolver,kroA100,6-8-56-86-50-60-24-80-68-72-49-43-1-53-39-63-67-84-38-29-95-77-51-4-36-32-75-12-94-81-47-99-70-40-13-2-45-28-33-82-54-11-26-85-34-19-61-59-76-22,20-73-58-71-9-83-35-37-23-17-78-52-87-15-21-93-69-65-64-3-96-55-79-30-88-41-7-91-0-62-5-48-89-18-74-25-98-16-14-10-31-90-97-44-46-92-27-66-57-42,2675861809,11735,17379,29114
EASolver,kroA100,43-49-72-67-84-38-29-95-77-51-4-36-32-75-12-94-81-1-53-39-63-68-80-24-60-50-86-8-6-56-19-11-26-85-34-61-59-76-22-97-90-44-31-10-14-16-73-20-58-71,78-52-87-15-21-93-69-65-64-3-96-55-79-30-88-41-7-91-0-62-5-48-89-9-83-35-37-23-17-98-18-74-25-46-92-27-66-57-54-82-33-28-45-2-42-13-70-40-99-47,2785816709,11732,18300,30032
EASolver,kroA100,63-39-53-1-43-49-72-67-84-38-29-95-77-51-4-36-32-75-12-94-81-68-80-24-60-50-86-8-6-56-19-11-26-85-34-61-59-76-22-97-90-44-31-10-14-16-73-20-58-71,46-62-5-48-89-9-83-35-37-23-17-78-52-87-15-21-93-69-65-64-3-96-55-79-30-88-41-7-91-0-92-27-66-57-54-82-33-28-45-2-42-13-70-40-99-47-74-18-25-98,2987582536,11808,17506,29314
EASolver,kroA100,73-20-58-71-9-83-35-37-23-17-78-52-87-15-21-93-69-65-64-3-96-55-79-30-88-41-7-91-0-62-5-48-89-18-74-25-98-16-14-10-31-90-97-22-44-46-92-27-66-57,81-94-12-32-75-36-4-77-51-95-38-29-47-99-70-40-13-2-45-28-33-82-54-11-26-85-34-19-56-6-8-86-50-60-24-80-68-72-49-43-1-53-39-63-67-84-42-61-59-76,3246244306,14846,13252,28098
EASolver,kroA100,49-43-72-67-84-38-29-95-77-51-4-36-32-75-12-94-81-1-53-39-63-68-80-24-60-50-86-8-6-56-19-11-26-85-34-61-59-76-22-97-90-44-31-10-14-16-73-20-58-71,78-52-87-15-21-93-69-65-64-3-96-55-79-30-88-41-7-91-0-62-5-48-89-9-83-35-37-23-17-98-18-74-25-46-92-27-66-57-54-82-33-28-45-2-42-13-70-40-99-47,5668940689,11794,18300,30094
EASolver,kroA100,24-80-60-50-86-8-6-56-19-11-26-85-34-61-59-76-22-97-90-44-31-10-14-16-73-20-58-71-9-83-35-37-23-17-78-52-87-15-21-93-69-65-64-3-96-55-79-30-88-41,72-49-43-1-53-39-63-68-67-84-38-29-95-77-51-4-36-32-75-12-94-81-47-99-70-40-13-2-45-28-33-82-54-42-57-27-92-66-0-62-5-48-89-18-74-91-7-46-98-25,4066154971,10338,19454,29792
EASolver,kroA100,54-82-33-28-45-2-42-13-70-40-99-47-51-77-95-4-36-32-75-12-94-81-49-43-72-67-84-38-29-8-6-56-86-50-60-24-80-68-63-39-53-1-66-27-92-57-76-59-61-85,35-37-23-17-78-52-87-15-21-93-69-65-64-3-96-55-79-30-88-41-7-91-0-62-5-48-89-9-83-71-20-73-58-16-14-10-31-90-97-22-44-46-74-18-25-98-34-26-11-19,4236564526,12291,16755,29046
EASolver,kroA100,5-48-62-0-91-7-41-88-30-79-55-96-74-18-52-78-17-23-37-35-98-83-9-71-20-73-58-16-14-10-31-90-97-22-44-46-92-27-66-57-60-24-80-68-72-49-43-1-53-39,42-2-45-28-13-70-40-99-47-51-77-95-4-36-32-75-12-94-81-38-29-84-67-63-50-86-8-6-56-19-11-26-85-34-61-59-76-54-82-33-89-87-15-21-93-69-65-64-3-25,3728690008,12527,17685,30212
EASolver,kroA100,26-85-34-19-11-6-8-56-86-50-60-24-80-68-72-49-43-1-53-39-63-67-84-38-29-95-77-51-4-36-32-75-12-94-81-47-99-70-40-13-2-45-28-33-82-54-42-61-59-76,73-20-58-71-9-83-35-37-23-17-78-52-87-15-21-93-69-65-64-3-96-55-79-30-88-41-7-91-0-62-5-48-89-18-74-25-98-16-14-10-31-90-97-22-44-46-92-27-66-57,3158694470,12340,14846,27186
EASolver,kroA100,79-30-88-41-7-91-0-62-5-48-89-9-83-71-20-73-58-16-14-10-31-90-97-22-44-46-92-27-66-57-60-24-80-68-72-49-43-1-53-39-63-67-84-38-29-95-77-51-4-36,74-18-52-78-17-23-37-35-98-93-21-15-87-69-65-64-3-96-55-25-76-59-61-85-26-11-19-56-6-8-86-50-54-82-33-28-45-2-42-13-70-40-99-47-32-75-12-94-81-34,3061001447,13201,18154,31355
EASolver,kroA100,80-24-60-50-86-8-6-56-19-11-26-85-34-61-59-76-22-97-90-44-31-10-14-16-73-20-58-71-9-83-35-37-23-17-78-52-87-15-21-93-69-65-64-3-96-55-79-30-88-41,42-2-45-28-13-70-40-99-47-51-77-95-4-36-32-75-12-94-81-49-43-72-67-84-38-29-33-82-54-57-27-92-66-0-62-5-48-89-18-74-91-7-46-98-25-53-39-63-68-1,3866124904,10298,19565,29863
EASolver,kroA100,33-82-54-11-26-85-34-19-56-6-8-86-50-60-24-80-68-72-49-43-1-53-39-63-67-84-38-29-95-77-51-4-36-32-75-12-94-81-47-99-70-40-13-2-45-28-42-61-59-76,78-52-87-15-21-93-69-65-64-3-96-55-79-30-88-41-7-91-0-62-5-48-89-9-83-71-20-73-58-16-14-10-31-90-97-22-44-46-92-27-66-57-74-18-17-23-37-35-98-25,3644751854,12395,14403,26798
EASolver,kroA100,13-2-45-28-33-82-54-11-26-85-34-19-56-6-8-86-50-60-24-80-68-72-49-43-1-53-39-63-67-84-38-29-95-77-51-4-36-32-75-12-94-81-47-99-70-40-42-61-59-76,20-73-58-71-9-83-35-37-23-17-78-52-87-15-21-93-69-65-64-3-96-55-79-30-88-41-7-91-0-62-5-48-89-18-74-25-98-16-14-10-31-90-97-22-44-46-92-27-66-57,3093655685,13124,14749,27873
EASolver,kroA100,27-92-57-60-24-80-68-72-49-43-1-53-39-63-67-84-38-29-95-77-51-4-36-32-75-12-94-81-47-99-70-40-13-2-45-28-33-82-54-11-26-85-34-19-56-6-8-86-50-76,88-41-30-79-55-96-74-18-52-78-17-23-37-35-98-83-9-71-20-73-58-16-14-10-31-90-97-22-44-46-62-5-48-89-91-7-0-66-59-61-42-3-64-65-25-69-21-15-87-93,3417778659,11737,17927,29664
EASolver,kroA100,44-90-97-22-59-61-76-19-11-26-85-34-56-6-8-86-50-60-24-80-68-72-49-43-1-53-39-63-67-84-38-29-95-77-51-4-36-32-75-12-94-81-47-99-70-40-13-2-45-28,58-73-20-71-9-83-35-37-23-17-78-52-87-15-21-93-69-65-64-3-96-55-79-30-88-41-7-91-0-62-5-48-89-18-74-25-98-16-14-10-31-46-92-27-66-57-54-82-33-42,5270881557,12696,16704,29400
EASolver,kroA100,14-16-10-31-90-97-22-44-46-62-5-48-89-9-83-71-20-73-58-35-37-23-17-78-52-87-15-21-93-69-65-64-3-96-55-79-30-88-41-7-91-0-92-27-66-57-60-24-80-68,42-2-45-28-13-70-40-99-47-51-77-95-4-36-32-75-12-94-81-49-43-72-67-84-38-29-33-82-54-11-26-85-34-19-56-6-8-86-50-76-59-61-63-39-53-1-74-18-25-98,7130623945,12142,18814,30956
EASolver,kroA100,13-2-45-28-33-82-54-11-26-85-34-19-56-6-8-86-50-60-24-80-68-72-49-43-1-53-39-63-67-84-38-29-95-77-51-4-36-32-75-12-94-81-47-99-70-40-42-61-59-76,35-37-23-17-78-52-87-15-21-93-69-65-64-3-96-55-79-30-88-41-7-91-0-62-5-48-89-9-83-71-20-73-58-16-14-10-31-90-97-22-44-46-92-27-66-57-74-18-25-98,3361785445,13124,13699,26823
EASolver,kroA100,36-4-77-51-95-38-29-47-99-70-40-13-2-45-28-33-82-54-11-26-85-34-19-56-6-8-86-50-60-24-80-68-72-49-43-1-53-39-63-67-84-81-94-12-32-75-42-61-59-76,20-73-58-71-9-83-35-37-23-17-78-52-87-15-21-93-69-65-64-3-96-55-79-30-88-41-7-91-0-62-5-48-89-18-74-25-98-16-14-10-31-90-97-22-44-46-92-27-66-57,3954677325,14394,14749,29143
EASolver,kroA100,43-49-72-67-84-38-29-95-77-51-4-36-32-75-12-94-81-1-53-39-63-68-80-24-60-50-86-8-6-56-19-11-26-85-34-61-59-76-22-97-90-44-31-10-14-16-73-20-58-71,62-5-48-89-9-83-35-37-23-17-78-52-87-15-21-93-69-65-64-3-96-55-79-30-88-41-7-91-0-92-27-66-57-46-74-18-25-98-54-82-33-28-45-2-42-13-70-40-99-47,4407593746,11732,18893,30625
EASolver,kroA100,33-82-54-11-26-85-34-19-56-6-8-86-50-60-24-80-68-72-49-43-1-53-39-63-67-84-38-29-95-77-51-4-36-32-75-12-94-81-47-99-70-40-13-2-45-28-42-61-59-76,73-20-58-71-9-83-35-37-23-17-78-52-87-15-21-93-69-65-64-3-96-55-79-30-88-41-7-91-0-62-5-48-89-18-74-25-98-16-14-10-31-90-97-22-44-46-92-27-66-57,4007155491,12395,14846,27241
EASolver,kroA100,82-54-33-28-45-2-42-13-70-40-99-47-51-77-95-4-36-32-75-12-94-81-49-43-72-67-84-38-29-8-6-56-86-50-60-24-80-68-63-39-53-1-66-27-92-57-76-59-61-85,35-37-23-17-78-52-87-15-21-93-69-65-64-3-96-55-79-30-88-41-7-91-0-62-5-48-89-9-83-71-20-73-58-16-14-10-31-90-97-22-44-46-74-18-25-98-34-26-11-19,3500735295,12337,16755,29092
EASolver,kroA100,23-37-35-98-17-78-52-87-15-21-93-69-65-64-3-96-55-79-30-88-41-7-91-0-62-5-48-89-9-83-71-20-73-58-16-14-10-31-90-97-22-44-46-92-27-66-57-60-24-80,54-82-33-28-45-2-42-13-70-40-99-47-51-77-95-4-36-32-75-12-94-81-49-43-72-67-84-38-29-8-6-56-86-50-19-11-26-85-34-61-59-76-68-63-39-53-1-74-18-25,3833169536,12905,17185,30090
EASolver,kroA100,44-90-97-22-59-61-76-19-11-26-85-34-56-6-8-86-50-60-24-80-68-72-49-43-1-53-39-63-67-84-38-29-95-77-51-4-36-32-75-12-94-81-47-99-70-40-13-2-45-28,73-20-58-71-9-83-35-37-23-17-78-52-87-15-21-93-69-65-64-3-96-55-79-30-88-41-7-91-0-62-5-48-89-18-74-25-98-16-14-10-31-46-92-27-66-57-54-82-33-42,3404563983,12696,16864,29560
EASolver,kroA100,36-4-77-51-95-38-29-47-99-70-40-13-2-45-28-33-82-54-11-26-85-34-19-56-6-8-86-50-60-24-80-68-72-49-43-1-53-39-63-67-84-81-94-12-32-75-42-61-59-76,69-21-15-87-93-17-23-37-35-98-83-9-71-20-73-58-16-14-10-31-90-97-22-44-46-62-5-48-89-78-52-18-74-96-55-79-30-88-41-7-91-0-92-27-66-57-3-64-65-25,6117165242,14394,12781,27175
EASolver,kroA100,33-82-54-11-26-85-34-19-56-6-8-86-50-60-24-80-68-72-49-43-1-53-39-63-67-84-38-29-95-77-51-4-36-32-75-12-94-81-47-99-70-40-13-2-45-28-42-61-59-76,23-37-35-98-17-78-52-87-15-21-93-69-65-64-3-96-55-79-30-88-41-7-91-0-62-5-48-89-9-83-71-20-73-58-16-14-10-31-90-97-22-44-46-92-27-66-57-74-18-25,3802040118,12395,13704,26099
EASolver,kroA100,1-43-49-72-67-84-38-29-95-77-51-4-36-32-75-12-94-81-63-39-53-68-80-24-60-50-86-8-6-56-19-11-26-85-34-61-59-76-22-97-90-44-31-10-14-16-73-20-58-71,9-83-35-37-23-17-78-52-87-15-21-93-69-65-64-3-96-55-79-30-88-41-7-91-0-62-5-48-89-18-74-25-98-46-92-27-66-57-54-82-33-28-45-2-42-13-70-40-99-47,3543972158,12161,17701,29862
EASolver,kroA100,26-85-34-19-11-6-8-56-86-50-60-24-80-68-72-49-43-1-53-39-63-67-84-38-29-95-77-51-4-36-32-75-12-94-81-47-99-70-40-13-2-45-28-33-82-54-42-61-59-76,93-21-15-87-52-78-17-23-37-35-98-83-9-71-20-73-58-16-14-10-31-90-97-22-44-46-62-5-48-89-18-74-96-55-79-30-88-41-7-91-0-92-27-66-57-3-64-65-25-69,3446610902,12340,12730,25070
EASolver,kroA100,76-59-61-85-26-11-19-56-6-8-86-50-60-24-80-68-72-49-43-1-53-39-63-67-84-38-29-95-77-51-4-36-32-75-12-94-81-47-99-70-40-13-2-45-28-33-82-54-34-22,35-37-23-17-78-52-87-15-21-93-69-65-64-3-96-55-79-30-88-41-7-91-0-62-5-48-89-9-83-71-20-73-58-16-14-10-31-90-97-44-46-92-27-66-57-74-18-25-98-42,3539839224,11786,19521,31307
EASolver,kroA100,33-82-54-11-26-85-34-19-56-6-8-86-50-60-24-80-68-72-49-43-1-53-39-63-67-84-38-29-95-77-51-4-36-32-75-12-94-81-47-99-70-40-13-2-45-28-42-61-59-76,17-23-37-35-98-83-9-71-20-73-58-16-14-10-31-90-97-22-44-46-62-5-48-89-78-52-87-15-21-93-69-65-64-3-96-55-79-30-88-41-7-91-0-92-27-66-57-74-18-25,3571169182,12395,13528,25923
EASolver,kroA100,81-94-12-32-75-36-4-77-51-95-38-29-47-99-70-40-13-2-45-28-33-82-54-11-26-85-34-19-56-6-8-86-50-60-24-80-68-72-49-43-1-53-39-63-67-84-42-61-59-76,73-20-58-71-9-83-35-37-23-17-78-52-87-15-21-93-69-65-64-3-96-55-79-30-88-41-7-91-0-62-5-48-89-18-74-25-98-16-14-10-31-90-97-22-44-46-92-27-66-57,3379714330,13252,14846,28098
EASolver,kroA100,13-2-45-28-33-82-54-11-26-85-34-19-56-6-8-86-50-60-24-80-68-72-49-43-1-53-39-63-67-84-38-29-95-77-51-4-36-32-75-12-94-81-47-99-70-40-42-61-59-76,73-20-58-71-9-83-35-37-23-17-78-52-87-15-21-93-69-65-64-3-96-55-79-30-88-41-7-91-0-62-5-48-89-18-74-25-98-16-14-10-31-90-97-22-44-46-92-27-66-57,3399494924,13124,14846,27970
EASolver,kroA100,12-32-75-94-81-49-43-72-67-84-38-29-95-77-51-4-36-47-99-70-40-13-2-45-28-33-82-54-11-26-85-34-19-56-6-8-86-50-60-24-80-68-63-39-53-1-66-27-92-57,78-52-87-15-21-93-69-65-64-3-96-55-79-30-88-41-7-91-0-62-5-48-89-9-83-71-20-73-58-16-14-10-31-90-97-22-44-46-76-59-61-42-74-18-17-23-37-35-98-25,4230291901,12651,17065,29716
EASolver,kroA100,43-49-72-67-84-38-29-95-77-51-4-36-32-75-12-94-81-1-53-39-63-68-80-24-60-50-86-8-6-56-19-11-26-85-34-61-59-76-22-97-90-44-31-10-14-16-73-20-58-71,98-35-37-23-17-78-52-87-15-21-93-69-65-64-3-96-55-79-30-88-41-7-91-0-62-5-48-89-9-83-18-74-25-46-92-27-66-57-54-82-33-28-45-2-42-13-70-40-99-47,3563295556,11732,17639,29371
EASolver,kroA100,5-48-62-0-91-7-41-88-30-79-55-96-74-18-52-78-17-23-37-35-98-83-9-71-20-73-58-16-14-10-31-90-97-22-44-46-92-27-66-57-60-24-80-68-72-49-43-1-53-39,45-2-42-28-13-70-40-99-47-51-77-95-4-36-32-75-12-94-81-38-29-84-67-63-50-86-8-6-56-19-11-26-85-34-61-59-76-54-82-33-89-87-15-21-93-69-65-64-3-25,3406837480,12527,17723,30250
EASolver,kroA100,16-14-10-31-90-97-22-44-46-62-5-48-89-9-83-71-20-73-58-35-37-23-17-78-52-87-15-21-93-69-65-64-3-96-55-79-30-88-41-7-91-0-92-27-66-57-60-24-80-68,54-82-33-28-45-2-42-13-70-40-99-47-51-77-95-4-36-32-75-12-94-81-49-43-72-67-84-38-29-8-6-56-86-50-19-11-26-85-34-61-59-76-63-39-53-1-74-18-25-98,5125450307,12150,18517,30667
EASolver,kroA100,84-67-72-49-43-1-53-39-63-68-80-24-60-50-86-8-6-56-19-11-26-85-34-61-59-76-22-97-90-44-31-10-14-16-73-20-58-71-9-83-35-37-23-17-78-52-87-15-21-93,42-2-45-28-13-70-40-99-47-51-77-95-4-36-32-75-12-94-81-38-29-33-82-54-57-27-92-66-0-62-5-48-89-18-74-96-55-79-30-88-41-7-91-46-98-69-65-64-3-25,5703009414,11855,18411,30266
EASolver,kroA100,76-59-61-85-26-11-19-56-6-8-86-50-60-24-80-68-72-49-43-1-53-39-63-67-84-38-29-95-77-51-4-36-32-75-12-94-81-47-99-70-40-13-2-45-28-33-82-54-34-22,23-37-35-98-17-78-52-87-15-21-93-69-65-64-3-96-55-79-30-88-41-7-91-0-62-5-48-89-9-83-71-20-73-58-16-14-10-31-90-97-44-46-92-27-66-57-74-18-25-42,5776071033,11786,19124,30910
EASolver,kroA100,97-90-44-22-59-61-76-19-11-26-85-34-56-6-8-86-50-60-24-80-68-72-49-43-1-53-39-63-67-84-38-29-95-77-51-4-36-32-75-12-94-81-47-99-70-40-13-2-45-28,5-48-62-0-91-7-41-88-30-79-55-96-74-18-52-78-17-23-37-35-98-83-9-71-20-73-58-16-14-10-31-46-92-27-66-57-54-82-33-42-89-87-15-21-93-69-65-64-3-25,4118530583,12681,15850,28531
EASolver,kroA100,7-91-0-62-5-48-89-9-83-71-20-73-58-16-14-10-31-90-97-22-44-46-92-27-66-57-60-24-80-68-72-49-43-1-53-39-63-67-84-38-29-95-77-51-4-36-32-75-12-94,41-88-30-79-55-96-74-18-52-78-17-23-37-35-98-93-21-15-87-69-65-64-3-25-76-59-61-85-26-11-19-56-6-8-86-50-54-82-33-28-45-2-42-13-70-40-99-47-81-34,5974363099,12977,17789,30766
EASolver,kroA100,11-26-85-34-19-56-6-8-86-50-60-24-80-68-72-49-43-1-53-39-63-67-84-38-29-95-77-51-4-36-32-75-12-94-81-47-99-70-40-13-2-45-28-33-82-54-42-61-59-76,23-37-35-98-17-78-52-87-15-21-93-69-65-64-3-96-55-79-30-88-41-7-91-0-62-5-48-89-9-83-71-20-73-58-16-14-10-31-90-97-22-44-46-92-27-66-57-74-18-25,3831098896,12315,13704,26019
EASolver,kroA100,18-74-96-55-79-30-88-41-7-91-0-62-5-48-89-9-83-71-20-73-58-16-14-10-31-90-97-22-44-46-92-27-66-57-60-24-80-68-72-49-43-1-53-39-63-67-84-38-29-95,94-12-32-75-81-36-4-77-51-47-99-70-40-13-2-45-28-33-82-54-11-26-85-34-19-56-6-8-86-50-76-59-61-42-35-37-23-17-78-52-87-15-21-93-69-65-64-3-25-98,3046437699,14142,19144,33286
EASolver,kroA100,49-43-72-67-84-38-29-95-77-51-4-36-32-75-12-94-81-1-53-39-63-68-80-24-60-50-86-8-6-56-19-11-26-85-34-61-59-76-22-97-90-44-31-10-14-16-73-20-58-71,7-91-0-62-5-48-89-9-83-35-37-23-17-78-52-87-15-21-93-69-65-64-3-96-55-79-30-88-41-74-18-25-98-46-92-27-66-57-54-82-33-28-45-2-42-13-70-40-99-47,3203664854,11794,17429,29223
EASolver,kroA100,84-67-72-49-43-1-53-39-63-68-80-24-60-50-86-8-6-56-19-11-26-85-34-61-59-76-22-97-90-44-31-10-14-16-73-20-58-71-9-83-35-37-23-17-78-52-87-15-21-93,99-70-40-13-2-45-28-33-82-54-42-47-51-77-95-4-36-32-75-12-94-81-38-29-57-27-92-66-0-62-5-48-89-18-74-96-55-79-30-88-41-7-91-46-98-69-65-64-3-25,3184528771,11855,19506,31361
EASolver,kroA100,79-30-88-41-7-91-0-62-5-48-89-9-83-71-20-73-58-16-14-10-31-90-97-22-44-46-92-27-66-57-60-24-80-68-72-49-43-1-53-39-63-67-84-38-29-95-77-51-4-36,74-18-52-78-17-23-37-35-98-93-21-15-87-69-65-64-3-96-55-25-76-59-61-85-26-11-19-56-6-8-86-50-54-82-33-28-45-2-42-13-70-40-99-47-32-75-12-94-81-34,2783415497,13201,18154,31355
EASolver,kroA100,5-48-62-0-91-7-41-88-30-79-55-96-74-18-52-78-17-23-37-35-98-83-9-71-20-73-58-16-14-10-31-90-97-22-44-46-92-27-66-57-60-24-80-68-72-49-43-1-53-39,82-54-33-28-45-2-42-13-70-40-99-47-51-77-95-4-36-32-75-12-94-81-38-29-84-67-63-50-86-8-6-56-19-11-26-85-34-61-59-76-89-87-15-21-93-69-65-64-3-25,3059186135,12527,15944,28471
EASolver,kroA100,0-62-5-48-89-9-83-71-20-73-58-16-14-10-31-90-97-22-44-46-92-27-66-57-60-24-80-68-72-49-43-1-53-39-63-67-84-38-29-95-77-51-4-36-32-75-12-94-81-47,88-41-30-79-55-96-74-18-52-78-17-23-37-35-98-93-21-15-87-69-65-64-3-25-7-91-76-59-61-85-26-11-19-56-6-8-86-50-54-82-33-28-45-2-42-13-70-40-99-34,4625654418,14094,16015,30109
EASolver,kroA100,26-85-34-19-11-6-8-56-86-50-60-24-80-68-72-49-43-1-53-39-63-67-84-38-29-95-77-51-4-36-32-75-12-94-81-47-99-70-40-13-2-45-28-33-82-54-42-61-59-76,83-9-71-20-73-58-16-14-10-31-90-97-22-44-46-62-5-48-89-78-52-87-15-21-93-69-65-64-3-96-55-79-30-88-41-7-91-0-92-27-66-57-74-18-17-23-37-35-98-25,3407052386,12340,14821,27161
EASolver,kroA100,0-62-5-48-89-9-83-71-20-73-58-16-14-10-31-90-97-22-44-46-92-27-66-57-60-24-80-68-72-49-43-1-53-39-63-67-84-38-29-95-77-51-4-36-32-75-12-94-81-47,79-30-88-41-7-91-74-18-52-78-17-23-37-35-98-93-21-15-87-69-65-64-3-96-55-25-76-59-61-85-26-11-19-56-6-8-86-50-54-82-33-28-45-2-42-13-70-40-99-34,3659951666,14094,16947,31041
EASolver,kroA100,65-64-3-96-55-79-30-88-41-7-91-0-62-5-48-89-9-83-71-20-73-58-16-14-10-31-90-97-22-44-46-92-27-66-57-60-24-80-68-72-49-43-1-53-39-63-67-84-38-29,28-45-2-42-13-70-40-99-47-51-77-95-4-36-32-75-12-94-81-50-86-8-6-56-19-11-26-85-34-61-59-76-54-82-33-74-18-52-78-17-23-37-35-98-93-21-15-87-69-25,4495401887,14159,17485,31644
EASolver,kroA100,76-59-61-85-26-11-19-56-6-8-86-50-60-24-80-68-72-49-43-1-53-39-63-67-84-38-29-95-77-51-4-36-32-75-12-94-81-47-99-70-40-13-2-45-28-33-82-54-34-22,73-20-58-71-9-83-35-37-23-17-78-52-87-15-21-93-69-65-64-3-96-55-79-30-88-41-7-91-0-62-5-48-89-18-74-25-98-16-14-10-31-90-97-44-46-92-27-66-57-42,3091575812,11786,17438,29224
EASolver,kroA100,24-80-60-50-86-8-6-56-19-11-26-85-34-61-59-76-22-97-90-44-31-10-14-16-73-20-58-71-9-83-35-37-23-17-78-52-87-15-21-93-69-65-64-3-96-55-79-30-88-41,2-45-28-13-70-40-99-47-51-77-95-4-36-32-75-12-94-81-49-43-72-67-84-38-29-33-82-54-42-68-63-39-53-1-66-27-92-57-0-62-5-48-89-18-74-91-7-46-98-25,5133791929,10338,20870,31208
EASolver,kroA100,27-92-57-60-24-80-68-72-49-43-1-53-39-63-67-84-38-29-95-77-51-4-36-32-75-12-94-81-47-99-70-40-13-2-45-28-33-82-54-11-26-85-34-19-56-6-8-86-50-76,37-23-17-78-52-87-15-21-93-69-65-64-3-96-55-79-30-88-41-7-91-0-62-5-48-89-9-83-71-20-73-58-16-14-10-31-90-97-22-44-46-66-74-18-25-35-98-59-61-42,5218021631,11737,19172,30909
EASolver,kroA100,10-14-16-31-90-97-22-44-46-62-5-48-89-9-83-71-20-73-58-35-37-23-17-78-52-87-15-21-93-69-65-64-3-96-55-79-30-88-41-7-91-0-92-27-66-57-60-24-80-68,28-45-2-42-13-70-40-99-47-51-77-95-4-36-32-75-12-94-81-49-43-72-67-84-38-29-33-82-54-11-26-85-34-19-56-6-8-86-50-76-59-61-63-39-53-1-74-18-25-98,4055689245,12146,18844,30990
EASolver,kroA100,49-43-72-67-84-38-29-95-77-51-4-36-32-75-12-94-81-1-53-39-63-68-80-24-60-50-86-8-6-56-19-11-26-85-34-61-59-76-22-97-90-44-31-10-14-16-73-20-58-71,62-5-48-89-9-83-35-37-23-17-78-52-87-15-21-93-69-65-64-3-96-55-79-30-88-41-7-91-0-92-27-66-57-46-74-18-25-98-54-82-33-28-45-2-42-13-70-40-99-47,3715476725,11794,18893,30687
EASolver,kroA100,84-67-72-49-43-1-53-39-63-68-80-24-60-50-86-8-6-56-19-11-26-85-34-61-59-76-22-97-90-44-31-10-14-16-73-20-58-71-9-83-35-37-23-17-78-52-87-15-21-93,28-45-2-42-13-70-40-99-47-51-77-95-4-36-32-75-12-94-81-38-29-33-82-54-57-27-92-66-0-62-5-48-89-18-74-96-55-79-30-88-41-7-91-46-98-69-65-64-3-25,3173027287,11855,18283,30138
EASolver,kroA100,43-49-72-67-84-38-29-95-77-51-4-36-32-75-12-94-81-1-53-39-63-68-80-24-60-50-86-8-6-56-19-11-26-85-34-61-59-76-22-97-90-44-31-10-14-16-73-20-58-71,15-87-21-93-69-52-78-17-23-37-35-98-83-9-89-48-5-62-0-91-7-41-88-30-79-55-96-74-18-3-64-65-25-46-92-27-66-57-54-82-33-28-45-2-42-13-70-40-99-47,3554881242,11732,17116,28848
EASolver,kroA100,84-67-72-49-43-1-53-39-63-68-80-24-60-50-86-8-6-56-19-11-26-85-34-61-59-76-22-97-90-44-31-10-14-16-73-20-58-71-9-83-35-37-23-17-78-52-87-15-21-93,28-45-2-42-13-70-40-99-47-51-77-95-4-36-32-75-12-94-81-38-29-33-82-54-57-27-92-66-0-62-5-48-89-18-74-96-55-79-30-88-41-7-91-46-98-69-65-64-3-25,4685697149,11855,18283,30138
EASolver,kroA100,80-24-60-50-86-8-6-56-19-11-26-85-34-61-59-76-22-97-90-44-31-10-14-16-73-20-58-71-9-83-35-37-23-17-78-52-87-15-21-93-69-65-64-3-96-55-79-30-88-41,81-94-12-32-75-36-4-77-51-95-38-29-47-99-70-40-13-2-45-28-33-82-54-42-84-67-72-49-43-1-53-39-63-68-57-27-92-66-0-62-5-48-89-18-74-91-7-46-98-25,3204735507,10298,18658,28956
EASolver,kroA100,27-92-57-60-24-80-68-72-49-43-1-53-39-63-67-84-38-29-95-77-51-4-36-32-75-12-94-81-47-99-70-40-13-2-45-28-33-82-54-11-26-85-34-19-56-6-8-86-50-76,98-35-37-23-17-78-52-87-15-21-93-69-65-64-3-96-55-79-30-88-41-7-91-0-62-5-48-89-9-83-71-20-73-58-16-14-10-31-90-97-22-44-46-66-74-18-25-59-61-42,4234494402,11737,18523,30260
EASolver,kroA100,16-14-10-31-90-97-22-44-46-62-5-48-89-9-83-71-20-73-58-35-37-23-17-78-52-87-15-21-93-69-65-64-3-96-55-79-30-88-41-7-91-0-92-27-66-57-60-24-80-68,28-45-2-42-13-70-40-99-47-51-77-95-4-36-32-75-12-94-81-49-43-72-67-84-38-29-33-82-54-11-26-85-34-19-56-6-8-86-50-76-59-61-63-39-53-1-74-18-25-98,4194642320,12150,18844,30994
EASolver,kroA100,84-67-72-49-43-1-53-39-63-68-80-24-60-50-86-8-6-56-19-11-26-85-34-61-59-76-22-97-90-44-31-10-14-16-73-20-58-71-9-83-35-37-23-17-78-52-87-15-21-93,82-54-33-28-45-2-42-13-70-40-99-47-51-77-95-4-36-32-75-12-94-81-38-29-57-27-92-66-0-62-5-48-89-18-74-96-55-79-30-88-41-7-91-46-98-69-65-64-3-25,2855463002,11855,18017,29872
EASolver,kroA100,9-83-71-20-73-58-16-14-10-31-90-97-22-44-46-62-5-48-89-78-52-87-15-21-93-69-65-64-3-96-55-79-30-88-41-7-91-0-92-27-66-57-60-24-80-68-72-49-43-1,28-45-2-42-13-70-40-99-47-51-77-95-4-36-32-75-12-94-81-38-29-84-67-63-39-53-50-86-8-6-56-19-11-26-85-34-61-59-76-54-82-33-74-18-17-23-37-35-98-25,3444330060,12811,19179,31990
EASolver,kroA100,76-59-61-85-26-11-19-56-6-8-86-50-60-24-80-68-72-49-43-1-53-39-63-67-84-38-29-95-77-51-4-36-32-75-12-94-81-47-99-70-40-13-2-45-28-33-82-54-34-22,23-37-35-98-17-78-52-87-15-21-93-69-65-64-3-96-55-79-30-88-41-7-91-0-62-5-48-89-9-83-71-20-73-58-16-14-10-31-90-97-44-46-92-27-66-57-74-18-25-42,5172739484,11786,19124,30910
EASolver,kroA100,44-90-97-22-59-61-76-19-11-26-85-34-56-6-8-86-50-60-24-80-68-72-49-43-1-53-39-63-67-84-38-29-95-77-51-4-36-32-75-12-94-81-47-99-70-40-13-2-45-28,23-37-35-98-17-78-52-87-15-21-93-69-65-64-3-96-55-79-30-88-41-7-91-0-62-5-48-89-9-83-71-20-73-58-16-14-10-31-46-92-27-66-57-54-82-33-42-74-18-25,5532181941,12696,16176,28872
EASolver,kroA100,43-49-72-67-84-38-29-95-77-51-4-36-32-75-12-94-81-1-53-39-63-68-80-24-60-50-86-8-6-56-19-11-26-85-34-61-59-76-22-97-90-44-31-10-14-16-73-20-58-71,79-30-88-41-7-91-0-62-5-48-89-9-83-35-37-23-17-78-52-87-15-21-93-69-65-64-3-96-55-74-18-25-98-46-92-27-66-57-54-82-33-28-45-2-42-13-70-40-99-47,4806945340,11732,17426,29158
EASolver,kroA100,54-82-33-28-45-2-42-13-70-40-99-47-51-77-95-4-36-32-75-12-94-81-49-43-72-67-84-38-29-8-6-56-86-50-60-24-80-68-63-39-53-1-66-27-92-57-76-59-61-85,98-35-37-23-17-78-52-87-15-21-93-69-65-64-3-96-55-79-30-88-41-7-91-0-62-5-48-89-9-83-71-20-73-58-16-14-10-31-90-97-22-44-46-74-18-25-19-11-26-34,4416972428,12291,16068,28359
EASolver,kroA100,11-26-85-34-19-56-6-8-86-50-60-24-80-68-72-49-43-1-53-39-63-67-84-38-29-95-77-51-4-36-32-75-12-94-81-47-99-70-40-13-2-45-28-33-82-54-42-61-59-76,58-73-20-71-9-83-35-37-23-17-78-52-87-15-21-93-69-65-64-3-96-55-79-30-88-41-7-91-0-62-5-48-89-18-74-25-98-16-14-10-31-90-97-22-44-46-92-27-66-57,5909063797,12315,14726,27041
EASolver,kroA100,98-35-37-23-17-78-52-87-15-21-93-69-65-64-3-96-55-79-30-88-41-7-91-0-62-5-48-89-9-83-71-20-73-58-16-14-10-31-90-97-22-44-46-92-27-66-57-60-24-80,42-2-45-28-13-70-40-99-47-51-77-95-4-36-32-75-12-94-81-49-43-72-67-84-38-29-33-82-54-11-26-85-34-19-56-6-8-86-50-76-59-61-68-63-39-53-1-74-18-25,7130774204,12698,17518,30216
EASolver,kroA100,76-59-61-85-26-11-19-56-6-8-86-50-60-24-80-68-72-49-43-1-53-39-63-67-84-38-29-95-77-51-4-36-32-75-12-94-81-47-99-70-40-13-2-45-28-33-82-54-34-22,73-20-58-71-9-83-35-37-23-17-78-52-87-15-21-93-69-65-64-3-96-55-79-30-88-41-7-91-0-62-5-48-89-18-74-25-98-16-14-10-31-90-97-44-46-92-27-66-57-42,4158985470,11786,17438,29224
EASolver,kroA100,52-78-17-23-37-35-98-83-9-71-20-73-58-16-14-10-31-90-97-22-44-46-62-5-48-89-18-74-96-55-79-30-88-41-7-91-0-92-27-66-57-60-24-80-68-72-49-43-1-53,54-82-33-28-45-2-42-13-70-40-99-47-51-77-95-4-36-32-75-12-94-81-38-29-84-67-63-39-50-86-8-6-56-19-11-26-85-34-61-59-76-87-15-21-93-69-65-64-3-25,2719668416,13226,16049,29275
EASolver,kroA100,6-8-56-86-50-60-24-80-68-72-49-43-1-53-39-63-67-84-38-29-95-77-51-4-36-32-75-12-94-81-47-99-70-40-13-2-45-28-33-82-54-11-26-85-34-19-61-59-76-22,23-37-35-98-17-78-52-87-15-21-93-69-65-64-3-96-55-79-30-88-41-7-91-0-62-5-48-89-9-83-71-20-73-58-16-14-10-31-90-97-44-46-92-27-66-57-74-18-25-42,2692883563,11735,19124,30859
EASolver,kroA100,24-80-60-50-86-8-6-56-19-11-26-85-34-61-59-76-22-97-90-44-31-10-14-16-73-20-58-71-9-83-35-37-23-17-78-52-87-15-21-93-69-65-64-3-96-55-79-30-88-41,94-12-32-75-81-49-43-72-67-84-38-29-95-77-51-4-36-47-99-70-40-13-2-45-28-33-82-54-42-68-63-39-53-1-66-27-92-57-0-62-5-48-89-18-74-91-7-46-98-25,2690052612,10338,20684,31022
EASolver,kroA100,9-83-71-20-73-58-16-14-10-31-90-97-22-44-46-62-5-48-89-78-52-87-15-21-93-69-65-64-3-96-55-79-30-88-41-7-91-0-92-27-66-57-60-24-80-68-72-49-43-1,26-85-34-19-11-6-8-56-86-50-76-59-61-54-82-33-28-45-2-42-13-70-40-99-47-51-77-95-4-36-32-75-12-94-81-38-29-84-67-63-39-53-74-18-17-23-37-35-98-25,6251741163,12811,17609,30420
EASolver,kroA100,26-85-34-19-11-6-8-56-86-50-60-24-80-68-72-49-43-1-53-39-63-67-84-38-29-95-77-51-4-36-32-75-12-94-81-47-99-70-40-13-2-45-28-33-82-54-42-61-59-76,83-9-71-20-73-58-16-14-10-31-90-97-22-44-46-62-5-48-89-78-52-87-15-21-93-69-65-64-3-96-55-79-30-88-41-7-91-0-92-27-66-57-74-18-17-23-37-35-98-25,6297705334,12340,14821,27161
EASolver,kroA100,43-49-72-67-84-38-29-95-77-51-4-36-32-75-12-94-81-1-53-39-63-68-80-24-60-50-86-8-6-56-19-11-26-85-34-61-59-76-22-97-90-44-31-10-14-16-73-20-58-71,46-62-5-48-89-9-83-35-37-23-17-78-52-87-15-21-93-69-65-64-3-96-55-79-30-88-41-7-91-0-92-27-66-57-54-82-33-28-45-2-42-13-70-40-99-47-74-18-25-98,8021406177,11732,17506,29238
EASolver,kroA100,34-85-26-11-19-56-6-8-86-50-60-24-80-68-72-49-43-1-53-39-63-67-84-38-29-95-77-51-4-36-32-75-12-94-81-47-99-70-40-13-2-45-28-33-82-54-42-61-59-76,58-73-20-71-9-83-35-37-23-17-78-52-87-15-21-93-69-65-64-3-96-55-79-30-88-41-7-91-0-62-5-48-89-18-74-25-98-16-14-10-31-90-97-22-44-46-92-27-66-57,7171059251,12148,14726,26874
EASolver,kroA100,9-83-71-20-73-58-16-14-10-31-90-97-22-44-46-62-5-48-89-78-52-87-15-21-93-69-65-64-3-96-55-79-30-88-41-7-91-0-92-27-66-57-60-24-80-68-72-49-43-1,28-45-2-42-13-70-40-99-47-51-77-95-4-36-32-75-12-94-81-38-29-84-67-63-39-53-50-86-8-6-56-19-11-26-85-34-61-59-76-54-82-33-74-18-17-23-37-35-98-25,10319899018,12811,19179,31990
EASolver,kroA100,12-32-75-94-81-49-43-72-67-84-38-29-95-77-51-4-36-47-99-70-40-13-2-45-28-33-82-54-11-26-85-34-19-56-6-8-86-50-60-24-80-68-63-39-53-1-66-27-92-57,98-35-37-23-17-78-52-87-15-21-93-69-65-64-3-96-55-79-30-88-41-7-91-0-62-5-48-89-9-83-71-20-73-58-16-14-10-31-90-97-22-44-46-76-59-61-42-74-18-25,6978768817,12651,16361,29012
EASolver,kroA100,13-2-45-28-33-82-54-11-26-85-34-19-56-6-8-86-50-60-24-80-68-72-49-43-1-53-39-63-67-84-38-29-95-77-51-4-36-32-75-12-94-81-47-99-70-40-42-61-59-76,9-83-71-20-73-58-16-14-10-31-90-97-22-44-46-62-5-48-89-78-52-87-15-21-93-69-65-64-3-96-55-79-30-88-41-7-91-0-92-27-66-57-74-18-17-23-37-35-98-25,6947237353,13124,14854,27978
EASolver,kroA100,83-9-71-20-73-58-16-14-10-31-90-97-22-44-46-62-5-48-89-78-52-87-15-21-93-69-65-64-3-96-55-79-30-88-41-7-91-0-92-27-66-57-60-24-80-68-72-49-43-1,2-45-28-13-70-40-99-47-51-77-95-4-36-32-75-12-94-81-38-29-84-67-63-39-53-50-86-8-6-56-19-11-26-85-34-61-59-76-54-82-33-42-74-18-17-23-37-35-98-25,5059133244,12906,20041,32947
EASolver,kroA100,76-59-61-85-26-11-19-56-6-8-86-50-60-24-80-68-72-49-43-1-53-39-63-67-84-38-29-95-77-51-4-36-32-75-12-94-81-47-99-70-40-13-2-45-28-33-82-54-34-22,20-73-58-71-9-83-35-37-23-17-78-52-87-15-21-93-69-65-64-3-96-55-79-30-88-41-7-91-0-62-5-48-89-18-74-25-98-16-14-10-31-90-97-44-46-92-27-66-57-42,6002474077,11786,17379,29165
EASolver,kroA100,11-26-85-34-19-56-6-8-86-50-60-24-80-68-72-49-43-1-53-39-63-67-84-38-29-95-77-51-4-36-32-75-12-94-81-47-99-70-40-13-2-45-28-33-82-54-42-61-59-76,98-35-37-23-17-78-52-87-15-21-93-69-65-64-3-96-55-79-30-88-41-7-91-0-62-5-48-89-9-83-71-20-73-58-16-14-10-31-90-97-22-44-46-92-27-66-57-74-18-25,5030531848,12315,13699,26014
EASolver,kroA100,54-82-33-28-45-2-42-13-70-40-99-47-51-77-95-4-36-32-75-12-94-81-49-43-72-67-84-38-29-8-6-56-86-50-60-24-80-68-63-39-53-1-66-27-92-57-76-59-61-85,35-37-23-17-78-52-87-15-21-93-69-65-64-3-96-55-79-30-88-41-7-91-0-62-5-48-89-9-83-71-20-73-58-16-14-10-31-90-97-22-44-46-74-18-25-98-34-26-11-19,4033076971,12291,16755,29046
EASolver,kroA100,98-35-37-23-17-78-52-87-15-21-93-69-65-64-3-96-55-79-30-88-41-7-91-0-62-5-48-89-9-83-71-20-73-58-16-14-10-31-90-97-22-44-46-92-27-66-57-60-24-80,54-82-33-28-45-2-42-13-70-40-99-47-51-77-95-4-36-32-75-12-94-81-49-43-72-67-84-38-29-8-6-56-86-50-19-11-26-85-34-61-59-76-68-63-39-53-1-74-18-25,4103104728,12698,17185,29883
EASolver,kroA150,57-107-66-104-141-147-132-137-88-41-121-79-30-138-55-142-118-96-74-18-52-133-78-136-87-15-21-93-69-65-64-3-117-123-25-128-105-89-48-5-62-0-129-91-7-27-92-130-46-108-90-97-22-44-31-10-14-16-140-58-73-20-71-112-9-83-35-37-23-17-103-101-110-98-126,134-139-116-6-8-56-144-86-124-50-60-24-80-68-72-49-43-113-143-63-39-53-1-115-81-125-94-12-32-145-102-75-36-4-77-51-95-38-100-120-29-106-111-131-28-45-2-135-42-122-114-119-148-54-82-33-11-26-85-34-149-61-59-76-109-19-84-67-146-47-99-70-40-13-127,6733355912,16817,15365,32182
EASolver,kroA150,104-141-147-66-107-57-27-92-130-46-108-90-97-22-44-31-10-14-16-140-58-73-20-71-112-9-83-35-37-23-17-136-78-105-89-48-5-62-0-129-91-7-41-121-79-30-88-132-137-53-39-63-143-113-43-49-72-67-84-134-139-116-6-8-56-144-86-124-50-60-24-80-68-1-115,55-142-118-96-74-18-52-133-87-15-21-93-69-65-64-3-117-123-25-128-138-126-98-101-110-103-109-76-59-61-149-85-26-11-19-34-148-54-82-33-28-131-111-106-120-29-100-38-95-77-51-4-36-146-12-32-145-102-75-94-125-81-47-99-70-40-135-2-45-42-122-114-119-127-13,7281357918,15307,21335,36642
EASolver,kroA150,135-2-45-28-131-111-106-120-29-100-38-95-77-51-4-36-146-12-32-145-102-75-94-125-81-115-49-43-113-143-63-39-53-1-72-67-84-134-139-116-6-8-56-144-86-124-50-60-24-80-68-107-57-27-92-130-46-108-90-97-22-44-31-10-14-16-140-58-73-20-71-112-9-83-35,25-123-117-64-65-3-96-142-55-138-121-41-88-30-79-7-91-129-0-62-5-48-89-105-78-136-87-15-21-93-69-52-133-18-74-118-128-17-23-37-103-101-110-98-126-59-61-149-85-26-11-19-34-148-54-82-33-122-42-127-114-119-13-70-40-99-47-76-109-104-141-147-66-132-137,6762706802,16121,21313,37434
EASolver,kroA150,129-0-62-5-48-89-105-78-136-87-15-21-93-69-52-133-18-74-96-142-55-138-121-41-88-30-79-7-91-141-104-66-147-132-137-53-39-63-143-113-43-49-72-67-84-134-139-116-6-8-56-144-86-124-50-60-24-80-68-107-57-27-92-130-46-108-90-97-22-44-31-10-14-16-140,3-64-65-128-25-123-117-118-9-83-71-20-73-58-126-35-37-23-17-103-101-110-98-112-109-76-59-61-149-85-26-11-19-34-148-54-82-33-28-131-111-106-120-29-100-38-95-77-51-4-36-146-12-32-145-102-75-94-125-81-115-1-47-99-70-40-135-2-45-42-122-114-119-127-13,9084980145,15133,21098,36231
EASolver,kroA150,95-77-51-4-36-146-38-100-120-29-106-111-131-28-45-2-135-42-122-114-119-148-54-82-33-134-139-116-6-8-56-144-86-124-50-60-24-80-68-72-49-43-113-143-63-39-53-1-115-81-125-94-12-32-145-102-75-84-67-107-57-27-92-130-46-108-90-97-22-44-31-10-14-16-140,69-21-15-87-93-136-78-105-89-48-5-62-0-129-91-7-41-121-79-30-88-132-137-147-141-104-66-138-55-142-118-96-74-18-52-133-17-23-37-103-101-110-98-35-83-9-71-20-73-58-126-112-109-76-59-61-149-85-26-11-19-34-127-40-70-99-47-13-3-64-65-128-25-123-117,14555650318,16638,19982,36620
EASolver,kroA150,121-41-88-30-79-55-142-118-96-74-18-52-133-78-136-87-15-21-93-69-65-64-3-117-123-25-128-105-89-48-5-62-0-129-91-7-138-132-137-147-141-104-66-107-57-27-92-130-46-108-90-97-22-44-31-10-14-16-140-58-73-20-71-112-9-83-35-37-23-17-103-101-110-98-126,19-11-26-85-34-149-61-59-76-109-56-6-8-116-54-82-148-33-134-139-144-86-124-50-60-24-80-68-72-49-43-113-143-63-39-53-1-115-81-125-94-12-32-145-102-75-36-4-77-51-95-38-100-120-29-106-111-131-28-45-2-135-42-122-114-119-127-40-70-99-47-13-84-67-146,9645589880,16941,15486,32427
EASolver,kroA150,110-101-98-103-37-23-17-136-78-105-89-48-5-62-0-129-91-7-41-121-79-30-88-132-137-147-141-104-66-107-57-27-92-130-46-108-90-97-22-44-31-10-14-16-140-58-73-20-71-112-9-83-35-126-133-52-87-15-21-93-69-65-64-3-96-142-55-138-74-18-118-117-123-25-128,34-85-26-11-19-149-61-59-76-109-56-6-8-116-54-82-148-33-134-139-144-86-124-50-60-24-80-68-72-49-43-113-143-63-39-53-1-115-81-125-94-12-32-145-102-75-36-4-77-51-95-38-100-120-29-106-111-131-28-45-2-135-42-122-114-119-127-40-70-99-47-13-84-67-146,9087887869,16358,15715,32073
EASolver,kroA150,119-114-122-42-2-45-28-131-111-106-120-29-100-38-95-77-51-4-36-146-12-32-145-102-75-94-125-81-115-49-43-113-143-63-39-53-1-72-67-84-134-139-116-6-8-56-144-86-124-50-60-24-80-68-107-57-27-92-130-46-108-90-97-22-44-31-10-14-16-140-58-73-20-71-112,65-64-3-96-142-55-138-121-41-88-30-79-7-91-129-0-62-5-48-89-105-78-136-87-15-21-93-69-52-133-18-74-118-117-123-25-128-17-23-37-103-101-110-98-35-83-9-126-59-61-149-85-26-11-19-34-148-54-82-33-13-135-127-40-70-99-47-76-109-104-141-147-66-132-137,6715069333,14703,20890,35593
EASolver,kroA150,62-5-48-89-105-78-136-87-15-21-93-69-52-133-18-74-96-142-55-138-121-41-88-30-79-7-91-129-0-92-27-104-141-147-66-107-57-60-24-80-124-50-86-144-8-6-116-56-19-11-26-85-34-149-61-59-76-109-22-97-90-108-31-10-14-16-140-58-73-20-71-112-9-83-35,135-2-45-28-131-111-106-120-29-100-38-95-77-51-4-36-146-12-32-145-102-75-94-125-81-115-49-43-113-143-63-39-53-1-72-67-84-134-139-33-82-54-148-119-114-122-42-127-40-70-99-47-13-68-137-132-118-3-64-65-128-25-123-117-17-23-37-103-101-110-98-126-46-130-44,7244208236,13335,20650,33985
EASolver,kroA150,138-55-142-118-96-74-18-52-133-78-136-87-15-21-93-69-65-64-3-117-123-25-128-105-89-48-5-62-0-129-91-7-41-121-79-30-88-132-137-147-141-104-66-107-57-27-92-130-46-108-90-97-22-44-31-10-14-16-140-58-73-20-71-112-9-83-35-37-23-17-103-101-110-98-126,59-61-149-85-26-11-19-56-6-8-116-54-82-148-33-134-139-144-86-124-50-60-24-80-68-72-49-43-113-143-63-39-53-1-115-81-125-94-12-32-145-102-75-36-4-77-51-95-38-100-120-29-106-111-131-28-45-2-135-42-122-114-119-127-40-70-99-47-13-84-67-146-34-76-109,9187554739,16258,15764,32022
EASolver,kroA150,4-36-146-38-100-120-29-106-111-131-28-45-2-135-42-122-114-119-148-54-82-33-134-139-116-6-8-56-144-86-124-50-60-24-80-68-72-49-43-113-143-63-39-53-1-115-81-125-94-12-32-145-102-75-95-77-51-47-99-70-40-13-127-11-26-85-34-149-61-59-76-109-22-97-90,147-141-104-66-107-57-27-92-130-46-108-31-10-14-16-140-58-73-20-71-112-9-83-35-37-23-17-136-78-105-89-48-5-62-0-129-91-7-41-121-79-30-88-132-137-138-55-142-118-96-74-18-52-133-87-15-21-93-69-65-64-3-117-123-25-128-103-101-110-98-126-44-19-84-67,7224093773,15908,18960,34868
EASolver,kroA150,76-109-59-61-149-85-26-11-19-56-6-8-116-54-82-148-33-134-139-144-86-124-50-60-24-80-68-72-49-43-113-143-63-39-53-1-115-81-125-94-12-32-145-102-75-36-4-77-51-95-38-100-120-29-106-111-131-28-45-2-135-42-122-114-119-127-40-70-99-47-13-84-67-146-107,96-142-55-138-121-41-88-30-79-7-91-129-0-62-5-48-89-105-78-136-87-15-21-93-69-52-133-18-74-3-64-65-128-25-123-117-118-132-137-147-141-104-66-27-92-130-46-108-90-97-22-44-31-10-14-16-140-58-73-20-71-112-9-83-35-37-23-17-103-101-110-98-126-57-34,6613964246,15756,19803,35559
EASolver,kroA150,140-58-73-20-71-112-9-83-35-37-23-17-136-78-105-89-48-5-62-0-129-91-7-41-121-79-30-88-132-137-147-141-104-66-107-57-27-92-130-46-108-90-97-22-44-31-10-14-16-126-98-101-110-103-93-21-15-87-133-52-18-74-96-142-55-138-118-3-64-65-128-25-123-117-69,70-40-99-47-13-2-45-28-131-111-106-120-29-100-38-95-77-51-4-36-146-12-32-145-102-75-94-125-81-115-49-43-113-143-63-39-53-1-72-67-84-134-139-116-6-8-56-144-86-124-50-60-24-80-68-33-82-54-148-11-26-85-34-149-61-59-76-109-19-119-114-122-42-127-135,5922314421,16339,13881,30220
EASolver,kroA150,34-85-26-11-19-149-61-59-76-109-22-97-90-108-31-10-14-16-140-58-73-20-71-112-9-83-35-37-23-17-136-78-105-89-48-5-62-0-129-91-7-41-121-79-30-88-132-137-147-141-104-66-107-57-27-92-130-46-44-126-98-101-110-103-93-21-15-87-133-52-18-74-96-142-55,82-54-148-33-134-139-116-6-8-56-144-86-124-50-60-24-80-68-72-49-43-113-143-63-39-53-1-115-81-125-94-12-32-145-102-75-36-4-77-51-95-38-100-120-29-106-111-131-28-45-2-135-42-122-114-119-127-40-70-99-47-13-84-67-146-138-118-3-64-65-128-25-123-117-69,7126258415,16849,20183,37032
EASolver,kroA150,92-27-104-141-147-66-107-57-60-24-80-124-50-86-144-8-6-116-56-19-11-26-85-34-149-61-59-76-109-22-97-90-108-31-10-14-16-140-58-73-20-71-112-9-83-35-37-23-17-136-78-105-89-48-5-62-0-129-91-7-41-121-79-30-88-132-137-53-39-63-143-113-43-49-72,45-2-135-42-122-114-119-148-54-82-33-134-139-84-67-68-1-115-81-125-94-12-32-145-102-75-36-4-77-51-95-38-100-120-29-106-111-131-28-13-70-40-99-47-127-146-130-46-44-126-98-101-110-103-93-21-15-87-133-52-18-74-96-142-55-138-118-3-64-65-128-25-123-117-69,6360199347,13463,23553,37016
EASolver,kroA150,129-0-62-5-48-89-105-78-136-87-15-21-93-69-52-133-18-74-96-142-55-138-121-41-88-30-79-7-91-141-104-66-147-132-137-53-39-63-143-113-43-49-72-67-84-134-139-116-6-8-56-144-86-124-50-60-24-80-68-107-57-27-92-130-46-108-90-97-22-44-31-10-14-16-140,71-20-73-58-126-35-37-23-17-83-9-112-103-101-110-98-65-64-3-117-123-25-128-118-109-76-59-61-149-85-26-11-19-34-148-54-82-33-28-131-111-106-120-29-100-38-95-77-51-4-36-146-12-32-145-102-75-94-125-81-115-1-47-99-70-40-135-2-45-42-122-114-119-127-13,6140163565,15133,21913,37046
EASolver,kroA150,92-27-104-141-147-66-107-57-60-24-80-124-50-86-144-8-6-116-56-19-11-26-85-34-149-61-59-76-109-22-97-90-108-31-10-14-16-140-58-73-20-71-112-9-83-35-37-23-17-136-78-105-89-48-5-62-0-129-91-7-41-121-79-30-88-132-137-53-39-63-143-113-43-49-72,98-101-110-103-126-46-130-44-148-54-82-33-134-139-84-67-68-1-115-81-125-94-12-32-145-102-75-36-4-77-51-95-38-100-120-29-106-111-131-28-45-2-135-42-122-114-119-127-40-70-99-47-13-146-138-55-142-118-96-74-18-52-133-87-15-21-93-69-65-64-3-117-123-25-128,6604454678,13463,21678,35141
EASolver,kroA150,101-110-103-37-23-17-136-78-105-89-48-5-62-0-129-91-7-41-121-79-30-88-132-137-147-141-104-66-107-57-27-92-130-46-108-90-97-22-44-31-10-14-16-140-58-73-20-71-112-9-83-35-98-126-133-52-87-15-21-93-69-65-64-3-96-142-55-138-74-18-118-117-123-25-128,56-6-8-116-54-82-148-11-26-85-34-149-61-59-76-109-19-86-144-124-50-60-24-80-68-72-49-43-113-143-63-39-53-1-115-81-125-94-12-32-145-102-75-36-4-77-51-95-38-100-120-29-106-111-131-28-45-2-135-42-122-114-119-33-134-139-84-67-146-47-99-70-40-13-127,6928708087,16783,15255,32038
EASolver,kroA150,66-104-141-147-132-137-88-41-121-79-30-138-55-142-118-96-74-18-52-133-78-136-87-15-21-93-69-65-64-3-117-123-25-128-105-89-48-5-62-0-129-91-7-27-92-130-46-108-90-97-22-44-31-10-14-16-140-58-73-20-71-112-9-83-35-37-23-17-103-101-110-98-126-59-61,63-39-53-143-113-43-49-72-67-84-134-139-116-6-8-56-144-86-124-50-60-24-80-68-107-57-109-76-149-85-26-11-19-34-148-54-82-33-28-131-111-106-120-29-100-38-95-77-51-4-36-146-12-32-145-102-75-94-125-81-115-1-47-99-70-40-135-2-45-42-122-114-119-127-13,7529619125,17427,16826,34253
EASolver,kroA150,35-37-23-17-136-78-105-89-48-5-62-0-129-91-7-41-121-79-30-88-132-137-147-141-104-66-107-57-27-92-130-46-108-90-97-22-44-31-10-14-16-140-58-73-20-71-112-9-83-103-101-110-98-126-133-52-87-15-21-93-69-65-64-3-96-142-55-138-74-18-118-117-123-25-128,40-70-99-47-13-2-45-28-131-111-106-120-29-100-38-95-77-51-4-36-146-12-32-145-102-75-94-125-81-115-49-43-113-143-63-39-53-1-72-67-84-134-139-116-6-8-56-144-86-124-50-60-24-80-68-33-82-54-148-11-26-85-34-149-61-59-76-109-19-119-114-122-42-127-135,9107122336,16919,13848,30767
EASolver,kroA150,55-142-118-96-74-18-52-133-78-136-87-15-21-93-69-65-64-3-117-123-25-128-105-89-48-5-62-0-129-91-7-41-121-79-30-88-132-137-147-141-104-66-107-57-27-92-130-46-108-90-97-22-44-31-10-14-16-140-58-73-20-71-112-9-83-35-37-23-17-103-101-110-98-126-59,119-114-122-42-2-45-28-131-111-106-120-29-100-38-95-77-51-4-36-146-12-32-145-102-75-94-125-81-115-49-43-113-143-63-39-53-1-72-67-84-134-139-116-6-8-56-144-86-124-50-60-24-80-68-33-82-54-148-11-26-85-34-149-61-76-109-19-127-135-13-70-40-99-47-138,8063810032,17932,19411,37343
EASolver,kroA150,55-142-118-96-74-18-52-133-78-136-87-15-21-93-69-65-64-3-117-123-25-128-105-89-48-5-62-0-129-91-7-41-121-79-30-88-132-137-147-141-104-66-107-57-27-92-130-46-108-90-97-22-44-31-10-14-16-140-58-73-20-71-112-9-83-35-37-23-17-103-101-110-98-126-59,61-149-85-26-11-19-56-6-8-116-54-82-148-33-134-139-144-86-124-50-60-24-80-68-72-49-43-113-143-63-39-53-1-115-81-125-94-12-32-145-102-75-36-4-77-51-95-38-100-120-29-106-111-131-28-45-2-135-42-122-114-119-127-40-70-99-47-13-84-67-146-34-76-109-138,12806323792,17932,18949,36881
EASolver,kroA150,83-9-71-20-73-140-58-126-35-37-23-17-136-78-105-89-48-5-62-0-129-91-7-41-121-79-30-88-132-137-147-141-104-66-107-57-27-92-130-46-108-90-97-22-44-31-10-14-16-112-74-18-52-133-87-15-21-93-69-65-64-3-96-142-55-138-118-117-123-25-128-103-101-110-98,94-125-81-115-49-43-113-143-63-39-53-1-72-67-84-134-139-116-6-8-56-144-86-124-50-60-24-80-68-38-100-120-29-106-111-131-28-45-2-135-42-122-114-119-148-54-82-33-11-26-85-34-149-61-59-76-109-19-127-40-70-99-47-13-51-77-95-4-36-146-12-32-145-102-75,7772960375,16367,14859,31226
EASolver,kroA150,55-142-118-96-74-18-52-133-78-136-87-15-21-93-69-65-64-3-117-123-25-128-105-89-48-5-62-0-129-91-7-41-121-79-30-88-132-137-147-141-104-66-107-57-27-92-130-46-108-90-97-22-44-31-10-14-16-140-58-73-20-71-112-9-83-35-37-23-17-103-101-110-98-126-59,11-26-85-34-149-61-76-109-19-56-6-8-116-54-82-148-33-134-139-144-86-124-50-60-24-80-68-72-49-43-113-143-63-39-53-1-115-81-125-94-12-32-145-102-75-36-4-77-51-95-38-100-120-29-106-111-131-28-45-2-135-42-122-114-119-127-40-70-99-47-13-84-67-146-138,8523255515,17932,18476,36408
EASolver,kroA150,119-114-122-42-2-45-28-131-111-106-120-29-100-38-95-77-51-4-36-146-12-32-145-102-75-94-125-81-115-49-43-113-143-63-39-53-1-72-67-84-134-139-116-6-8-56-144-86-124-50-60-24-80-68-107-57-27-92-130-46-108-90-97-22-44-31-10-14-16-140-58-73-20-71-112,98-101-110-103-37-23-17-136-78-105-89-48-5-62-0-129-91-7-41-121-79-30-88-132-137-147-141-104-66-138-55-142-118-96-74-18-52-133-87-15-21-93-69-65-64-3-117-123-25-128-83-9-35-126-59-61-149-85-26-11-19-34-148-54-82-33-13-135-127-40-70-99-47-76-109,7375471586,14703,20511,35214
EASolver,kroA150,69-21-15-87-93-136-78-105-89-48-5-62-0-129-91-7-41-121-79-30-88-132-137-147-141-104-66-107-57-27-92-130-46-108-90-97-22-44-31-10-14-16-140-58-73-20-71-112-9-83-35-37-23-17-133-52-18-74-96-142-55-138-118-3-64-65-128-25-123-117-103-101-110-98-126,114-119-122-42-2-45-28-131-111-106-120-29-100-38-95-77-51-4-36-146-12-32-145-102-75-94-125-81-115-49-43-113-143-63-39-53-1-72-67-84-134-139-116-6-8-56-144-86-124-50-60-24-80-68-33-82-54-148-11-26-85-34-149-61-59-76-109-19-127-135-13-70-40-99-47,8219701541,16796,15023,31819
EASolver,kroA150,101-110-103-37-23-17-136-78-105-89-48-5-62-0-129-91-7-41-121-79-30-88-132-137-147-141-104-66-107-57-27-92-130-46-108-90-97-22-44-31-10-14-16-140-58-73-20-71-112-9-83-35-98-126-133-52-87-15-21-93-69-65-64-3-96-142-55-138-74-18-118-117-123-25-128,33-82-54-148-11-26-85-34-149-61-59-76-109-19-56-6-8-116-144-86-124-50-60-24-80-68-72-49-43-113-143-63-39-53-1-115-81-125-94-12-32-145-102-75-36-4-77-51-95-38-100-120-29-106-111-131-28-45-2-135-42-122-114-119-127-40-70-99-47-13-134-139-84-67-146,7137441621,16783,14867,31650
EASolver,kroA150,140-58-73-20-71-112-9-83-35-37-23-17-136-78-105-89-48-5-62-0-129-91-7-41-121-79-30-88-132-137-147-141-104-66-107-57-27-92-130-46-108-90-97-22-44-31-10-14-16-126-98-101-110-103-93-21-15-87-133-52-18-74-96-142-55-138-118-3-64-65-128-25-123-117-69,94-125-81-115-49-43-113-143-63-39-53-1-72-67-84-134-139-116-6-8-56-144-86-124-50-60-24-80-68-38-100-120-29-106-111-131-28-45-2-135-42-122-114-119-148-54-82-33-11-26-85-34-149-61-59-76-109-19-127-40-70-99-47-13-51-77-95-4-36-146-12-32-145-102-75,6725126753,16339,14859,31198
EASolver,kroA150,109-76-59-61-149-85-26-11-19-56-6-8-116-54-82-148-33-134-139-144-86-124-50-60-24-80-68-72-49-43-113-143-63-39-53-1-115-81-125-94-12-32-145-102-75-36-4-77-51-95-38-100-120-29-106-111-131-28-45-2-135-42-122-114-119-127-40-70-99-47-13-84-67-146-107,92-27-104-141-147-66-57-130-46-108-90-97-22-44-31-10-14-16-140-58-73-20-71-112-9-83-35-37-23-17-136-78-105-89-48-5-62-0-129-91-7-41-121-79-30-88-132-137-138-55-142-118-96-74-18-52-133-87-15-21-93-69-65-64-3-117-123-25-128-103-101-110-98-126-34,7077159043,15745,18547,34292
EASolver,kroA150,55-142-118-96-74-18-52-133-78-136-87-15-21-93-69-65-64-3-117-123-25-128-105-89-48-5-62-0-129-91-7-41-121-79-30-88-132-137-147-141-104-66-107-57-27-92-130-46-108-90-97-22-44-31-10-14-16-140-58-73-20-71-112-9-83-35-37-23-17-103-101-110-98-126-59,12-32-145-102-75-94-125-81-115-49-43-113-143-63-39-53-1-72-67-84-134-139-116-6-8-56-144-86-124-50-60-24-80-68-38-100-120-29-106-111-131-28-45-2-135-42-122-114-119-148-54-82-33-11-26-85-34-149-61-76-109-19-127-40-70-99-47-13-51-77-95-4-36-146-138,7421764371,17932,19636,37568
EASolver,kroA150,114-119-122-42-2-45-28-131-111-106-120-29-100-38-95-77-51-4-36-146-12-32-145-102-75-94-125-81-115-49-43-113-143-63-39-53-1-72-67-84-134-139-116-6-8-56-144-86-124-50-60-24-80-68-107-57-27-92-130-46-108-90-97-22-44-31-10-14-16-140-58-73-20-71-112,89-105-78-136-87-15-21-93-69-52-133-18-74-96-142-55-138-121-41-88-30-79-7-91-129-0-62-5-48-9-83-35-37-23-17-103-101-110-98-126-59-61-149-85-26-11-19-34-148-54-82-33-13-135-127-40-70-99-47-76-109-104-141-147-66-132-137-118-3-64-65-128-25-123-117,6405799849,14744,20393,35137
EASolver,kroA150,105-78-136-87-15-21-93-69-52-133-18-74-96-142-55-138-121-41-88-30-79-7-91-129-0-62-5-48-89-9-83-71-20-73-140-58-126-35-37-23-17-103-101-110-98-112-46-108-90-97-22-44-31-10-14-16-130-92-27-104-141-147-66-107-57-60-24-80-124-50-86-144-8-6-116,143-113-43-49-72-67-84-134-139-56-19-11-26-85-34-149-61-59-76-109-148-54-82-33-28-131-111-106-120-29-100-38-95-77-51-4-36-146-12-32-145-102-75-94-125-81-115-1-53-39-63-68-137-132-118-3-64-65-128-25-123-117-119-114-122-42-2-45-135-13-70-40-99-47-127,6106536271,16670,20737,37407
EASolver,kroA150,114-119-122-42-2-45-28-131-111-106-120-29-100-38-95-77-51-4-36-146-12-32-145-102-75-94-125-81-115-49-43-113-143-63-39-53-1-72-67-84-134-139-116-6-8-56-144-86-124-50-60-24-80-68-107-57-27-92-130-46-108-90-97-22-44-31-10-14-16-140-58-73-20-71-112,126-35-37-23-17-136-78-105-89-48-5-62-0-129-91-7-41-121-79-30-88-132-137-147-141-104-66-138-55-142-118-96-74-18-52-133-87-15-21-93-69-65-64-3-117-123-25-128-83-9-103-101-110-98-59-61-149-85-26-11-19-34-148-54-82-33-13-135-127-40-70-99-47-76-109,6290743285,14744,20851,35595
EASolver,kroA150,147-141-104-66-107-57-27-92-130-46-108-90-97-22-44-31-10-14-16-140-58-73-20-71-112-9-83-35-37-23-17-136-78-105-89-48-5-62-0-129-91-7-41-121-79-30-88-132-137-53-39-63-143-113-43-49-72-67-84-134-139-116-6-8-56-144-86-124-50-60-24-80-68-1-115,110-101-98-103-126-133-52-87-15-21-93-69-65-64-3-96-142-55-138-74-18-118-117-123-25-128-109-76-59-61-149-85-26-11-19-34-148-54-82-33-28-131-111-106-120-29-100-38-95-77-51-4-36-146-12-32-145-102-75-94-125-81-47-99-70-40-135-2-45-42-122-114-119-127-13,5983348581,15234,21823,37057
EASolver,kroA150,74-18-52-133-78-136-87-15-21-93-69-65-64-3-96-142-55-138-121-41-88-30-79-7-91-129-0-62-5-48-89-105-17-23-37-103-101-110-98-35-83-9-71-20-73-140-58-126-16-14-10-31-108-90-97-22-44-46-130-92-27-104-141-147-66-107-57-60-24-80-124-50-86-144-8,33-82-54-148-11-26-85-34-149-61-59-76-109-19-56-6-116-139-134-84-67-72-49-43-113-143-63-39-53-1-115-81-125-94-12-32-145-102-75-36-4-77-51-95-38-100-120-29-106-111-131-28-45-2-135-42-122-114-119-127-40-70-99-47-13-146-68-137-132-118-117-123-25-128-112,5833082814,15467,19800,35267
EASolver,kroA150,98-101-110-103-37-23-17-136-78-105-89-48-5-62-0-129-91-7-41-121-79-30-88-132-137-147-141-104-66-107-57-27-92-130-46-108-90-97-22-44-31-10-14-16-140-58-73-20-71-112-9-83-35-126-133-52-87-15-21-93-69-65-64-3-96-142-55-138-74-18-118-117-123-25-128,144-86-124-50-60-24-80-68-72-49-43-113-143-63-39-53-1-115-81-125-94-12-32-145-102-75-36-4-77-51-95-38-100-120-29-106-111-131-28-45-2-135-42-122-114-119-148-54-82-33-134-139-116-6-8-56-19-11-26-85-34-149-61-59-76-109-67-84-146-47-99-70-40-13-127,5931808562,16487,15410,31897
EASolver,kroA150,93-21-15-87-136-78-105-89-48-5-62-0-129-91-7-41-121-79-30-88-132-137-147-141-104-66-107-57-27-92-130-46-108-90-97-22-44-31-10-14-16-140-58-73-20-71-112-9-83-35-37-23-17-133-52-18-74-96-142-55-138-118-3-64-65-128-25-123-117-69-103-101-110-98-126,40-70-99-47-13-2-45-28-131-111-106-120-29-100-38-95-77-51-4-36-146-12-32-145-102-75-94-125-81-115-49-43-113-143-63-39-53-1-72-67-84-134-139-116-6-8-56-144-86-124-50-60-24-80-68-33-82-54-148-11-26-85-34-149-61-59-76-109-19-119-114-122-42-127-135,5858090476,16331,13848,30179
EASolver,kroA150,78-136-87-15-21-93-69-52-133-105-89-48-5-62-0-129-91-7-41-121-79-30-88-132-137-147-141-104-66-107-57-27-92-130-46-108-90-97-22-44-31-10-14-16-140-58-73-20-71-112-9-83-35-37-23-17-103-101-110-98-126-18-74-96-142-55-138-118-3-64-65-128-25-123-117,116-6-8-56-144-86-124-50-60-24-80-68-72-49-43-113-143-63-39-53-1-115-81-125-94-12-32-145-102-75-36-4-77-51-95-38-100-120-29-106-111-131-28-45-2-135-42-122-114-119-148-54-82-33-134-139-84-67-146-47-99-70-40-13-127-11-26-85-34-149-61-59-76-109-19,5672642070,16185,14738,30923
EASolver,kroA150,69-21-15-87-93-136-78-105-89-48-5-62-0-129-91-7-41-121-79-30-88-132-137-147-141-104-66-107-57-27-92-130-46-108-90-97-22-44-31-10-14-16-140-58-73-20-71-112-9-83-35-37-23-17-133-52-18-74-96-142-55-138-118-3-64-65-128-25-123-117-103-101-110-98-126,115-49-43-113-143-63-39-53-1-72-67-84-134-139-116-6-8-56-144-86-124-50-60-24-80-68-38-100-120-29-106-111-131-28-45-2-135-42-122-114-119-148-54-82-33-11-26-85-34-149-61-59-76-109-19-127-40-70-99-47-13-51-77-95-4-36-146-12-32-145-102-75-94-125-81,5680842048,16796,14859,31655
EASolver,kroA150,35-37-23-17-136-78-105-89-48-5-62-0-129-91-7-41-121-79-30-88-132-137-147-141-104-66-107-57-27-92-130-46-108-90-97-22-44-31-10-14-16-140-58-73-20-71-112-9-83-103-101-110-98-126-133-52-87-15-21-93-69-65-64-3-96-142-55-138-74-18-118-117-123-25-128,122-42-2-45-28-131-111-106-120-29-100-38-95-77-51-4-36-146-12-32-145-102-75-94-125-81-115-49-43-113-143-63-39-53-1-72-67-84-134-139-116-6-8-56-144-86-124-50-60-24-80-68-33-82-54-148-11-26-85-34-149-61-59-76-109-19-119-114-127-135-13-70-40-99-47,6045702121,16919,14536,31455
EASolver,kroA150,83-9-71-20-73-140-58-126-35-37-23-17-136-78-105-89-48-5-62-0-129-91-7-41-121-79-30-88-132-137-147-141-104-66-107-57-27-92-130-46-108-90-97-22-44-31-10-14-16-112-74-18-52-133-87-15-21-93-69-65-64-3-96-142-55-138-118-117-123-25-128-103-101-110-98,94-125-81-115-49-43-113-143-63-39-53-1-72-67-84-134-139-116-6-8-56-144-86-124-50-60-24-80-68-38-100-120-29-106-111-131-28-45-2-135-42-122-114-119-148-54-82-33-11-26-85-34-149-61-59-76-109-19-127-40-70-99-47-13-51-77-95-4-36-146-12-32-145-102-75,5940520302,16367,14859,31226
EASolver,kroA150,14-16-10-31-108-90-97-22-44-46-130-92-27-104-141-147-66-107-57-60-24-80-124-50-86-144-8-6-116-56-19-11-26-85-34-149-61-59-76-109-148-54-82-33-134-139-84-67-72-49-43-113-143-63-39-53-1-115-81-125-94-12-32-145-102-75-36-4-77-51-95-38-100-120-29,5-48-62-0-129-91-7-41-121-79-30-88-132-137-138-55-142-118-96-74-18-52-133-78-136-87-15-21-93-69-65-64-3-117-123-25-128-105-89-9-83-71-20-73-140-58-126-35-37-23-17-103-101-110-98-112-68-106-111-131-28-45-2-135-42-122-114-119-127-40-70-99-47-13-146,5939386583,15469,21560,37029
EASolver,kroA150,78-136-87-15-21-93-69-52-133-105-89-48-5-62-0-129-91-7-41-121-79-30-88-132-137-147-141-104-66-107-57-27-92-130-46-108-90-97-22-44-31-10-14-16-140-58-73-20-71-112-9-83-35-37-23-17-103-101-110-98-126-18-74-96-142-55-138-118-3-64-65-128-25-123-117,40-70-99-47-13-2-45-28-131-111-106-120-29-100-38-95-77-51-4-36-146-12-32-145-102-75-94-125-81-115-49-43-113-143-63-39-53-1-72-67-84-134-139-116-6-8-56-144-86-124-50-60-24-80-68-33-82-54-148-11-26-85-34-149-61-59-76-109-19-119-114-122-42-127-135,5811271550,16185,13848,30033
EASolver,kroA150,104-141-147-66-107-57-27-92-130-46-108-90-97-22-44-31-10-14-16-140-58-73-20-71-112-9-83-35-37-23-17-136-78-105-89-48-5-62-0-129-91-7-41-121-79-30-88-132-137-53-39-63-143-113-43-49-72-67-84-134-139-116-6-8-56-144-86-124-50-60-24-80-68-1-115,64-65-3-96-142-55-138-74-18-52-133-87-15-21-93-69-128-25-123-117-118-103-101-110-98-126-59-61-149-85-26-11-19-34-148-54-82-33-28-131-111-106-120-29-100-38-95-77-51-4-36-146-12-32-145-102-75-94-125-81-47-99-70-40-135-2-45-42-122-114-119-127-13-76-109,5984477659,15307,21084,36391
EASolver,kroA150,122-42-2-45-28-131-111-106-120-29-100-38-95-77-51-4-36-146-12-32-145-102-75-94-125-81-115-49-43-113-143-63-39-53-1-72-67-84-134-139-116-6-8-56-144-86-124-50-60-24-80-68-107-57-27-92-130-46-108-90-97-22-44-31-10-14-16-140-58-73-20-71-112-9-83,101-110-103-37-23-17-136-78-105-89-48-5-62-0-129-91-7-41-121-79-30-88-132-137-147-141-104-66-138-55-142-118-96-74-18-52-133-87-15-21-93-69-65-64-3-117-123-25-128-35-98-126-59-61-149-85-26-11-19-34-148-54-82-33-114-119-127-135-13-70-40-99-47-76-109,5987302079,15501,20777,36278
EASolver,kroA150,101-110-103-37-23-17-136-78-105-89-48-5-62-0-129-91-7-41-121-79-30-88-132-137-147-141-104-66-107-57-27-92-130-46-108-90-97-22-44-31-10-14-16-140-58-73-20-71-112-9-83-35-98-126-133-52-87-15-21-93-69-65-64-3-96-142-55-138-74-18-118-117-123-25-128,143-113-43-49-72-67-84-134-139-116-6-8-56-144-86-124-50-60-24-80-68-63-39-53-1-115-81-125-94-12-32-145-102-75-36-4-77-51-95-38-100-120-29-106-111-131-28-45-2-135-42-122-114-119-148-54-82-33-11-26-85-34-149-61-59-76-109-19-127-40-70-99-47-13-146,5748424320,16783,15317,32100
EASolver,kroA150,55-142-118-96-74-18-52-133-78-136-87-15-21-93-69-65-64-3-117-123-25-128-105-89-48-5-62-0-129-91-7-41-121-79-30-88-132-137-147-141-104-66-107-57-27-92-130-46-108-90-97-22-44-31-10-14-16-140-58-73-20-71-112-9-83-35-37-23-17-103-101-110-98-126-59,115-49-43-113-143-63-39-53-1-72-67-84-134-139-116-6-8-56-144-86-124-50-60-24-80-68-38-100-120-29-106-111-131-28-45-2-135-42-122-114-119-148-54-82-33-11-26-85-34-149-61-76-109-19-127-40-70-99-47-13-51-77-95-4-36-146-12-32-145-102-75-94-125-81-138,5571657713,17932,19006,36938
EASolver,kroA150,114-119-122-42-2-45-28-131-111-106-120-29-100-38-95-77-51-4-36-146-12-32-145-102-75-94-125-81-115-49-43-113-143-63-39-53-1-72-67-84-134-139-116-6-8-56-144-86-124-50-60-24-80-68-107-57-27-92-130-46-108-90-97-22-44-31-10-14-16-140-58-73-20-71-112,79-30-121-41-88-132-137-147-141-104-66-129-0-62-5-48-89-105-78-136-87-15-21-93-69-52-133-18-74-96-142-55-138-7-91-118-3-64-65-128-25-123-117-17-23-37-103-101-110-98-35-83-9-126-59-61-149-85-26-11-19-34-148-54-82-33-13-135-127-40-70-99-47-76-109,5901381744,14744,20581,35325
EASolver,kroA150,147-141-104-66-107-57-27-92-130-46-108-90-97-22-44-31-10-14-16-140-58-73-20-71-112-9-83-35-37-23-17-136-78-105-89-48-5-62-0-129-91-7-41-121-79-30-88-132-137-53-39-63-143-113-43-49-72-67-84-134-139-116-6-8-56-144-86-124-50-60-24-80-68-1-115,65-64-3-96-142-55-138-74-18-52-133-87-15-21-93-69-128-25-123-117-118-103-101-110-98-126-59-61-149-85-26-11-19-34-148-54-82-33-28-131-111-106-120-29-100-38-95-77-51-4-36-146-12-32-145-102-75-94-125-81-47-99-70-40-135-2-45-42-122-114-119-127-13-76-109,6218329655,15234,21042,36276
EASolver,kroA150,14-16-10-31-108-90-97-22-44-46-130-92-27-104-141-147-66-107-57-60-24-80-124-50-86-144-8-6-116-56-19-11-26-85-34-149-61-59-76-109-148-54-82-33-134-139-84-67-72-49-43-113-143-63-39-53-1-115-81-125-94-12-32-145-102-75-36-4-77-51-95-38-100-120-29,5-48-62-0-129-91-7-41-121-79-30-88-132-137-138-55-142-118-96-74-18-52-133-78-136-87-15-21-93-69-65-64-3-117-123-25-128-105-89-9-83-71-20-73-140-58-126-35-37-23-17-103-101-110-98-112-68-106-111-131-28-45-2-135-42-122-114-119-127-40-70-99-47-13-146,5737468674,15469,21560,37029
EASolver,kroA150,79-30-121-41-88-132-137-147-141-104-66-107-57-27-92-130-46-108-90-97-22-44-31-10-14-16-140-58-73-20-71-112-9-83-35-37-23-17-136-78-105-89-48-5-62-0-129-91-7-138-55-142-118-96-74-18-52-133-87-15-21-93-69-65-64-3-117-123-25-128-103-101-110-98-126,59-61-149-85-26-11-19-56-6-8-116-54-82-148-33-134-139-144-86-124-50-60-24-80-68-72-49-43-113-143-63-39-53-1-115-81-125-94-12-32-145-102-75-36-4-77-51-95-38-100-120-29-106-111-131-28-45-2-135-42-122-114-119-127-40-70-99-47-13-84-67-146-34-76-109,5854846128,16907,15764,32671
EASolver,kroA150,138-55-142-118-96-74-18-52-133-78-136-87-15-21-93-69-65-64-3-117-123-25-128-105-89-48-5-62-0-129-91-7-41-121-79-30-88-132-137-147-141-104-66-107-57-27-92-130-46-108-90-97-22-44-31-10-14-16-140-58-73-20-71-112-9-83-35-37-23-17-103-101-110-98-126,59-61-149-85-26-11-19-56-6-8-116-54-82-148-33-134-139-144-86-124-50-60-24-80-68-72-49-43-113-143-63-39-53-1-115-81-125-94-12-32-145-102-75-36-4-77-51-95-38-100-120-29-106-111-131-28-45-2-135-42-122-114-119-127-40-70-99-47-13-84-67-146-34-76-109,5895678685,16258,15764,32022
EASolver,kroA150,121-41-88-30-79-55-142-118-96-74-18-52-133-78-136-87-15-21-93-69-65-64-3-117-123-25-128-105-89-48-5-62-0-129-91-7-138-132-137-147-141-104-66-107-57-27-92-130-46-108-90-97-22-44-31-10-14-16-140-58-73-20-71-112-9-83-35-37-23-17-103-101-110-98-126,124-50-86-144-8-6-116-56-19-11-26-85-34-149-61-59-76-109-60-24-80-68-72-49-43-113-143-63-39-53-1-115-81-125-94-12-32-145-102-75-36-4-77-51-95-38-100-120-29-106-111-131-28-45-2-135-42-122-114-119-148-54-82-33-134-139-84-67-146-47-99-70-40-13-127,5681862411,16941,15346,32287
EASolver,kroA150,28-131-111-106-120-29-100-38-95-77-51-4-36-146-12-32-145-102-75-94-125-81-115-49-43-113-143-63-39-53-1-72-67-84-134-139-116-6-8-56-144-86-124-50-60-24-80-68-107-57-27-92-130-46-108-90-97-22-44-31-10-14-16-140-58-73-20-71-112-9-83-35-37-23-17,0-129-91-7-41-121-79-30-88-132-137-147-141-104-66-62-5-48-89-105-78-136-87-15-21-93-69-52-133-18-74-96-142-55-138-118-3-64-65-128-25-123-117-103-101-110-98-126-59-61-149-85-26-11-19-34-148-54-82-33-45-2-135-42-122-114-119-127-40-70-99-47-13-76-109,5889141034,16137,19692,35829
EASolver,kroA150,92-27-104-141-147-66-107-57-60-24-80-124-50-86-144-8-6-116-56-19-11-26-85-34-149-61-59-76-109-22-97-90-108-31-10-14-16-140-58-73-20-71-112-9-83-35-37-23-17-136-78-105-89-48-5-62-0-129-91-7-41-121-79-30-88-132-137-53-39-63-143-113-43-49-72,45-2-135-42-122-114-119-148-54-82-33-134-139-84-67-68-1-115-81-125-94-12-32-145-102-75-36-4-77-51-95-38-100-120-29-106-111-131-28-13-70-40-99-47-127-146-130-46-44-126-98-101-110-103-93-21-15-87-133-52-18-74-96-142-55-138-118-3-64-65-128-25-123-117-69,5789314731,13463,23553,37016
EASolver,kroA150,55-142-118-96-74-18-52-133-78-136-87-15-21-93-69-65-64-3-117-123-25-128-105-89-48-5-62-0-129-91-7-41-121-79-30-88-132-137-147-141-104-66-107-57-27-92-130-46-108-90-97-22-44-31-10-14-16-140-58-73-20-71-112-9-83-35-37-23-17-103-101-110-98-126-59,19-11-26-85-34-149-61-76-109-56-6-8-116-54-82-148-33-134-139-144-86-124-50-60-24-80-68-72-49-43-113-143-63-39-53-1-115-81-125-94-12-32-145-102-75-36-4-77-51-95-38-100-120-29-106-111-131-28-45-2-135-42-122-114-119-127-40-70-99-47-13-84-67-146-138,5777723283,17932,18360,36292
EASolver,kroA150,4-36-146-38-100-120-29-106-111-131-28-45-2-135-42-122-114-119-148-54-82-33-134-139-116-6-8-56-144-86-124-50-60-24-80-68-72-49-43-113-143-63-39-53-1-115-81-125-94-12-32-145-102-75-95-77-51-47-99-70-40-13-127-11-26-85-34-149-61-59-76-109-22-97-90,104-141-147-66-107-57-27-92-130-46-108-31-10-14-16-140-58-73-20-71-112-9-83-35-37-23-17-136-78-105-89-48-5-62-0-129-91-7-41-121-79-30-88-132-137-138-55-142-118-96-74-18-52-133-87-15-21-93-69-65-64-3-117-123-25-128-103-101-110-98-126-44-19-84-67,5738123481,15908,18974,34882
EASolver,kroA150,147-141-104-66-107-57-27-92-130-46-108-90-97-22-44-31-10-14-16-140-58-73-20-71-112-9-83-35-37-23-17-136-78-105-89-48-5-62-0-129-91-7-41-121-79-30-88-132-137-53-39-63-143-113-43-49-72-67-84-134-139-116-6-8-56-144-86-124-50-60-24-80-68-1-115,25-123-117-64-65-3-96-142-55-138-74-18-52-133-87-15-21-93-69-128-118-103-101-110-98-126-59-61-149-85-26-11-19-34-148-54-82-33-28-131-111-106-120-29-100-38-95-77-51-4-36-146-12-32-145-102-75-94-125-81-47-99-70-40-135-2-45-42-122-114-119-127-13-76-109,5865328963,15234,21727,36961
EASolver,kroA150,19-11-26-85-34-149-61-59-76-109-22-97-90-108-31-10-14-16-140-58-73-20-71-112-9-83-35-37-23-17-136-78-105-89-48-5-62-0-129-91-7-41-121-79-30-88-132-137-147-141-104-66-107-57-27-92-130-46-44-126-98-101-110-103-93-21-15-87-133-52-18-74-96-142-55,45-2-135-42-122-114-119-148-54-82-33-134-139-116-6-8-56-144-86-124-50-60-24-80-68-72-49-43-113-143-63-39-53-1-115-81-125-94-12-32-145-102-75-36-4-77-51-95-38-100-120-29-106-111-131-28-13-70-40-99-47-127-84-67-146-138-118-3-64-65-128-25-123-117-69,6556772921,16650,21082,37732
EASolver,kroA150,10-14-16-31-108-90-97-22-44-46-130-92-27-104-141-147-66-107-57-60-24-80-124-50-86-144-8-6-116-56-19-11-26-85-34-149-61-59-76-109-148-54-82-33-134-139-84-67-72-49-43-113-143-63-39-53-1-115-81-125-94-12-32-145-102-75-36-4-77-51-95-38-100-120-29,48-5-62-0-129-91-7-41-121-79-30-88-132-137-138-55-142-118-96-74-18-52-133-78-136-87-15-21-93-69-65-64-3-117-123-25-128-105-89-9-83-71-20-73-140-58-126-35-37-23-17-103-101-110-98-112-68-106-111-131-28-45-2-135-42-122-114-119-127-40-70-99-47-13-146,6762410060,15513,21559,37072
EASolver,kroA150,110-101-98-103-37-23-17-136-78-105-89-48-5-62-0-129-91-7-41-121-79-30-88-132-137-147-141-104-66-107-57-27-92-130-46-108-90-97-22-44-31-10-14-16-140-58-73-20-71-112-9-83-35-126-133-52-87-15-21-93-69-65-64-3-96-142-55-138-74-18-118-117-123-25-128,86-144-124-50-60-24-80-68-72-49-43-113-143-63-39-53-1-115-81-125-94-12-32-145-102-75-36-4-77-51-95-38-100-120-29-106-111-131-28-45-2-135-42-122-114-119-148-54-82-33-134-139-116-6-8-56-19-11-26-85-34-149-61-59-76-109-67-84-146-47-99-70-40-13-127,7120467269,16358,15443,31801
EASolver,kroA150,35-37-23-17-136-78-105-89-48-5-62-0-129-91-7-41-121-79-30-88-132-137-147-141-104-66-107-57-27-92-130-46-108-90-97-22-44-31-10-14-16-140-58-73-20-71-112-9-83-103-101-110-98-126-133-52-87-15-21-93-69-65-64-3-96-142-55-138-74-18-118-117-123-25-128,109-76-59-61-149-85-26-11-19-56-6-8-116-54-82-148-33-134-139-144-86-124-50-60-24-80-68-72-49-43-113-143-63-39-53-1-115-81-125-94-12-32-145-102-75-36-4-77-51-95-38-100-120-29-106-111-131-28-45-2-135-42-122-114-119-127-40-70-99-47-13-84-67-146-34,7438965059,16919,15792,32711
EASolver,kroA150,104-141-147-66-107-57-27-92-130-46-108-90-97-22-44-31-10-14-16-140-58-73-20-71-112-9-83-35-37-23-17-136-78-105-89-48-5-62-0-129-91-7-41-121-79-30-88-132-137-53-39-63-143-113-43-49-72-67-84-134-139-116-6-8-56-144-86-124-50-60-24-80-68-1-115,55-142-118-96-74-18-52-133-87-15-21-93-69-65-64-3-117-123-25-128-138-126-98-101-110-103-109-76-59-61-149-85-26-11-19-34-148-54-82-33-28-131-111-106-120-29-100-38-95-77-51-4-36-146-12-32-145-102-75-94-125-81-47-99-70-40-135-2-45-42-122-114-119-127-13,6590517451,15307,21335,36642
EASolver,kroA150,119-114-122-42-2-45-28-131-111-106-120-29-100-38-95-77-51-4-36-146-12-32-145-102-75-94-125-81-115-49-43-113-143-63-39-53-1-72-67-84-134-139-116-6-8-56-144-86-124-50-60-24-80-68-107-57-27-92-130-46-108-90-97-22-44-31-10-14-16-140-58-73-20-71-112,64-65-3-96-142-55-138-121-41-88-30-79-7-91-129-0-62-5-48-89-105-78-136-87-15-21-93-69-52-133-18-74-118-117-123-25-128-17-23-37-103-101-110-98-35-83-9-126-59-61-149-85-26-11-19-34-148-54-82-33-13-135-127-40-70-99-47-76-109-104-141-147-66-132-137,6365763195,14703,20863,35566
EASolver,kroA150,55-142-118-96-74-18-52-133-78-136-87-15-21-93-69-65-64-3-117-123-25-128-105-89-48-5-62-0-129-91-7-41-121-79-30-88-132-137-147-141-104-66-107-57-27-92-130-46-108-90-97-22-44-31-10-14-16-140-58-73-20-71-112-9-83-35-37-23-17-103-101-110-98-126-59,53-39-63-143-113-43-49-72-67-84-134-139-116-6-8-56-144-86-124-50-60-24-80-68-1-115-81-125-94-12-32-145-102-75-36-4-77-51-95-38-100-120-29-106-111-131-28-45-2-135-42-122-114-119-148-54-82-33-11-26-85-34-149-61-76-109-19-127-40-70-99-47-13-146-138,6645658773,17932,18436,36368
EASolver,kroA150,119-114-122-42-2-45-28-131-111-106-120-29-100-38-95-77-51-4-36-146-12-32-145-102-75-94-125-81-115-49-43-113-143-63-39-53-1-72-67-84-134-139-116-6-8-56-144-86-124-50-60-24-80-68-107-57-27-92-130-46-108-90-97-22-44-31-10-14-16-140-58-73-20-71-112,69-21-15-87-93-136-78-105-89-48-5-62-0-129-91-7-41-121-79-30-88-132-137-147-141-104-66-138-55-142-118-96-74-18-52-133-17-23-37-103-101-110-98-35-83-9-126-59-61-149-85-26-11-19-34-148-54-82-33-13-135-127-40-70-99-47-76-109-3-64-65-128-25-123-117,6366476637,14703,20178,34881
EASolver,kroA150,49-43-113-143-63-39-53-1-115-81-125-94-12-32-145-102-75-36-4-77-51-95-38-100-120-29-106-111-131-28-45-2-135-42-122-114-119-148-54-82-33-134-139-116-6-8-56-144-86-124-50-60-24-80-68-72-67-84-146-47-99-70-40-13-127-11-26-85-34-149-61-59-76-109-22,147-141-104-66-107-57-27-92-130-46-108-90-97-44-31-10-14-16-140-58-73-20-71-112-9-83-35-37-23-17-136-78-105-89-48-5-62-0-129-91-7-41-121-79-30-88-132-137-138-55-142-118-96-74-18-52-133-87-15-21-93-69-65-64-3-117-123-25-128-103-101-110-98-126-19,6435047254,15933,18501,34434
EASolver,kroA150,57-107-66-104-141-147-132-137-88-41-121-79-30-138-55-142-118-96-74-18-52-133-78-136-87-15-21-93-69-65-64-3-117-123-25-128-105-89-48-5-62-0-129-91-7-27-92-130-46-108-90-97-22-44-31-10-14-16-140-58-73-20-71-112-9-83-35-37-23-17-103-101-110-98-126,115-49-43-113-143-63-39-53-1-72-67-84-134-139-116-6-8-56-144-86-124-50-60-24-80-68-38-100-120-29-106-111-131-28-45-2-135-42-122-114-119-148-54-82-33-11-26-85-34-149-61-59-76-109-19-127-40-70-99-47-13-51-77-95-4-36-146-12-32-145-102-75-94-125-81,6697756903,16817,14859,31676
EASolver,kroA150,83-9-71-20-73-140-58-126-35-37-23-17-136-78-105-89-48-5-62-0-129-91-7-41-121-79-30-88-132-137-147-141-104-66-107-57-27-92-130-46-108-90-97-22-44-31-10-14-16-112-74-18-52-133-87-15-21-93-69-65-64-3-96-142-55-138-118-117-123-25-128-103-101-110-98,63-39-53-143-113-43-49-72-67-84-134-139-116-6-8-56-144-86-124-50-60-24-80-68-1-115-81-125-94-12-32-145-102-75-36-4-77-51-95-38-100-120-29-106-111-131-28-45-2-135-42-122-114-119-148-54-82-33-11-26-85-34-149-61-59-76-109-19-127-40-70-99-47-13-146,6720963049,16367,15695,32062
EASolver,kroA150,140-58-73-20-71-112-9-83-35-37-23-17-136-78-105-89-48-5-62-0-129-91-7-41-121-79-30-88-132-137-147-141-104-66-107-57-27-92-130-46-108-90-97-22-44-31-10-14-16-126-98-101-110-103-93-21-15-87-133-52-18-74-96-142-55-138-118-3-64-65-128-25-123-117-69,115-49-43-113-143-63-39-53-1-72-67-84-134-139-116-6-8-56-144-86-124-50-60-24-80-68-38-100-120-29-106-111-131-28-45-2-135-42-122-114-119-148-54-82-33-11-26-85-34-149-61-59-76-109-19-127-40-70-99-47-13-51-77-95-4-36-146-12-32-145-102-75-94-125-81,7155173811,16339,14859,31198
EASolver,kroA150,98-101-110-103-37-23-17-136-78-105-89-48-5-62-0-129-91-7-41-121-79-30-88-132-137-147-141-104-66-107-57-27-92-130-46-108-90-97-22-44-31-10-14-16-140-58-73-20-71-112-9-83-35-126-133-52-87-15-21-93-69-65-64-3-96-142-55-138-74-18-118-117-123-25-128,115-49-43-113-143-63-39-53-1-72-67-84-134-139-116-6-8-56-144-86-124-50-60-24-80-68-38-100-120-29-106-111-131-28-45-2-135-42-122-114-119-148-54-82-33-11-26-85-34-149-61-59-76-109-19-127-40-70-99-47-13-51-77-95-4-36-146-12-32-145-102-75-94-125-81,7902472252,16487,14859,31346
EASolver,kroA150,119-114-122-42-2-45-28-131-111-106-120-29-100-38-95-77-51-4-36-146-12-32-145-102-75-94-125-81-115-49-43-113-143-63-39-53-1-72-67-84-134-139-116-6-8-56-144-86-124-50-60-24-80-68-107-57-27-92-130-46-108-90-97-22-44-31-10-14-16-140-58-73-20-71-112,48-5-62-0-129-91-7-41-121-79-30-88-132-137-147-141-104-66-138-55-142-118-96-74-18-52-133-78-136-87-15-21-93-69-65-64-3-117-123-25-128-105-89-9-83-35-37-23-17-103-101-110-98-126-59-61-149-85-26-11-19-34-148-54-82-33-13-135-127-40-70-99-47-76-109,6844033224,14703,20056,34759
EASolver,kroA150,87-15-21-93-136-78-105-89-48-5-62-0-129-91-7-41-121-79-30-88-132-137-147-141-104-66-107-57-27-92-130-46-108-90-97-22-44-31-10-14-16-140-58-73-20-71-112-9-83-35-37-23-17-133-52-18-74-96-142-55-138-118-3-64-65-128-25-123-117-69-103-101-110-98-126,115-49-43-113-143-63-39-53-1-72-67-84-134-139-116-6-8-56-144-86-124-50-60-24-80-68-38-100-120-29-106-111-131-28-45-2-135-42-122-114-119-148-54-82-33-11-26-85-34-149-61-59-76-109-19-127-40-70-99-47-13-51-77-95-4-36-146-12-32-145-102-75-94-125-81,6579344191,16407,14859,31266
EASolver,kroA150,28-131-111-106-120-29-100-38-95-77-51-4-36-146-12-32-145-102-75-94-125-81-115-49-43-113-143-63-39-53-1-72-67-84-134-139-116-6-8-56-144-86-124-50-60-24-80-68-107-57-27-92-130-46-108-90-97-22-44-31-10-14-16-140-58-73-20-71-112-9-83-35-37-23-17,0-129-91-7-41-121-79-30-88-132-137-147-141-104-66-62-5-48-89-105-78-136-87-15-21-93-69-52-133-18-74-96-142-55-138-118-3-64-65-128-25-123-117-103-101-110-98-126-59-61-149-85-26-11-19-34-148-54-82-33-45-2-135-42-122-114-119-127-40-70-99-47-13-76-109,6517054901,16137,19692,35829
EASolver,kroA150,55-142-118-96-74-18-52-133-78-136-87-15-21-93-69-65-64-3-117-123-25-128-105-89-48-5-62-0-129-91-7-41-121-79-30-88-132-137-147-141-104-66-107-57-27-92-130-46-108-90-97-22-44-31-10-14-16-140-58-73-20-71-112-9-83-35-37-23-17-103-101-110-98-126-59,86-144-124-50-60-24-80-68-72-49-43-113-143-63-39-53-1-115-81-125-94-12-32-145-102-75-36-4-77-51-95-38-100-120-29-106-111-131-28-45-2-135-42-122-114-119-148-54-82-33-134-139-116-6-8-56-19-11-26-85-34-149-61-76-109-67-84-146-47-99-70-40-13-127-138,5887714980,17932,18865,36797
EASolver,kroA150,35-37-23-17-136-78-105-89-48-5-62-0-129-91-7-41-121-79-30-88-132-137-147-141-104-66-107-57-27-92-130-46-108-90-97-22-44-31-10-14-16-140-58-73-20-71-112-9-83-103-101-110-98-126-133-52-87-15-21-93-69-65-64-3-96-142-55-138-74-18-118-117-123-25-128,119-114-122-42-2-45-28-131-111-106-120-29-100-38-95-77-51-4-36-146-12-32-145-102-75-94-125-81-115-49-43-113-143-63-39-53-1-72-67-84-134-139-116-6-8-56-144-86-124-50-60-24-80-68-33-82-54-148-11-26-85-34-149-61-59-76-109-19-127-135-13-70-40-99-47,5821011429,16919,15022,31941
EASolver,kroA150,98-101-110-103-37-23-17-136-78-105-89-48-5-62-0-129-91-7-41-121-79-30-88-132-137-147-141-104-66-107-57-27-92-130-46-108-90-97-22-44-31-10-14-16-140-58-73-20-71-112-9-83-35-126-133-52-87-15-21-93-69-65-64-3-96-142-55-138-74-18-118-117-123-25-128,76-109-59-61-149-85-26-11-19-56-6-8-116-54-82-148-33-134-139-144-86-124-50-60-24-80-68-72-49-43-113-143-63-39-53-1-115-81-125-94-12-32-145-102-75-36-4-77-51-95-38-100-120-29-106-111-131-28-45-2-135-42-122-114-119-127-40-70-99-47-13-84-67-146-34,5783410340,16487,15764,32251
EASolver,kroA150,37-23-17-136-78-105-89-48-5-62-0-129-91-7-41-121-79-30-88-132-137-147-141-104-66-107-57-27-92-130-46-108-90-97-22-44-31-10-14-16-140-58-73-20-71-112-9-83-35-103-101-110-98-126-133-52-87-15-21-93-69-65-64-3-96-142-55-138-74-18-118-117-123-25-128,143-113-43-49-72-67-84-134-139-116-6-8-56-144-86-124-50-60-24-80-68-63-39-53-1-115-81-125-94-12-32-145-102-75-36-4-77-51-95-38-100-120-29-106-111-131-28-45-2-135-42-122-114-119-148-54-82-33-11-26-85-34-149-61-59-76-109-19-127-40-70-99-47-13-146,5893574386,16609,15317,31926
EASolver,kroA150,104-141-147-66-107-57-27-92-130-46-108-90-97-22-44-31-10-14-16-140-58-73-20-71-112-9-83-35-37-23-17-136-78-105-89-48-5-62-0-129-91-7-41-121-79-30-88-132-137-53-39-63-143-113-43-49-72-67-84-134-139-116-6-8-56-144-86-124-50-60-24-80-68-1-115,69-21-15-87-93-133-52-18-74-96-142-55-138-118-3-64-65-128-25-123-117-103-101-110-98-126-59-61-149-85-26-11-19-34-148-54-82-33-28-131-111-106-120-29-100-38-95-77-51-4-36-146-12-32-145-102-75-94-125-81-47-99-70-40-135-2-45-42-122-114-119-127-13-76-109,6330541822,15307,20849,36156
EASolver,kroA150,129-0-62-5-48-89-105-78-136-87-15-21-93-69-52-133-18-74-96-142-55-138-121-41-88-30-79-7-91-141-104-66-147-132-137-53-39-63-143-113-43-49-72-67-84-134-139-116-6-8-56-144-86-124-50-60-24-80-68-107-57-27-92-130-46-108-90-97-22-44-31-10-14-16-140,71-20-73-58-126-35-37-23-17-83-9-112-103-101-110-98-65-64-3-117-123-25-128-118-109-76-59-61-149-85-26-11-19-34-148-54-82-33-28-131-111-106-120-29-100-38-95-77-51-4-36-146-12-32-145-102-75-94-125-81-115-1-47-99-70-40-135-2-45-42-122-114-119-127-13,5880437915,15133,21913,37046
EASolver,kroA150,138-55-142-118-96-74-18-52-133-78-136-87-15-21-93-69-65-64-3-117-123-25-128-105-89-48-5-62-0-129-91-7-41-121-79-30-88-132-137-147-141-104-66-107-57-27-92-130-46-108-90-97-22-44-31-10-14-16-140-58-73-20-71-112-9-83-35-37-23-17-103-101-110-98-126,86-144-124-50-60-24-80-68-72-49-43-113-143-63-39-53-1-115-81-125-94-12-32-145-102-75-36-4-77-51-95-38-100-120-29-106-111-131-28-45-2-135-42-122-114-119-148-54-82-33-134-139-116-6-8-56-19-11-26-85-34-149-61-59-76-109-67-84-146-47-99-70-40-13-127,5796580589,16258,15443,31701
EASolver,kroA150,147-141-104-66-107-57-27-92-130-46-108-90-97-22-44-31-10-14-16-140-58-73-20-71-112-9-83-35-37-23-17-136-78-105-89-48-5-62-0-129-91-7-41-121-79-30-88-132-137-53-39-63-143-113-43-49-72-67-84-134-139-116-6-8-56-144-86-124-50-60-24-80-68-1-115,103-101-110-98-126-133-52-87-15-21-93-69-65-64-3-96-142-55-138-74-18-118-117-123-25-128-109-76-59-61-149-85-26-11-19-34-148-54-82-33-28-131-111-106-120-29-100-38-95-77-51-4-36-146-12-32-145-102-75-94-125-81-47-99-70-40-135-2-45-42-122-114-119-127-13,5949311054,15234,21683,36917
EASolver,kroA150,83-9-71-20-73-140-58-126-35-37-23-17-136-78-105-89-48-5-62-0-129-91-7-41-121-79-30-88-132-137-147-141-104-66-107-57-27-92-130-46-108-90-97-22-44-31-10-14-16-112-74-18-52-133-87-15-21-93-69-65-64-3-96-142-55-138-118-117-123-25-128-103-101-110-98,125-94-12-32-145-102-75-81-115-49-43-113-143-63-39-53-1-72-67-84-134-139-116-6-8-56-144-86-124-50-60-24-80-68-38-100-120-29-106-111-131-28-45-2-135-42-122-114-119-148-54-82-33-11-26-85-34-149-61-59-76-109-19-127-40-70-99-47-13-51-77-95-4-36-146,5872464768,16367,15225,31592
EASolver,kroA150,35-37-23-17-136-78-105-89-48-5-62-0-129-91-7-41-121-79-30-88-132-137-147-141-104-66-107-57-27-92-130-46-108-90-97-22-44-31-10-14-16-140-58-73-20-71-112-9-83-103-101-110-98-126-133-52-87-15-21-93-69-65-64-3-96-142-55-138-74-18-118-117-123-25-128,115-49-43-113-143-63-39-53-1-72-67-84-134-139-116-6-8-56-144-86-124-50-60-24-80-68-38-100-120-29-106-111-131-28-45-2-135-42-122-114-119-148-54-82-33-11-26-85-34-149-61-59-76-109-19-127-40-70-99-47-13-51-77-95-4-36-146-12-32-145-102-75-94-125-81,5954320910,16919,14859,31778
EASolver,kroA150,83-9-71-20-73-140-58-126-35-37-23-17-136-78-105-89-48-5-62-0-129-91-7-41-121-79-30-88-132-137-147-141-104-66-107-57-27-92-130-46-108-90-97-22-44-31-10-14-16-112-74-18-52-133-87-15-21-93-69-65-64-3-96-142-55-138-118-117-123-25-128-103-101-110-98,86-144-124-50-60-24-80-68-72-49-43-113-143-63-39-53-1-115-81-125-94-12-32-145-102-75-36-4-77-51-95-38-100-120-29-106-111-131-28-45-2-135-42-122-114-119-148-54-82-33-134-139-116-6-8-56-19-11-26-85-34-149-61-59-76-109-67-84-146-47-99-70-40-13-127,8660960426,16367,15443,31810
EASolver,kroA150,58-140-73-20-71-112-9-83-35-37-23-17-136-78-105-89-48-5-62-0-129-91-7-41-121-79-30-88-132-137-147-141-104-66-107-57-27-92-130-46-108-90-97-22-44-31-10-14-16-126-98-101-110-103-93-21-15-87-133-52-18-74-96-142-55-138-118-3-64-65-128-25-123-117-69,115-49-43-113-143-63-39-53-1-72-67-84-134-139-116-6-8-56-144-86-124-50-60-24-80-68-38-100-120-29-106-111-131-28-45-2-135-42-122-114-119-148-54-82-33-11-26-85-34-149-61-59-76-109-19-127-40-70-99-47-13-51-77-95-4-36-146-12-32-145-102-75-94-125-81,8862098837,16310,14859,31169
EASolver,kroA150,109-76-59-61-149-85-26-11-19-56-6-8-116-54-82-148-33-134-139-144-86-124-50-60-24-80-68-72-49-43-113-143-63-39-53-1-115-81-125-94-12-32-145-102-75-36-4-77-51-95-38-100-120-29-106-111-131-28-45-2-135-42-122-114-119-127-40-70-99-47-13-84-67-146-107,0-129-91-7-41-121-79-30-88-132-137-147-141-104-66-27-92-130-46-108-90-97-22-44-31-10-14-16-140-58-73-20-71-112-9-83-35-37-23-17-136-78-105-89-48-5-62-74-18-52-133-87-15-21-93-69-65-64-3-96-142-55-138-118-117-123-25-128-103-101-110-98-126-57-34,7331612275,15745,19416,35161
EASolver,kroA150,114-119-122-42-2-45-28-131-111-106-120-29-100-38-95-77-51-4-36-146-12-32-145-102-75-94-125-81-115-49-43-113-143-63-39-53-1-72-67-84-134-139-116-6-8-56-144-86-124-50-60-24-80-68-107-57-27-92-130-46-108-90-97-22-44-31-10-14-16-140-58-73-20-71-112,123-25-128-65-64-3-96-142-55-138-121-41-88-30-79-7-91-129-0-62-5-48-89-105-78-136-87-15-21-93-69-52-133-18-74-118-117-17-23-37-103-101-110-98-35-83-9-126-59-61-149-85-26-11-19-34-148-54-82-33-13-135-127-40-70-99-47-76-109-104-141-147-66-132-137,6950511914,14744,21136,35880
EASolver,kroA150,35-37-23-17-136-78-105-89-48-5-62-0-129-91-7-41-121-79-30-88-132-137-147-141-104-66-107-57-27-92-130-46-108-90-97-22-44-31-10-14-16-140-58-73-20-71-112-9-83-103-101-110-98-126-133-52-87-15-21-93-69-65-64-3-96-142-55-138-74-18-118-117-123-25-128,86-144-124-50-60-24-80-68-72-49-43-113-143-63-39-53-1-115-81-125-94-12-32-145-102-75-36-4-77-51-95-38-100-120-29-106-111-131-28-45-2-135-42-122-114-119-148-54-82-33-134-139-116-6-8-56-19-11-26-85-34-149-61-59-76-109-67-84-146-47-99-70-40-13-127,10529395825,16919,15443,32362
EASolver,kroA150,4-36-146-38-100-120-29-106-111-131-28-45-2-135-42-122-114-119-148-54-82-33-134-139-116-6-8-56-144-86-124-50-60-24-80-68-72-49-43-113-143-63-39-53-1-115-81-125-94-12-32-145-102-75-95-77-51-47-99-70-40-13-127-11-26-85-34-149-61-59-76-109-22-97-90,92-27-104-141-147-66-107-57-130-46-108-31-10-14-16-140-58-73-20-71-112-9-83-35-37-23-17-136-78-105-89-48-5-62-0-129-91-7-41-121-79-30-88-132-137-138-55-142-118-96-74-18-52-133-87-15-21-93-69-65-64-3-117-123-25-128-103-101-110-98-126-44-19-84-67,9245504871,15908,19176,35084
EASolver,kroA150,119-114-122-42-2-45-28-131-111-106-120-29-100-38-95-77-51-4-36-146-12-32-145-102-75-94-125-81-115-49-43-113-143-63-39-53-1-72-67-84-134-139-116-6-8-56-144-86-124-50-60-24-80-68-107-57-27-92-130-46-108-90-97-22-44-31-10-14-16-140-58-73-20-71-112,18-74-96-142-55-138-121-41-88-30-79-7-91-129-0-62-5-48-89-105-78-136-87-15-21-93-69-52-133-17-23-37-103-101-110-98-35-83-9-126-59-61-149-85-26-11-19-34-148-54-82-33-13-135-127-40-70-99-47-76-109-104-141-147-66-132-137-118-3-64-65-128-25-123-117,7236612726,14703,19705,34408
EASolver,kroA150,55-142-118-96-74-18-52-133-78-136-87-15-21-93-69-65-64-3-117-123-25-128-105-89-48-5-62-0-129-91-7-41-121-79-30-88-132-137-147-141-104-66-107-57-27-92-130-46-108-90-97-22-44-31-10-14-16-140-58-73-20-71-112-9-83-35-37-23-17-103-101-110-98-126-59,19-11-26-85-34-149-61-76-109-56-6-8-116-54-82-148-33-134-139-144-86-124-50-60-24-80-68-72-49-43-113-143-63-39-53-1-115-81-125-94-12-32-145-102-75-36-4-77-51-95-38-100-120-29-106-111-131-28-45-2-135-42-122-114-119-127-40-70-99-47-13-84-67-146-138,6203655171,17932,18360,36292
EASolver,kroA150,77-51-95-4-36-146-38-100-120-29-106-111-131-28-45-2-135-42-122-114-119-148-54-82-33-134-139-116-6-8-56-144-86-124-50-60-24-80-68-72-49-43-113-143-63-39-53-1-115-81-125-94-12-32-145-102-75-84-67-107-57-27-92-130-46-108-90-97-22-44-31-10-14-16-140,69-21-15-87-93-136-78-105-89-48-5-62-0-129-91-7-41-121-79-30-88-132-137-147-141-104-66-138-55-142-118-96-74-18-52-133-17-23-37-103-101-110-98-35-83-9-71-20-73-58-126-112-109-76-59-61-149-85-26-11-19-34-127-40-70-99-47-13-3-64-65-128-25-123-117,7752472258,16727,19982,36709
EASolver,kroA150,63-39-53-143-113-43-49-72-67-84-134-139-116-6-8-56-144-86-124-50-60-24-80-68-107-57-27-92-130-46-108-90-97-22-44-31-10-14-16-140-58-73-20-71-112-9-83-35-37-23-17-136-78-105-89-48-5-62-0-129-91-7-41-121-79-30-88-132-137-147-141-104-66-138-55,33-82-54-148-11-26-85-34-149-61-59-76-109-19-119-114-122-42-2-45-28-131-111-106-120-29-100-38-95-77-51-4-36-146-12-32-145-102-75-94-125-81-115-1-47-99-70-40-135-13-127-126-98-101-110-103-93-21-15-87-133-52-18-74-96-142-118-3-64-65-128-25-123-117-69,7075299270,15394,21638,37032
EASolver,kroA150,13-2-45-28-131-111-106-120-29-100-38-95-77-51-4-36-146-12-32-145-102-75-94-125-81-115-49-43-113-143-63-39-53-1-72-67-84-134-139-116-6-8-56-144-86-124-50-60-24-80-68-107-57-27-92-130-46-108-90-97-22-44-31-10-14-16-140-58-73-20-71-112-9-83-35,25-123-117-64-65-3-96-142-55-138-121-41-88-30-79-7-91-129-0-62-5-48-89-105-78-136-87-15-21-93-69-52-133-18-74-118-128-17-23-37-103-101-110-98-126-59-61-149-85-26-11-19-34-148-54-82-33-122-42-127-135-70-40-99-47-114-119-76-109-104-141-147-66-132-137,7957669914,16220,20631,36851
EASolver,kroA150,101-110-103-37-23-17-136-78-105-89-48-5-62-0-129-91-7-41-121-79-30-88-132-137-147-141-104-66-107-57-27-92-130-46-108-90-97-22-44-31-10-14-16-140-58-73-20-71-112-9-83-35-98-126-133-52-87-15-21-93-69-65-64-3-96-142-55-138-74-18-118-117-123-25-128,33-82-54-148-11-26-85-34-149-61-59-76-109-19-56-6-8-116-144-86-124-50-60-24-80-68-72-49-43-113-143-63-39-53-1-115-81-125-94-12-32-145-102-75-36-4-77-51-95-38-100-120-29-106-111-131-28-45-2-135-42-122-114-119-127-40-70-99-47-13-134-139-84-67-146,6191396755,16783,14867,31650
EASolver,kroA150,41-121-79-30-88-132-137-147-141-104-66-107-57-27-92-130-46-108-90-97-22-44-31-10-14-16-140-58-73-20-71-112-9-83-35-37-23-17-136-78-105-89-48-5-62-0-129-91-7-138-55-142-118-96-74-18-52-133-87-15-21-93-69-65-64-3-117-123-25-128-103-101-110-98-126,113-143-63-39-53-1-43-49-72-67-84-134-139-116-6-8-56-144-86-124-50-60-24-80-68-115-81-125-94-12-32-145-102-75-36-4-77-51-95-38-100-120-29-106-111-131-28-45-2-135-42-122-114-119-148-54-82-33-11-26-85-34-149-61-59-76-109-19-127-40-70-99-47-13-146,7494443342,16779,15501,32280
EASolver,kroA150,114-119-122-42-2-45-28-131-111-106-120-29-100-38-95-77-51-4-36-146-12-32-145-102-75-94-125-81-115-49-43-113-143-63-39-53-1-72-67-84-134-139-116-6-8-56-144-86-124-50-60-24-80-68-107-57-27-92-130-46-108-90-97-22-44-31-10-14-16-140-58-73-20-71-112,103-101-110-98-35-37-23-17-136-78-105-89-48-5-62-0-129-91-7-41-121-79-30-88-132-137-147-141-104-66-138-55-142-118-96-74-18-52-133-87-15-21-93-69-65-64-3-117-123-25-128-83-9-126-59-61-149-85-26-11-19-34-148-54-82-33-13-135-127-40-70-99-47-76-109,7834472268,14744,20706,35450
EASolver,kroA150,99-70-40-135-2-45-28-131-111-106-120-29-100-38-95-77-51-4-36-146-12-32-145-102-75-94-125-81-115-49-43-113-143-63-39-53-1-72-67-84-134-139-116-6-8-56-144-86-124-50-60-24-80-68-107-57-27-92-130-46-108-90-97-22-44-31-10-14-16-140-58-73-20-71-112,65-64-3-96-142-55-138-121-41-88-30-79-7-91-129-0-62-5-48-89-105-78-136-87-15-21-93-69-52-133-18-74-118-117-123-25-128-17-23-37-103-101-110-98-35-83-9-126-59-61-149-85-26-11-19-34-148-54-82-33-122-42-127-114-119-13-47-76-109-104-141-147-66-132-137,7111324293,15615,21068,36683
EASolver,kroA150,136-78-105-89-48-5-62-0-129-91-7-41-121-79-30-88-132-137-147-141-104-66-107-57-27-92-130-46-108-90-97-22-44-31-10-14-16-140-58-73-20-71-112-9-83-35-37-23-17-93-21-15-87-133-52-18-74-96-142-55-138-118-3-64-65-128-25-123-117-69-103-101-110-98-126,115-49-43-113-143-63-39-53-1-72-67-84-134-139-116-6-8-56-144-86-124-50-60-24-80-68-38-100-120-29-106-111-131-28-45-2-135-42-122-114-119-148-54-82-33-11-26-85-34-149-61-59-76-109-19-127-40-70-99-47-13-51-77-95-4-36-146-12-32-145-102-75-94-125-81,6903811845,16148,14859,31007
