name,primary_graph,secondary_graph,time_ns,primary_cost,secondary_cost,total_cost
gc,20-73-58-71-9-83-35-37-23-17-78-89-48-5-62-46-10-16-14-31-90-44-97-22-59-76-61-19-85-34-26-11-56-6-8-86-50-57-92-27-0-91-7-74-18-52-87-15-21-93,1-43-49-72-63-39-53-68-80-24-67-84-38-81-94-12-75-32-36-4-95-77-51-29-28-33-82-54-60-66-88-41-30-79-55-96-3-64-65-25-69-98-45-2-13-47-99-70-40-42,118500420,11460,18902,30362
gc,46-31-90-97-22-44-10-14-16-20-73-71-9-62-0-92-27-57-66-91-5-48-89-83-58-35-37-23-17-78-52-18-74-7-41-88-30-79-55-96-3-64-65-87-15-21-93-69-98-59,28-45-2-42-13-47-99-70-40-33-82-54-11-6-8-56-86-50-24-80-84-29-38-95-77-51-4-36-67-72-49-43-68-60-19-26-85-34-61-76-63-39-53-1-81-94-12-32-75-25,22113223,15821,20233,36054
gc,49-43-72-67-84-38-29-95-77-51-4-36-81-1-63-39-53-68-80-24-60-50-86-8-6-56-19-11-54-82-33-28-45-2-13-47-99-70-40-42-26-85-34-61-76-57-66-27-92-0,91-7-41-88-30-79-55-74-48-5-62-89-18-96-3-64-65-52-78-9-83-71-20-73-58-46-90-97-22-44-31-10-14-16-35-37-23-17-87-15-21-93-69-25-98-59-94-12-32-75,20040325,13398,19891,33289
gc,4-36-77-51-95-38-29-47-99-70-13-28-45-2-42-40-84-67-49-43-81-12-32-75-94-72-68-80-24-60-50-86-8-6-33-82-54-11-56-19-26-85-34-61-76-59-57-63-39-1,31-10-14-16-44-90-97-22-46-20-73-58-71-9-83-35-37-23-17-78-89-62-5-48-0-92-27-66-91-7-41-88-30-79-55-74-18-52-87-15-21-93-69-65-3-96-64-25-98-53,15461016,14555,18164,32719
gc,85-26-34-19-11-6-56-8-54-82-33-86-50-61-59-76-22-97-90-44-31-10-14-16-46-92-27-57-60-24-80-67-84-28-45-42-2-13-70-40-99-47-29-38-95-77-51-4-36-49,9-83-71-20-73-58-35-37-23-17-78-89-48-5-62-0-91-74-18-52-87-15-21-93-69-65-3-96-55-7-41-79-30-88-66-68-63-39-53-1-43-72-81-94-12-32-75-64-25-98,10887233,13070,17746,30816
gc,72-49-43-1-63-39-53-68-67-84-80-24-60-50-86-8-6-56-19-11-54-82-33-28-29-38-95-77-51-4-36-81-94-12-32-75-47-13-2-45-42-70-99-40-26-85-34-61-76-57,83-9-71-20-73-58-35-37-23-17-78-89-48-5-62-0-91-74-18-52-87-15-21-93-69-65-64-3-96-55-7-41-79-30-88-46-31-10-16-14-44-90-97-22-59-92-27-66-98-25,10661919,13799,16870,30669
gc,98-35-37-23-17-83-9-71-20-73-58-16-14-10-31-46-62-5-48-89-78-87-93-21-15-52-18-74-96-3-65-69-64-25-55-91-0-7-41-79-30-88-27-92-90-44-97-22-59-76,81-94-12-75-32-36-4-95-77-51-38-49-43-1-72-67-84-29-47-13-28-45-2-42-33-82-54-8-6-56-86-80-24-68-63-39-53-60-50-57-66-19-11-26-85-34-61-99-70-40,17632163,14953,15665,30618
gc,3-64-65-25-96-18-74-55-79-30-41-7-91-48-5-89-52-87-15-21-69-93-78-17-23-37-83-9-62-0-88-66-27-92-46-71-20-73-58-35-98-10-31-90-97-22-44-14-16-57,77-51-95-4-36-38-29-47-99-70-13-28-45-2-42-40-33-82-54-84-67-49-72-43-81-94-12-32-75-1-63-39-53-68-80-24-60-50-86-8-6-56-11-26-85-19-34-61-76-59,12843116,16700,14176,30876
gc,68-72-49-43-63-39-53-1-80-24-60-50-86-8-6-56-67-84-38-29-95-77-51-4-36-81-94-12-32-75-57-66-27-92-0-91-7-41-88-30-79-55-96-74-5-62-46-97-22-76,93-21-15-87-69-52-78-17-23-37-35-83-9-89-18-3-65-64-25-48-71-20-73-58-98-10-16-14-31-90-44-59-61-19-85-26-34-11-54-82-33-28-45-2-42-13-47-99-70-40,12952003,14854,16667,31521
gc,46-31-90-97-22-44-10-14-16-20-73-71-9-62-0-92-27-57-66-91-5-48-89-83-58-35-37-23-17-78-52-18-74-7-41-88-30-79-55-96-3-64-65-87-15-21-93-69-98-59,77-51-95-4-36-38-29-47-99-70-13-28-45-2-42-40-33-82-54-84-67-49-72-43-81-94-12-32-75-1-63-39-53-68-80-24-60-50-86-8-6-56-11-26-85-19-34-61-76-25,12933969,15821,18379,34200
gc,59-61-76-22-97-90-44-31-10-14-16-46-92-27-57-50-86-56-19-85-34-26-11-6-8-54-82-33-45-28-2-42-13-29-84-67-24-60-80-68-72-49-43-63-39-53-66-0-62-5,35-37-23-17-83-9-71-20-73-58-98-78-89-48-52-87-15-93-21-69-18-74-96-3-64-65-25-55-91-7-41-79-30-88-1-81-38-95-77-51-47-99-70-40-4-36-12-94-75-32,8607145,13381,19063,32444
gc,53-39-63-1-43-49-72-68-80-24-60-50-86-67-84-38-81-94-12-75-32-36-4-95-77-51-29-28-33-82-54-8-6-56-57-66-27-92-0-7-41-88-30-79-55-91-62-5-48-74,19-11-26-85-34-61-59-76-22-97-90-44-31-10-14-16-46-20-73-58-71-9-83-89-18-96-3-64-65-52-78-17-23-37-35-98-87-15-21-93-69-25-45-2-42-13-70-40-99-47,31553577,13715,16505,30220
gc,33-82-54-11-6-8-56-19-26-85-34-61-76-86-50-24-80-60-84-67-28-45-2-42-13-47-29-38-95-77-51-4-36-99-70-40-72-49-43-68-63-39-53-1-81-94-12-32-75-57,21-15-87-93-69-52-78-17-23-37-83-9-89-18-3-65-64-25-96-74-48-5-62-91-7-55-79-30-41-88-0-46-71-35-98-20-73-58-10-16-14-31-90-97-22-44-92-27-66-59,14336338,16033,16549,32582
gc,87-15-21-93-69-52-78-17-23-37-83-9-89-18-74-96-3-65-64-25-55-48-5-62-91-7-41-79-30-88-0-46-71-35-98-20-73-58-10-16-14-31-90-97-22-44-92-27-66-57,51-77-95-4-36-38-29-47-99-70-13-2-28-45-42-40-33-82-54-84-67-49-72-43-81-94-12-32-75-1-63-39-53-68-80-24-60-50-86-8-6-56-11-26-85-19-34-61-76-59,26736779,15562,14177,29739
gc,37-23-17-78-83-35-98-9-71-20-73-58-10-16-14-31-46-62-89-48-5-52-87-15-93-21-69-18-74-96-3-65-64-25-55-91-0-7-41-79-30-88-27-92-90-97-44-22-59-76,1-43-49-72-63-39-53-68-80-24-67-84-38-81-94-12-75-32-36-4-95-77-51-29-28-33-82-54-8-86-50-60-57-66-56-6-11-19-85-26-34-61-45-2-13-47-99-70-40-42,10252950,15775,14715,30490
gc,89-48-5-62-9-83-78-52-18-74-96-55-91-7-0-46-71-20-73-58-35-37-23-17-87-15-21-93-69-65-3-64-25-79-41-88-30-27-92-66-57-90-31-10-16-14-44-97-22-76,84-67-72-49-43-68-80-24-60-50-86-8-6-56-82-54-33-28-29-38-95-77-51-4-36-12-32-75-94-81-1-63-39-53-11-19-26-85-34-61-59-45-2-13-47-99-70-40-42-98,9630097,15375,18667,34042
gc,13-2-45-28-42-70-99-40-47-29-95-77-51-38-84-67-33-82-54-11-6-8-56-19-26-85-34-61-59-76-86-50-24-80-60-68-72-49-43-4-36-32-12-75-94-81-1-63-39-53,65-64-3-25-69-21-15-87-52-18-96-74-55-79-30-41-7-91-48-5-89-78-93-17-23-37-83-9-62-0-46-71-20-73-58-35-98-10-16-14-31-90-97-22-44-92-27-66-88-57,12247452,13965,16505,30470
gc,1-43-49-72-63-39-53-68-80-24-67-84-38-81-94-12-75-32-36-4-95-77-51-29-28-33-82-54-8-86-50-60-57-66-27-92-0-7-41-88-30-79-55-91-62-5-48-74-96-18,26-85-34-11-19-56-6-61-59-76-22-97-90-44-31-10-14-16-46-20-73-58-71-9-83-89-78-17-23-37-35-98-52-87-15-21-93-69-3-64-65-25-45-42-2-13-70-40-99-47,4832313,14347,16197,30544
gc,45-2-28-42-13-70-40-99-47-29-33-82-54-11-26-85-19-6-8-56-86-50-24-80-84-67-38-95-77-51-4-36-32-12-75-94-81-49-72-68-60-57-76-61-34-59-22-97-90-44,25-64-65-3-96-55-74-18-52-69-21-15-87-93-78-17-23-37-83-89-48-5-91-7-41-79-30-88-0-62-9-71-20-73-58-35-98-46-92-27-66-39-53-63-1-43-31-10-16-14,16810396,13609,17316,30925
gc,27-92-57-66-0-91-7-41-88-30-79-55-96-74-5-62-46-90-97-22-44-31-10-14-16-20-73-71-9-48-89-18-52-78-83-58-35-37-23-17-87-15-21-93-69-3-64-65-25-60,72-49-43-1-63-39-53-68-67-84-80-24-50-86-8-6-56-19-11-54-82-33-28-29-38-95-77-51-4-36-81-94-12-32-75-47-13-2-45-42-70-99-40-26-85-34-61-76-59-98,10945576,15044,17260,32304
gc,65-64-3-25-69-21-15-87-52-18-96-74-55-79-30-41-7-91-48-5-89-78-93-17-23-37-83-9-62-0-46-71-20-73-58-35-98-10-16-14-31-90-97-22-44-92-27-66-88-57,85-26-34-19-11-6-56-8-54-82-33-86-50-61-59-76-60-24-80-67-84-28-45-42-2-13-70-40-99-47-29-38-95-77-51-4-36-49-72-68-63-39-53-43-1-81-94-12-32-75,10544368,16505,14239,30744
gc,15-87-21-93-69-52-78-17-23-37-83-9-89-18-74-96-3-65-64-25-55-48-5-62-91-7-41-79-30-88-0-46-71-35-98-20-73-58-10-16-14-31-90-97-22-44-92-27-66-57,86-50-60-24-80-8-6-56-19-11-26-85-34-61-76-59-54-82-33-28-45-2-42-13-29-84-67-72-68-63-39-53-43-49-38-95-77-51-47-99-70-40-4-36-81-1-94-12-32-75,11819447,15652,14723,30375
gc,34-85-26-11-19-61-59-76-56-6-8-54-82-33-45-42-2-28-13-70-40-99-47-29-86-50-60-24-80-57-92-27-22-97-90-44-31-10-14-16-46-0-62-5-48-91-7-66-68-67,84-38-95-77-51-4-36-49-72-43-1-63-39-53-81-94-12-32-75-88-41-30-79-55-96-74-18-89-9-71-20-73-58-83-35-37-23-17-78-52-87-15-21-93-69-3-64-65-25-98,6962791,13818,18480,32298
gc,98-35-37-23-17-83-9-71-20-73-58-16-14-10-31-46-62-5-48-89-78-87-93-21-15-52-18-74-96-3-65-69-64-25-55-91-0-7-41-79-30-88-27-92-90-44-97-22-59-76,19-11-26-85-34-61-56-6-8-86-50-60-24-80-54-82-33-45-28-2-42-13-29-84-67-72-68-57-66-63-39-53-43-49-38-95-77-51-47-99-70-40-4-36-12-32-75-94-81-1,12146163,14953,14842,29795
gc,63-39-53-1-43-72-68-80-24-60-50-86-67-49-84-38-29-95-77-51-4-36-81-94-12-75-32-47-13-28-33-82-54-8-6-56-57-66-27-92-0-7-41-88-30-79-55-91-62-5,22-97-90-44-31-10-14-16-46-76-59-61-19-85-34-26-11-45-2-42-70-40-99-20-73-58-71-9-83-89-48-74-18-52-78-17-23-37-35-98-87-15-21-93-69-65-3-96-64-25,6968319,14821,17446,32267
gc,94-12-75-32-81-36-4-95-77-51-38-29-84-67-49-43-1-72-63-39-53-68-80-24-60-50-86-8-6-56-33-28-45-2-13-47-99-70-40-42-82-54-11-19-26-85-34-61-76-57,14-16-10-31-44-90-97-22-46-20-73-58-71-9-83-35-37-23-17-78-89-48-5-62-0-92-27-66-91-7-74-18-52-87-15-21-93-98-59-41-88-30-79-55-96-3-64-65-69-25,6953409,13526,17501,31027
gc,99-70-40-13-47-2-45-28-42-33-82-54-29-95-77-51-4-36-38-84-67-72-49-43-81-94-12-32-75-1-63-68-80-24-86-8-6-56-11-26-85-19-34-61-59-76-50-60-57-27,69-21-15-87-93-52-78-17-23-37-83-9-89-18-65-64-3-25-96-74-48-5-62-91-7-55-79-30-41-88-0-46-71-35-98-20-73-58-10-16-14-31-90-97-22-44-92-66-39-53,5982964,14763,16610,31373
gc,50-86-60-24-80-8-56-6-19-11-26-85-34-61-76-59-22-97-90-57-27-92-66-68-72-67-84-49-43-63-39-53-1-81-38-29-33-82-54-28-45-2-42-13-47-95-77-51-4-36,14-16-10-31-44-73-58-20-71-9-83-35-37-23-17-78-89-48-5-62-46-0-91-7-74-18-52-87-15-21-93-98-69-65-3-96-55-41-88-30-79-64-25-94-12-32-75-99-70-40,5239245,14093,20076,34169
gc,71-20-73-58-9-83-35-37-23-17-78-89-48-5-62-46-31-10-16-14-44-90-97-22-59-76-61-92-27-0-91-74-18-52-87-15-21-93-69-65-3-96-55-7-41-88-30-79-64-25,53-39-63-1-43-49-72-68-80-24-60-50-86-67-84-38-81-94-12-75-32-36-4-95-77-51-29-28-33-82-54-8-6-56-57-66-19-11-26-85-34-45-2-13-47-99-70-40-42-98,7081960,13975,18685,32660
gc,26-85-34-11-19-56-6-8-54-82-33-45-28-2-42-13-70-40-99-47-29-84-86-50-60-24-80-61-59-76-22-97-90-44-31-10-14-16-46-92-27-57-66-68-67-72-49-43-63-39,79-30-88-41-55-96-74-7-91-0-62-5-48-89-18-3-64-65-25-52-78-87-15-21-69-93-17-23-83-9-71-20-73-58-35-37-98-53-1-81-94-12-75-32-36-4-38-95-77-51,5167222,13805,17318,31123
gc,75-32-12-94-81-36-4-77-95-51-38-29-84-67-49-43-1-72-63-39-53-68-80-24-60-50-86-8-6-56-33-28-47-99-70-13-2-45-42-40-82-54-11-19-26-85-34-61-76-59,27-92-57-66-0-91-7-41-88-30-79-55-96-74-5-62-46-90-97-22-44-31-10-14-16-20-73-71-9-48-89-18-52-78-83-58-35-37-23-17-87-15-21-93-69-3-64-65-25-98,8542269,14449,15561,30010
gc,10-14-16-31-44-90-97-22-46-20-73-58-71-9-83-35-37-23-17-78-89-48-5-62-0-92-27-57-76-59-61-19-85-34-26-11-56-6-8-86-50-60-24-80-66-91-7-74-18-52,3-64-65-25-96-55-79-30-41-88-69-15-87-21-93-98-68-63-39-53-1-43-72-49-67-84-38-29-33-82-54-28-45-2-42-13-47-95-77-51-4-36-81-94-12-75-32-99-70-40,5632707,12865,20319,33184
gc,97-90-22-44-31-10-14-16-46-92-27-57-76-59-61-19-85-34-26-11-56-6-8-86-50-60-24-80-68-66-0-62-5-48-89-9-71-20-73-58-83-35-37-23-17-78-52-18-74-91,36-4-77-51-95-38-29-47-99-70-13-28-45-2-42-40-32-12-75-94-81-49-43-72-67-84-33-82-54-1-63-39-53-88-41-7-30-79-55-96-3-64-65-25-69-15-87-21-93-98,4871545,12489,19178,31667
gc,39-63-53-1-43-72-68-80-24-60-50-86-67-49-84-38-29-95-77-51-4-36-81-94-12-75-32-66-57-27-92-0-7-41-88-30-79-55-91-62-5-48-74-96-18-89-46-90-97-22,65-64-3-25-69-21-15-87-52-78-93-17-23-37-83-9-71-20-73-58-35-98-10-16-14-31-44-59-76-61-19-56-8-6-11-85-26-34-54-82-33-28-45-2-42-13-47-99-70-40,5210789,16157,15388,31545
gc,93-21-15-87-69-52-78-17-23-37-35-83-9-89-18-74-96-3-65-64-25-55-48-5-62-91-7-41-79-30-88-0-71-20-73-58-98-10-16-14-31-46-90-97-44-22-92-27-66-57,50-86-60-24-80-8-56-6-19-11-26-85-34-61-76-59-54-82-33-28-45-2-42-13-29-84-67-72-68-63-39-53-43-49-1-81-38-95-77-51-4-36-12-94-75-32-47-99-70-40,4959504,16245,14347,30592
gc,82-54-33-6-8-56-11-26-85-19-34-61-59-76-86-50-60-24-80-67-84-28-45-2-42-13-70-40-99-47-29-38-95-77-51-4-36-49-72-68-63-39-53-43-1-81-94-12-32-75,5-48-62-89-9-83-71-20-73-58-10-46-0-91-74-18-52-78-17-23-37-35-98-87-15-21-93-69-65-3-96-55-7-41-79-30-88-66-27-92-57-90-31-14-16-44-97-22-64-25,6068283,13149,16246,29395
gc,91-7-41-88-30-79-55-74-48-5-62-0-27-92-66-57-46-89-18-96-3-64-65-52-78-9-83-71-20-73-58-10-31-90-97-22-44-14-16-35-37-23-17-87-15-21-93-69-25-98,43-49-72-1-63-39-53-68-67-84-38-81-94-12-75-32-36-4-95-77-51-29-80-24-60-50-86-8-6-56-19-11-54-82-33-28-45-2-13-47-99-70-40-42-26-85-34-61-76-59,5420219,16116,13364,29480
gc,97-90-22-44-31-10-14-16-46-92-27-57-76-59-61-19-85-34-26-11-56-6-8-86-50-60-24-80-68-66-0-62-5-48-89-9-71-20-73-58-83-35-37-23-17-78-52-18-74-91,30-79-88-41-7-55-96-3-64-65-25-69-15-87-21-93-98-39-53-63-1-43-72-49-67-84-38-29-95-77-51-4-36-81-94-12-75-32-33-82-54-28-45-2-42-13-47-99-70-40,6274261,12489,18570,31059
gc,88-41-30-79-55-7-91-0-62-5-48-74-96-18-3-64-65-25-52-89-9-83-78-87-15-21-69-93-17-23-37-35-71-46-27-92-66-57-60-24-80-68-63-39-53-1-43-72-49-67,82-54-33-6-8-56-11-26-85-19-34-61-59-76-86-50-28-45-2-42-13-70-40-99-47-29-84-38-95-77-51-4-36-12-32-75-94-81-22-97-90-44-31-10-14-16-73-20-58-98,4914429,14523,15854,30377
gc,60-24-80-50-86-8-6-56-19-11-26-85-34-61-76-57-27-92-66-68-72-67-84-49-43-63-39-53-1-81-38-29-33-82-54-28-45-2-42-13-47-95-77-51-4-36-12-94-75-32,15-87-21-93-69-52-78-17-23-37-83-9-89-18-74-96-3-65-64-25-55-48-5-62-91-7-41-79-30-88-0-46-71-35-98-20-73-58-10-16-14-31-90-97-22-44-59-70-99-40,12356351,13907,18676,32583
gc,32-75-12-94-81-36-4-77-51-95-38-29-84-67-49-43-1-72-68-63-39-53-80-24-60-50-86-8-6-56-33-28-47-99-70-13-2-45-42-40-82-54-11-19-26-85-34-61-76-59,46-31-90-97-22-44-10-14-16-20-73-71-9-62-0-92-27-57-66-91-5-48-89-83-58-35-37-23-17-78-52-18-74-7-41-88-30-79-55-96-3-64-65-87-15-21-93-69-98-25,5590399,14485,16613,31098
gc,0-62-5-48-91-7-41-88-30-79-55-74-18-89-9-83-71-46-92-27-66-57-60-50-86-24-80-68-63-39-53-1-43-72-67-84-8-56-76-97-90-31-10-14-16-20-73-58-35-37,81-94-12-75-32-36-4-95-77-51-38-49-29-47-13-28-45-2-42-33-82-54-6-11-19-26-85-34-61-59-22-44-99-70-40-96-3-64-65-25-52-78-17-23-87-15-21-69-93-98,7381482,13430,21424,34854
gc,31-10-14-16-44-90-97-22-46-20-73-58-71-9-83-35-37-23-17-78-89-62-5-48-0-92-27-57-76-59-61-19-85-34-26-11-56-6-8-86-50-60-24-80-66-91-7-41-88-30,33-82-54-45-28-2-42-13-47-29-38-84-67-72-49-43-68-63-39-53-1-81-95-77-51-4-36-99-70-40-12-32-75-94-79-55-96-74-18-52-87-15-21-93-69-3-64-65-25-98,16351196,13266,20241,33507
gc,19-11-26-85-34-61-59-76-56-6-8-86-50-60-24-80-54-82-33-45-28-2-42-13-29-84-67-72-68-57-92-27-66-22-97-90-44-31-10-14-16-46-0-62-5-48-91-7-41-88,79-30-55-96-74-18-3-64-65-25-52-89-9-83-78-87-15-21-69-93-17-23-37-35-71-20-73-58-98-39-53-63-1-43-49-81-94-12-75-32-36-4-38-95-77-51-47-99-70-40,11047398,14038,17761,31799
gc,9-83-71-20-73-58-35-37-23-17-78-89-48-5-62-0-91-74-18-52-87-15-21-93-69-65-3-96-55-7-41-79-30-88-46-31-10-16-14-44-90-97-22-92-27-66-57-60-50-86,82-54-33-6-8-56-11-26-85-19-34-61-59-76-24-80-67-84-28-45-2-42-13-70-40-99-47-29-38-95-77-51-4-36-49-72-68-63-39-53-43-1-81-94-12-32-75-64-25-98,16230153,13938,19547,33485
gc,91-7-41-88-30-79-55-74-48-5-62-0-27-92-66-57-46-89-18-96-3-64-65-52-78-9-83-71-20-73-58-10-31-90-97-22-44-14-16-35-37-23-17-87-15-21-93-69-25-98,26-85-34-11-19-56-6-8-54-82-33-45-28-2-42-13-70-40-99-47-29-84-86-50-60-24-80-61-59-76-67-72-68-63-39-53-43-49-38-95-77-51-4-36-12-32-75-94-81-1,12064643,16116,14461,30577
gc,26-85-34-11-19-56-6-8-54-82-33-45-28-2-42-13-70-40-99-47-29-84-86-50-60-24-80-61-59-76-22-97-90-44-31-10-14-16-46-92-27-57-66-68-67-72-49-43-63-39,88-41-30-79-55-7-91-0-62-5-48-74-96-18-3-64-65-25-52-89-9-83-78-87-15-21-69-93-17-23-37-35-71-20-73-58-98-53-1-81-94-12-75-32-36-4-38-95-77-51,12667865,13805,17591,31396
gc,66-27-92-57-60-24-80-68-63-39-53-1-43-72-49-67-84-50-86-56-8-6-19-76-59-61-22-97-90-46-0-91-7-41-88-30-79-55-96-74-5-62-48-89-9-83-71-20-73-58,34-85-26-11-54-82-33-45-42-2-28-13-70-40-99-47-29-38-95-77-51-4-36-12-32-75-94-81-44-31-10-14-16-35-37-23-17-78-52-18-3-64-65-87-15-21-93-69-98-25,10978008,12629,18150,30779
gc,55-96-74-18-3-64-65-25-79-30-41-7-91-5-48-89-62-0-88-66-27-92-57-60-24-80-68-63-39-53-1-43-72-49-67-84-50-86-56-8-6-76-46-9-83-78-52-87-15-21,36-4-77-51-95-38-29-47-99-70-13-28-45-2-42-40-32-12-75-94-81-33-82-54-11-19-26-85-34-61-59-22-97-90-44-31-10-14-16-73-20-71-58-35-37-23-17-93-69-98,10467923,15104,17246,32350
gc,27-92-57-66-0-91-7-41-88-30-79-55-96-74-5-62-46-90-97-22-44-31-10-14-16-20-73-71-9-48-89-18-52-78-83-58-35-37-23-17-87-15-21-93-69-3-64-65-25-60,50-86-56-8-6-19-11-26-85-34-61-76-59-24-80-68-72-67-84-49-43-63-39-53-1-81-38-29-33-82-54-28-45-2-42-13-47-95-77-51-4-36-12-94-75-32-99-70-40-98,7434087,15044,18937,33981
gc,18-74-96-3-64-65-52-78-89-48-5-62-91-7-55-79-30-41-88-0-9-83-17-87-15-21-69-93-23-37-35-71-20-73-58-10-46-31-90-97-22-44-14-16-98-25-27-92-66-57,72-49-43-1-63-39-53-68-67-84-80-24-60-50-86-8-6-56-19-11-54-82-33-28-29-38-95-77-51-4-36-81-94-12-32-75-47-13-2-45-42-70-99-40-26-85-34-61-76-59,4819086,18139,13915,32054
gc,59-61-76-22-97-90-44-31-10-14-16-46-92-27-57-50-86-56-19-85-34-26-11-6-8-54-82-33-45-28-2-42-13-29-84-67-24-60-80-68-72-49-43-63-39-53-66-0-62-5,71-20-73-58-9-83-35-37-23-17-78-89-48-91-74-18-52-87-15-21-93-69-65-3-96-55-7-41-88-30-79-64-25-98-1-81-38-95-77-51-4-36-12-94-75-32-47-99-70-40,6836647,13381,20664,34045
gc,28-45-2-42-13-47-99-70-40-33-82-54-11-6-8-56-86-50-24-80-84-29-38-95-77-51-4-36-67-72-49-43-68-60-19-26-85-34-61-76-59-22-97-90-44-31-46-57-27-92,52-78-87-15-21-93-69-18-74-96-3-64-65-25-89-48-5-62-9-83-17-23-37-35-98-71-20-73-58-10-16-14-0-91-7-55-79-30-41-88-66-39-63-53-1-81-94-12-32-75,4828996,14199,17540,31739
gc,83-9-71-20-73-58-35-37-23-17-78-89-48-5-62-0-91-74-18-52-87-15-21-93-69-65-64-3-96-55-7-41-79-30-88-46-31-10-16-14-44-90-97-22-59-76-61-92-27-66,49-43-72-67-84-38-29-95-77-51-4-36-81-1-63-39-53-68-80-24-60-50-86-8-6-56-19-11-54-82-33-28-45-2-13-47-99-70-40-42-26-85-34-57-94-12-32-75-25-98,5559859,13571,21333,34904
gc,91-7-41-88-30-79-55-74-48-5-62-0-27-92-66-57-46-89-18-96-3-64-65-52-78-9-83-71-20-73-58-10-31-90-97-22-44-14-16-35-37-23-17-87-15-21-93-69-25-98,60-24-80-50-86-8-6-56-19-11-26-85-34-61-76-59-54-82-33-84-67-68-72-49-43-63-39-53-1-81-38-29-28-45-2-42-13-47-95-77-51-4-36-12-94-75-32-99-70-40,7186268,16116,14450,30566
gc,96-55-74-18-3-64-65-25-52-78-89-48-5-91-7-41-79-30-88-0-62-9-83-17-87-15-21-69-93-23-37-35-71-20-73-58-46-92-27-66-57-60-24-80-68-63-39-53-1-43,56-6-8-86-50-19-11-26-85-34-61-76-59-54-82-33-28-45-2-42-13-29-84-67-72-49-38-95-77-51-47-99-70-40-4-36-81-94-12-32-75-22-97-90-44-31-10-14-16-98,8837467,15344,17235,32579
gc,85-26-34-19-11-6-56-8-54-82-33-86-50-61-59-76-22-97-90-44-31-10-14-16-46-92-27-57-60-24-80-67-84-28-45-42-2-13-70-40-99-47-29-38-95-77-51-4-36-49,15-87-21-93-69-52-78-17-23-37-83-9-89-18-74-96-3-65-64-25-55-48-5-62-91-7-41-79-30-88-0-71-35-98-20-73-58-66-68-63-39-53-1-43-72-81-94-12-75-32,7331897,13070,19257,32327
gc,41-88-30-79-55-7-91-74-96-18-48-5-62-0-27-92-66-57-60-24-80-68-63-39-53-1-43-72-49-67-84-50-86-56-8-6-19-76-97-90-46-89-9-83-78-52-3-64-65-25,37-23-17-35-98-71-20-73-58-10-16-14-31-44-22-59-61-85-34-26-11-54-82-33-28-45-2-42-13-29-38-95-77-51-4-36-81-94-12-32-75-87-15-93-21-69-47-99-70-40,9183024,13983,21238,35221
gc,39-63-53-1-43-72-68-80-24-60-50-86-67-49-84-38-29-95-77-51-4-36-81-94-12-75-32-66-57-27-92-0-7-41-88-30-79-55-91-62-5-48-74-96-18-89-46-90-97-22,20-73-58-71-9-83-35-37-23-17-78-52-87-15-21-93-98-10-16-14-31-44-59-76-61-19-85-34-26-11-56-6-8-54-82-33-45-28-2-42-13-70-40-99-47-3-64-65-69-25,7222467,16157,16592,32749
gc,32-75-12-94-81-36-4-77-51-95-38-29-84-67-49-43-1-72-68-63-39-53-80-24-60-50-86-8-6-56-33-28-47-99-70-13-2-45-42-40-82-54-11-19-26-85-34-61-76-59,88-41-30-79-55-7-91-0-62-5-48-74-96-18-3-64-65-25-52-89-9-83-78-87-15-21-69-93-17-23-37-35-71-46-27-92-66-57-97-90-31-10-14-16-20-73-58-44-22-98,14578981,14485,16775,31260
gc,39-63-53-1-43-72-68-80-24-60-50-86-67-49-84-38-29-95-77-51-4-36-81-94-12-75-32-66-57-27-92-0-7-41-88-30-79-55-91-62-5-48-74-96-18-89-46-90-97-22,8-6-56-19-11-54-82-33-26-85-34-61-76-59-44-31-10-14-16-73-20-71-58-9-83-35-37-23-17-78-52-87-15-21-93-69-3-64-65-25-28-45-2-42-13-47-99-70-40-98,7387226,16157,19613,35770
gc,72-49-43-1-63-39-53-68-67-84-80-24-60-50-86-8-6-56-19-11-54-82-33-28-29-38-95-77-51-4-36-81-94-12-32-75-47-13-2-45-42-70-99-40-26-85-34-61-76-57,3-64-65-25-96-18-74-55-79-30-41-7-91-48-5-89-52-87-15-21-69-93-78-17-23-37-83-9-62-0-88-66-27-92-46-71-20-73-58-35-98-10-31-90-97-22-44-14-16-59,36869444,13799,16793,30592
gc,38-29-95-77-51-4-36-12-32-75-94-81-49-84-67-72-43-1-63-39-53-68-80-24-60-50-86-8-6-56-33-28-45-2-13-47-99-70-40-42-82-54-11-19-26-85-34-61-76-59,5-48-62-89-9-83-71-20-73-58-10-46-0-91-74-18-52-78-17-23-37-35-98-87-15-21-93-69-65-3-96-55-7-41-79-30-88-66-27-92-57-90-31-14-16-44-97-22-64-25,10042111,12427,16246,28673
gc,11-26-85-19-56-6-8-54-82-33-45-28-2-42-34-61-59-76-86-50-60-24-80-67-84-29-38-95-77-51-13-70-40-99-47-4-36-49-72-68-57-92-27-66-22-97-90-44-31-10,7-91-41-88-30-79-55-96-74-48-5-62-0-46-89-18-3-64-65-52-78-9-83-71-20-73-58-16-14-35-37-23-17-87-15-21-69-93-25-98-39-53-63-1-43-81-94-12-75-32,18662385,14392,19759,34151
gc,57-27-92-66-60-50-86-24-80-68-63-39-53-72-67-84-8-56-6-19-76-59-61-22-97-90-44-31-46-0-91-7-41-88-30-79-55-96-74-5-62-48-89-9-71-20-73-10-14-16,37-23-17-78-83-35-98-58-87-15-93-21-52-18-69-65-64-3-25-85-34-26-11-54-82-33-28-45-2-42-13-29-38-49-43-1-81-94-12-32-75-36-4-95-77-51-47-99-70-40,7454612,12938,19463,32401
gc,86-50-60-24-80-8-6-56-19-11-26-85-34-61-76-59-22-97-90-44-31-46-57-92-27-66-68-72-67-84-33-82-54-28-45-2-42-13-29-38-49-43-63-39-53-1-81-94-12-32,14-16-10-73-58-20-71-9-83-35-37-23-17-78-89-48-5-62-0-91-7-74-18-52-87-15-21-93-98-69-65-3-96-55-41-88-30-79-64-25-95-77-51-47-99-70-40-4-36-75,8751518,14142,19984,34126
gc,88-41-30-79-55-7-91-0-62-5-48-74-96-18-3-64-65-25-52-89-9-83-78-87-15-21-69-93-17-23-37-35-71-46-27-92-66-57-60-24-80-68-63-39-53-1-43-72-49-67,42-2-45-28-13-70-40-99-47-29-33-82-54-11-26-85-34-19-6-8-56-86-50-84-38-95-77-51-4-36-32-12-75-94-81-61-59-76-22-97-90-44-31-10-14-16-73-20-58-98,11311425,14523,15477,30000
gc,39-63-53-1-43-72-68-80-24-60-50-86-67-49-84-38-29-95-77-51-4-36-81-94-12-75-32-66-57-27-92-0-7-41-88-30-79-55-91-62-5-48-74-96-18-89-46-90-97-22,14-16-10-31-44-73-58-20-71-9-83-35-37-23-17-78-52-87-15-21-93-98-59-76-61-34-85-19-26-11-56-6-8-54-82-33-45-28-2-42-13-70-40-99-47-3-64-65-69-25,9056291,16157,17901,34058
gc,5-48-62-89-9-83-71-20-73-58-10-46-0-91-74-18-52-78-17-23-37-35-98-87-15-21-93-69-65-3-96-55-7-41-79-30-88-66-27-92-57-90-31-14-16-44-97-22-76-59,8-6-56-86-50-60-24-80-19-11-54-82-33-26-85-34-61-45-28-2-42-13-29-84-67-72-68-63-39-53-43-49-38-95-77-51-47-99-70-40-4-36-12-32-75-94-81-1-64-25,5770275,14657,18406,33063
gc,62-5-48-89-9-83-71-20-73-58-46-0-91-7-74-18-52-78-17-23-37-35-98-10-31-90-97-22-44-14-16-92-27-66-57-60-50-86-76-59-61-19-56-8-6-11-85-26-34-54,21-15-87-93-69-65-64-3-96-55-79-30-41-88-25-53-39-63-68-80-24-72-43-1-49-67-84-82-33-28-45-2-42-13-29-38-95-77-51-4-36-81-94-12-75-32-47-99-70-40,4206338,14701,19248,33949
gc,52-78-87-15-21-93-69-18-74-96-3-64-65-25-89-48-5-62-9-83-17-23-37-35-98-71-20-73-58-10-16-14-31-46-0-91-7-55-79-30-41-88-66-27-92-57-90-97-22-44,53-39-63-1-43-49-72-68-80-24-60-50-86-67-84-38-81-94-12-75-32-36-4-95-77-51-29-28-33-82-54-8-6-56-19-11-26-85-34-61-76-59-45-2-13-47-99-70-40-42,3818010,14925,13567,28492
gc,1-43-49-72-63-39-53-68-80-24-67-84-38-81-94-12-75-32-36-4-95-77-51-29-28-33-82-54-8-86-50-60-57-66-27-92-0-7-41-88-30-79-55-91-62-5-48-74-96-18,89-9-83-78-52-87-15-21-93-17-23-37-35-71-20-73-58-10-16-14-31-46-90-97-22-44-59-76-61-19-56-6-11-85-26-34-98-69-65-3-64-25-45-2-42-13-47-99-70-40,4935325,14347,20155,34502
gc,64-65-3-25-96-18-52-15-87-21-69-93-78-17-23-37-83-89-74-55-79-30-41-7-91-48-5-62-0-9-71-20-73-58-35-98-46-92-27-66-88-57-60-24-80-68-63-39-53-1,29-38-95-77-51-4-36-47-13-28-45-2-42-33-82-54-6-8-56-86-84-67-49-72-43-81-94-12-32-75-99-70-40-11-26-85-19-50-76-61-34-59-22-97-90-44-31-10-14-16,3809146,17502,15751,33253
gc,6-8-56-86-50-19-11-26-85-34-54-82-33-28-45-2-42-13-29-84-67-24-80-60-57-76-61-59-22-97-90-44-31-46-92-27-66-68-72-49-43-63-39-53-1-38-95-77-51-47,71-20-73-58-9-83-35-37-23-17-78-89-48-5-62-0-91-74-18-52-87-15-21-93-69-65-3-96-55-7-41-88-30-79-10-16-14-98-64-25-81-94-12-32-75-36-4-99-70-40,3839480,13725,20770,34495
gc,92-27-57-66-0-62-46-90-97-22-44-31-10-14-16-20-73-71-9-5-48-91-7-41-88-30-79-55-74-96-18-89-83-58-35-37-23-17-78-52-87-15-21-93-69-3-64-65-25-60,50-86-56-8-6-19-11-26-85-34-61-76-59-24-80-68-72-67-84-49-43-63-39-53-1-81-38-29-33-82-54-28-45-2-42-13-47-95-77-51-4-36-12-94-75-32-99-70-40-98,3879236,14989,18937,33926
gc,5-48-62-89-9-83-71-20-73-58-10-46-0-91-74-18-52-78-17-23-37-35-98-87-15-21-93-69-65-3-96-55-7-41-79-30-88-66-27-92-57-90-31-14-16-44-97-22-76-59,29-38-95-77-51-4-36-47-13-28-45-2-42-33-82-54-6-8-56-86-84-67-49-72-43-1-81-94-12-32-75-99-70-40-11-26-85-19-50-24-80-60-68-63-39-53-61-34-64-25,4115760,14657,20843,35500
gc,67-84-72-49-43-68-80-24-60-50-86-8-6-56-82-54-33-28-29-38-95-77-51-4-36-81-94-12-32-75-1-63-39-53-57-66-27-92-76-19-11-26-85-34-61-59-22-97-90-44,64-65-3-25-96-18-52-15-87-21-69-93-78-17-23-37-83-89-74-55-79-30-41-7-91-48-5-62-0-9-71-20-73-58-35-98-46-31-10-16-14-88-45-2-42-13-47-99-70-40,3983933,13880,20945,34825
gc,39-63-53-1-43-72-68-80-24-60-50-86-67-49-84-38-29-95-77-51-4-36-81-94-12-75-32-66-57-27-92-0-7-41-88-30-79-55-91-62-5-48-74-96-18-89-46-90-97-22,23-37-17-78-83-9-35-98-71-20-73-58-10-16-14-31-44-52-87-15-93-21-69-65-64-3-25-76-59-61-19-85-34-26-11-56-6-8-54-82-33-28-45-2-42-13-47-99-70-40,4016962,16157,17612,33769
gc,26-85-34-11-19-56-6-8-54-82-33-45-28-2-42-13-70-40-99-47-29-84-86-50-60-24-80-61-59-76-22-97-90-44-31-10-14-16-46-92-27-57-66-68-67-72-49-43-63-39,89-48-5-62-9-83-78-52-18-74-96-55-91-7-0-71-20-73-58-35-37-23-17-87-15-21-93-69-65-3-64-25-79-41-88-30-98-53-1-81-94-12-32-75-38-95-77-51-4-36,3857252,13805,20562,34367
gc,14-16-10-31-44-90-97-22-46-20-73-58-71-9-83-35-37-23-17-78-89-48-5-62-0-92-27-57-76-59-61-34-85-19-26-11-56-6-8-86-50-60-24-80-66-91-7-74-18-52,32-75-12-94-81-36-4-77-51-95-38-29-84-67-49-43-1-72-68-63-39-53-47-99-70-13-28-45-2-42-33-82-54-40-88-41-30-79-55-96-3-64-65-25-69-15-87-21-93-98,3819149,12877,20725,33602
gc,18-74-96-3-64-65-52-78-89-48-5-62-91-7-55-79-30-41-88-0-9-83-17-87-15-21-69-93-23-37-35-71-20-73-58-10-46-31-90-97-22-44-14-16-98-25-27-92-66-57,59-61-76-19-85-34-26-11-56-6-8-86-50-60-24-80-68-72-67-84-82-54-33-45-28-2-42-13-29-38-95-77-51-47-99-70-40-4-36-49-43-63-39-53-1-81-94-12-32-75,3991200,18139,14371,32510
gc,74-18-96-55-91-7-41-79-30-88-48-5-89-62-0-46-9-83-78-52-87-15-21-69-3-64-65-25-93-17-23-37-35-71-20-73-58-10-31-90-97-22-44-14-16-92-27-66-57-60,39-63-53-1-43-72-68-80-24-67-49-84-38-29-95-77-51-4-36-81-94-12-75-32-50-86-8-6-56-19-11-54-82-33-28-45-2-13-47-99-70-40-42-26-85-34-61-76-59-98,4109397,15588,17135,32723
gc,47-99-70-40-13-2-28-45-42-29-95-77-51-4-36-38-84-67-49-72-43-81-94-12-32-75-33-82-54-6-8-56-11-26-85-19-86-50-24-80-60-68-63-39-53-1-57-76-61-34,92-27-66-0-62-46-90-97-22-44-31-10-14-16-20-73-71-9-5-48-91-7-41-88-30-79-55-74-96-18-89-83-58-35-37-23-17-78-52-87-15-21-93-69-3-64-65-25-59-98,4553458,14898,17929,32827
gc,30-79-88-41-7-55-96-74-91-0-62-5-48-89-18-3-64-65-25-52-78-87-15-21-69-93-17-23-83-9-71-20-73-58-46-92-27-66-57-60-24-80-68-63-39-53-1-43-72-49,2-45-28-42-13-70-40-99-47-29-33-82-54-11-26-85-19-6-8-56-86-50-84-67-38-95-77-51-4-36-32-12-75-94-81-34-61-59-76-22-97-90-44-31-10-14-16-35-37-98,4074451,13910,16199,30109
gc,34-85-26-11-19-61-59-76-56-6-8-54-82-33-45-42-2-28-13-70-40-99-47-29-86-50-60-24-80-57-92-27-22-97-90-44-31-10-14-16-46-0-62-5-48-91-7-66-68-67,49-43-72-84-38-95-77-51-4-36-81-1-63-39-53-94-12-32-75-88-41-30-79-55-96-74-18-89-9-71-20-73-58-83-78-52-3-64-65-25-69-15-87-21-93-17-23-37-35-98,5620732,13818,18067,31885
gc,45-2-28-42-13-70-40-99-47-29-33-82-54-11-26-85-19-6-8-56-86-50-24-80-84-67-38-95-77-51-4-36-32-12-75-94-81-49-72-68-60-57-76-61-34-59-22-97-90-44,3-64-65-25-96-18-74-55-79-30-41-7-91-48-5-89-52-87-15-21-69-93-78-17-23-37-83-9-62-0-88-66-27-92-46-71-20-73-58-35-98-10-31-14-16-39-53-63-1-43,4153747,13609,18394,32003
gc,14-16-10-31-44-90-97-22-46-20-73-58-71-9-83-35-37-23-17-78-89-48-5-62-0-92-27-57-76-59-61-34-85-19-26-11-56-6-8-86-50-60-24-80-66-91-7-74-18-52,63-39-53-1-43-72-68-49-67-84-38-29-95-77-51-4-36-81-94-12-75-32-47-13-28-33-82-54-45-2-42-70-99-40-88-41-30-79-55-96-3-64-65-25-69-15-87-21-93-98,4028910,12877,18396,31273
gc,17-23-37-78-87-15-21-93-52-18-89-83-9-35-98-71-20-73-58-10-16-14-31-46-62-5-48-74-96-3-65-69-64-25-55-91-7-0-92-27-66-41-79-30-88-57-90-97-44-22,60-24-80-50-86-8-6-56-19-11-26-85-34-61-76-59-54-82-33-84-67-68-72-49-43-63-39-53-1-81-38-29-28-45-2-42-13-47-95-77-51-4-36-12-94-75-32-99-70-40,5808515,16667,14450,31117
gc,77-51-95-4-36-38-29-47-99-70-13-28-45-2-42-40-33-82-54-84-67-49-72-43-81-94-12-32-75-1-63-39-53-68-80-24-60-50-86-8-6-56-11-26-85-19-34-61-76-59,93-21-15-87-69-52-78-17-23-37-35-83-9-89-18-74-96-3-65-64-25-55-48-5-62-91-7-41-79-30-88-0-71-20-73-58-98-10-16-14-31-46-90-97-44-22-92-27-66-57,6817982,14176,16245,30421
gc,76-59-61-19-85-26-11-56-6-8-86-50-60-24-80-57-92-27-22-97-90-44-31-10-14-16-46-0-62-5-48-91-7-66-68-72-67-84-82-54-34-33-45-28-2-42-13-29-38-49,65-64-3-25-69-21-15-87-52-18-96-74-55-79-30-41-88-89-78-93-17-23-37-83-9-71-20-73-58-35-98-39-53-63-1-43-81-94-12-75-32-36-4-95-77-51-47-99-70-40,6470281,14719,18701,33420
gc,83-9-71-20-73-58-35-37-23-17-78-89-48-5-62-0-91-74-18-52-87-15-21-93-69-65-64-3-96-55-7-41-79-30-88-46-31-10-16-14-44-90-97-22-59-76-61-92-27-66,8-6-56-86-50-60-24-80-19-11-54-82-33-26-85-34-45-28-2-42-13-29-84-67-72-68-57-63-39-53-43-49-38-95-77-51-47-99-70-40-4-36-12-32-75-94-81-1-25-98,5321708,13571,20291,33862
gc,68-72-49-43-63-39-53-1-80-24-60-50-86-8-6-56-67-84-38-29-95-77-51-4-36-81-94-12-32-75-57-66-27-92-0-91-7-41-88-30-79-55-96-74-5-62-46-97-22-76,33-82-54-11-26-85-19-34-61-59-45-28-2-42-13-47-99-70-40-90-44-31-10-14-16-73-20-71-58-9-83-48-89-18-52-78-17-23-37-35-98-87-15-21-93-69-3-64-65-25,6463144,14854,17597,32451
gc,73-20-58-71-9-83-35-37-23-17-78-89-48-5-62-46-10-16-14-31-44-90-97-22-59-76-61-19-85-34-26-11-56-6-8-86-50-57-92-27-0-91-7-74-18-52-87-15-21-93,98-69-65-64-3-96-55-79-41-88-30-25-66-60-24-80-68-63-39-53-1-43-72-67-84-82-54-33-45-28-2-42-13-29-38-49-81-94-12-32-75-36-4-95-77-51-47-99-70-40,3941803,11457,19183,30640
gc,81-94-12-75-32-36-4-95-77-51-38-49-43-1-72-67-84-29-47-13-28-45-2-42-33-82-54-8-6-56-86-80-24-68-63-39-53-60-50-57-66-27-92-0-7-41-88-30-79-55,10-14-16-31-44-90-97-22-46-20-73-58-71-9-83-35-37-23-17-78-89-48-5-62-91-74-18-52-87-15-21-93-98-59-76-61-19-85-34-26-11-70-40-99-96-3-64-65-69-25,4129870,14706,19246,33952
gc,22-97-90-44-31-10-14-16-46-76-59-61-19-85-34-26-11-56-6-8-86-50-60-57-92-27-0-62-5-48-89-9-71-20-73-58-83-35-37-23-17-78-52-18-74-91-7-66-24-80,95-77-51-4-36-38-29-47-13-99-70-40-2-28-45-42-33-82-54-84-67-49-72-43-81-94-12-32-75-1-63-39-53-68-88-41-30-79-55-96-3-64-65-25-69-15-87-21-93-98,6346984,12654,17682,30336
gc,91-7-41-88-30-79-55-74-48-5-62-0-27-92-66-57-46-89-18-96-3-64-65-52-78-9-83-71-20-73-58-10-31-90-97-22-44-14-16-35-37-23-17-87-15-21-93-69-25-98,50-86-60-24-80-8-56-6-19-11-26-85-34-61-76-59-54-82-33-28-45-2-42-13-29-84-67-72-68-63-39-53-43-49-1-81-38-95-77-51-4-36-12-94-75-32-47-99-70-40,5651997,16116,14347,30463
gc,68-72-49-43-63-39-53-1-80-24-60-50-86-8-6-56-67-84-38-29-95-77-51-4-36-81-94-12-32-75-57-66-27-92-0-91-7-41-88-30-79-55-96-74-5-62-46-97-22-76,2-45-28-42-13-70-40-99-47-33-82-54-11-26-85-19-34-61-59-44-90-31-10-14-16-73-20-58-71-9-83-48-89-18-52-78-17-23-37-35-98-87-15-21-93-69-3-64-65-25,7496879,14854,15655,30509
gc,83-9-71-20-73-58-35-37-23-17-78-89-48-5-62-0-91-74-18-52-87-15-21-93-69-65-64-3-96-55-7-41-79-30-88-46-31-10-16-14-44-90-97-22-59-76-61-92-27-66,63-39-53-1-43-72-68-80-24-60-50-86-67-49-84-38-29-95-77-51-4-36-81-94-12-75-32-47-13-28-33-82-54-8-6-56-57-19-11-26-85-34-45-2-42-70-99-40-25-98,4833106,13571,21649,35220
gc,33-82-54-11-6-8-56-19-26-85-34-61-76-86-50-24-80-60-84-67-28-45-2-42-13-47-29-38-95-77-51-4-36-99-70-40-72-49-43-68-63-39-53-1-81-94-12-32-75-57,52-78-87-15-21-93-69-18-74-96-3-64-65-25-89-48-5-62-9-83-17-23-37-35-98-71-20-73-58-10-16-14-31-46-0-91-7-55-79-30-41-88-66-27-92-90-97-22-44-59,5359668,16033,15393,31426
gc,33-82-54-11-6-8-56-19-26-85-34-61-76-86-50-24-80-60-84-67-28-45-2-42-13-47-29-38-95-77-51-4-36-99-70-40-72-49-43-68-63-39-53-1-81-94-12-32-75-57,69-21-15-87-93-52-78-17-23-37-83-9-89-18-65-64-3-25-96-74-48-5-62-91-7-55-79-30-41-88-0-46-71-35-98-20-73-58-10-16-14-31-90-97-22-44-92-27-66-59,6447479,16033,16724,32757
nn,15-87-21-93-69-52-78-17-23-37-35-98-83-9-71-20-73-58-16-14-10-31-90-97-22-44-46-62-5-48-89-18-74-96-55-79-30-88-41-7-91-0-92-27-66-57-60-24-80-68,70-40-99-47-13-2-45-28-33-82-54-11-26-85-34-19-56-6-8-86-50-76-59-61-42-29-38-95-77-51-4-36-32-75-12-94-81-49-43-72-67-84-63-39-53-1-3-64-65-25,10057143,13228,17885,31113
nn,28-45-2-42-13-70-40-99-47-51-77-95-4-36-32-75-12-94-81-49-43-72-67-84-38-29-33-82-54-11-26-85-34-19-56-6-8-86-50-60-24-80-68-63-39-53-1-66-27-92,93-21-15-87-52-78-17-23-37-35-98-83-9-71-20-73-58-16-14-10-31-90-97-22-44-46-62-5-48-89-18-74-96-55-79-30-88-41-7-91-0-57-76-59-61-3-64-65-25-69,15367143,12480,13916,26396
nn,74-18-52-78-17-23-37-35-98-83-9-71-20-73-58-16-14-10-31-90-97-22-44-46-62-5-48-89-91-7-41-88-30-79-55-96-3-64-65-25-69-21-15-87-93-0-92-27-66-57,77-51-95-4-36-32-75-12-94-81-49-43-72-67-84-38-29-47-99-70-40-13-2-45-28-33-82-54-11-26-85-34-19-56-6-8-86-50-60-24-80-68-63-39-53-1-76-59-61-42,8882314,13541,12953,26494
nn,75-32-12-94-81-49-43-72-67-84-38-29-95-77-51-4-36-47-99-70-40-13-2-45-28-33-82-54-11-26-85-34-19-56-6-8-86-50-60-24-80-68-63-39-53-1-66-27-92-57,9-83-71-20-73-58-16-14-10-31-90-97-22-44-46-62-5-48-89-78-52-87-15-21-93-69-65-64-3-96-55-79-30-88-41-7-91-0-74-18-17-23-37-35-98-25-76-59-61-42,4580055,12707,18463,31170
nn,57-27-92-66-0-62-5-48-89-9-83-71-20-73-58-16-14-10-31-90-97-22-44-46-91-7-41-88-30-79-55-96-74-18-52-78-17-23-37-35-98-93-21-15-87-69-65-64-3-25,6-8-56-86-50-60-24-80-68-72-49-43-1-53-39-63-67-84-38-29-95-77-51-4-36-32-75-12-94-81-47-99-70-40-13-2-45-28-33-82-54-11-26-85-34-19-61-59-76-42,3417160,13603,12502,26105
nn,21-15-87-93-69-52-78-17-23-37-35-98-83-9-71-20-73-58-16-14-10-31-90-97-22-44-46-62-5-48-89-18-74-96-55-79-30-88-41-7-91-0-92-27-66-57-60-24-80-68,76-59-61-85-26-11-19-56-6-8-86-50-54-82-33-28-45-2-42-13-70-40-99-47-51-77-95-4-36-32-75-12-94-81-49-43-72-67-84-38-29-1-53-39-63-34-3-64-65-25,8290218,13275,17485,30760
nn,60-24-80-68-72-49-43-1-53-39-63-67-84-38-29-95-77-51-4-36-32-75-12-94-81-47-99-70-40-13-2-45-28-33-82-54-11-26-85-34-19-56-6-8-86-50-57-27-92-66,10-14-16-31-90-97-22-44-46-62-5-48-89-9-83-71-20-73-58-35-37-23-17-78-52-87-15-21-93-69-65-64-3-96-55-79-30-88-41-7-91-0-74-18-25-98-59-61-76-42,13530092,11491,17610,29101
nn,89-48-5-62-0-91-7-41-88-30-79-55-96-74-18-52-78-17-23-37-35-98-83-9-71-20-73-58-16-14-10-31-90-97-22-44-46-92-27-66-57-60-24-80-68-72-49-43-1-53,26-85-34-19-11-6-8-56-86-50-76-59-61-54-82-33-28-45-2-42-13-70-40-99-47-51-77-95-4-36-32-75-12-94-81-38-29-84-67-63-39-3-64-65-25-69-21-15-87-93,4375545,12853,15780,28633
nn,56-6-8-86-50-60-24-80-68-72-49-43-1-53-39-63-67-84-38-29-95-77-51-4-36-32-75-12-94-81-47-99-70-40-13-2-45-28-33-82-54-11-26-85-34-19-61-59-76-22,42-57-27-92-66-0-62-5-48-89-9-83-71-20-73-58-16-14-10-31-90-97-44-46-91-7-41-88-30-79-55-96-74-18-52-78-17-23-37-35-98-93-21-15-87-69-65-64-3-25,5055007,11636,16674,28310
nn,79-30-88-41-7-91-0-62-5-48-89-9-83-71-20-73-58-16-14-10-31-90-97-22-44-46-92-27-66-57-60-24-80-68-72-49-43-1-53-39-63-67-84-38-29-95-77-51-4-36,61-59-76-19-11-26-85-34-56-6-8-86-50-54-82-33-28-45-2-42-13-70-40-99-47-32-75-12-94-81-55-96-74-18-52-78-17-23-37-35-98-93-21-15-87-69-65-64-3-25,3523135,13201,16661,29862
nn,85-26-11-19-56-6-8-86-50-60-24-80-68-72-49-43-1-53-39-63-67-84-38-29-95-77-51-4-36-32-75-12-94-81-47-99-70-40-13-2-45-28-33-82-54-34-61-59-76-22,69-21-15-87-93-17-23-37-35-98-83-9-71-20-73-58-16-14-10-31-90-97-44-46-62-5-48-89-78-52-18-74-96-55-79-30-88-41-7-91-0-92-27-66-57-42-3-64-65-25,19201133,11794,15841,27635
nn,45-2-42-28-13-70-40-99-47-51-77-95-4-36-32-75-12-94-81-49-43-72-67-84-38-29-33-82-54-11-26-85-34-19-56-6-8-86-50-60-24-80-68-63-39-53-1-66-27-92,14-16-10-31-90-97-22-44-46-62-5-48-89-9-83-71-20-73-58-35-37-23-17-78-52-87-15-21-93-69-65-64-3-96-55-79-30-88-41-7-91-0-74-18-25-98-59-61-76-57,13612542,12631,15971,28602
nn,48-5-62-0-91-7-41-88-30-79-55-96-74-18-52-78-17-23-37-35-98-83-9-71-20-73-58-16-14-10-31-90-97-22-44-46-92-27-66-57-60-24-80-68-72-49-43-1-53-39,32-75-12-94-81-36-4-77-51-95-38-29-47-99-70-40-13-2-45-28-33-82-54-11-26-85-34-19-56-6-8-86-50-76-59-61-42-84-67-63-89-87-15-21-93-69-65-64-3-25,3075307,12520,17867,30387
nn,47-99-70-40-13-2-45-28-33-82-54-11-26-85-34-19-56-6-8-86-50-60-24-80-68-72-49-43-1-53-39-63-67-84-38-29-95-77-51-4-36-32-75-12-94-81-57-27-92-66,44-90-97-22-59-61-76-31-10-14-16-73-20-58-71-9-83-35-37-23-17-78-52-87-15-21-93-69-65-64-3-96-55-79-30-88-41-7-91-0-62-5-48-89-18-74-25-98-46-42,1934227,13003,17433,30436
nn,97-90-44-22-59-61-76-19-11-26-85-34-56-6-8-86-50-60-24-80-68-72-49-43-1-53-39-63-67-84-38-29-95-77-51-4-36-32-75-12-94-81-47-99-70-40-13-2-45-28,52-78-17-23-37-35-98-83-9-71-20-73-58-16-14-10-31-46-62-5-48-89-18-74-96-55-79-30-88-41-7-91-0-92-27-66-57-54-82-33-42-3-64-65-25-69-21-15-87-93,1866931,12681,15275,27956
nn,38-29-95-77-51-4-36-32-75-12-94-81-49-43-72-67-84-80-24-60-50-86-8-6-56-19-11-26-85-34-61-59-76-22-97-90-44-31-10-14-16-73-20-58-71-9-83-35-37-23,18-74-96-55-79-30-88-41-7-91-0-62-5-48-89-78-52-87-15-21-93-69-65-64-3-25-17-98-46-92-27-66-57-68-63-39-53-1-33-82-54-45-2-42-28-13-70-40-99-47,1831297,12674,18178,30852
nn,18-74-96-55-79-30-88-41-7-91-0-62-5-48-89-9-83-71-20-73-58-16-14-10-31-90-97-22-44-46-92-27-66-57-60-24-80-68-72-49-43-1-53-39-63-67-84-38-29-95,25-64-65-3-52-78-17-23-37-35-98-93-21-15-87-69-76-59-61-85-26-11-19-56-6-8-86-50-54-82-33-28-45-2-42-13-70-40-99-47-51-77-4-36-32-75-12-94-81-34,3360421,14142,17452,31594
nn,35-37-23-17-78-52-87-15-21-93-69-65-64-3-96-55-79-30-88-41-7-91-0-62-5-48-89-9-83-71-20-73-58-16-14-10-31-90-97-22-44-46-92-27-66-57-60-24-80-68,77-51-95-4-36-32-75-12-94-81-49-43-72-67-84-38-29-47-99-70-40-13-2-45-28-33-82-54-11-26-85-34-19-56-6-8-86-50-76-59-61-42-63-39-53-1-74-18-25-98,3296022,12500,20181,32681
nn,31-10-14-16-73-20-58-71-9-83-35-37-23-17-78-52-87-15-21-93-69-65-64-3-96-55-79-30-88-41-7-91-0-62-5-48-89-18-74-25-98-46-90-97-22-44-59-61-76-19,47-99-70-40-13-2-45-28-33-82-54-11-26-85-34-56-6-8-86-50-60-24-80-68-72-49-43-1-53-39-63-67-84-38-29-95-77-51-4-36-32-75-12-94-81-57-27-92-66-42,2497519,14877,13520,28397
nn,96-55-79-30-88-41-7-91-0-62-5-48-89-9-83-71-20-73-58-16-14-10-31-90-97-22-44-46-92-27-66-57-60-24-80-68-72-49-43-1-53-39-63-67-84-38-29-95-77-51,4-36-32-75-12-94-81-47-99-70-40-13-2-45-28-33-82-54-11-26-85-34-19-56-6-8-86-50-76-59-61-42-74-18-52-78-17-23-37-35-98-93-21-15-87-69-65-64-3-25,1416194,13750,18639,32389
nn,53-39-63-68-72-49-43-1-81-94-12-32-75-36-4-77-51-95-38-29-47-99-70-40-13-2-45-28-33-82-54-11-26-85-34-19-56-6-8-86-50-60-24-80-67-84-42-61-59-76,9-83-71-20-73-58-16-14-10-31-90-97-22-44-46-62-5-48-89-78-52-87-15-21-93-69-65-64-3-96-55-79-30-88-41-7-91-0-92-27-66-57-74-18-17-23-37-35-98-25,1354795,12855,14854,27709
nn,79-30-88-41-7-91-0-62-5-48-89-9-83-71-20-73-58-16-14-10-31-90-97-22-44-46-92-27-66-57-60-24-80-68-72-49-43-1-53-39-63-67-84-38-29-95-77-51-4-36,35-37-23-17-78-52-87-15-21-93-69-65-64-3-96-55-74-18-25-98-59-61-76-19-11-26-85-34-56-6-8-86-50-54-82-33-28-45-2-42-13-70-40-99-47-32-75-12-94-81,1346834,13201,18179,31380
nn,95-77-51-4-36-32-75-12-94-81-49-43-72-67-84-38-29-47-99-70-40-13-2-45-28-33-82-54-11-26-85-34-19-56-6-8-86-50-60-24-80-68-63-39-53-1-66-27-92-57,88-41-30-79-55-96-74-18-52-78-17-23-37-35-98-83-9-71-20-73-58-16-14-10-31-90-97-22-44-46-62-5-48-89-91-7-0-76-59-61-42-3-64-65-25-69-21-15-87-93,1806009,12179,17432,29611
nn,92-27-66-57-60-24-80-68-72-49-43-1-53-39-63-67-84-38-29-95-77-51-4-36-32-75-12-94-81-47-99-70-40-13-2-45-28-33-82-54-11-26-85-34-19-56-6-8-86-50,9-83-71-20-73-58-16-14-10-31-90-97-22-44-46-62-5-48-89-78-52-87-15-21-93-69-65-64-3-96-55-79-30-88-41-7-91-0-74-18-17-23-37-35-98-25-76-59-61-42,1321579,11496,18463,29959
nn,97-90-44-22-59-61-76-19-11-26-85-34-56-6-8-86-50-60-24-80-68-72-49-43-1-53-39-63-67-84-38-29-95-77-51-4-36-32-75-12-94-81-47-99-70-40-13-2-45-28,88-41-30-79-55-96-74-18-52-78-17-23-37-35-98-83-9-71-20-73-58-16-14-10-31-46-62-5-48-89-91-7-0-92-27-66-57-54-82-33-42-3-64-65-25-69-21-15-87-93,1897024,12681,16898,29579
nn,96-55-79-30-88-41-7-91-0-62-5-48-89-9-83-71-20-73-58-16-14-10-31-90-97-22-44-46-92-27-66-57-60-24-80-68-72-49-43-1-53-39-63-67-84-38-29-95-77-51,4-36-32-75-12-94-81-47-99-70-40-13-2-45-28-33-82-54-11-26-85-34-19-56-6-8-86-50-76-59-61-42-74-18-52-78-17-23-37-35-98-93-21-15-87-69-65-64-3-25,2397615,13750,18639,32389
nn,70-40-99-47-13-2-45-28-33-82-54-11-26-85-34-19-56-6-8-86-50-60-24-80-68-72-49-43-1-53-39-63-67-84-38-29-95-77-51-4-36-32-75-12-94-81-57-27-92-66,9-83-71-20-73-58-16-14-10-31-90-97-22-44-46-62-5-48-89-78-52-87-15-21-93-69-65-64-3-96-55-79-30-88-41-7-91-0-74-18-17-23-37-35-98-25-76-59-61-42,2358977,13179,18463,31642
nn,1-43-49-72-67-84-38-29-95-77-51-4-36-32-75-12-94-81-63-39-53-68-80-24-60-50-86-8-6-56-19-11-26-85-34-61-59-76-22-97-90-44-31-10-14-16-73-20-58-71,65-64-3-96-55-79-30-88-41-7-91-0-62-5-48-89-9-83-35-37-23-17-78-52-87-15-21-93-69-18-74-25-98-46-92-27-66-57-54-82-33-28-45-2-42-13-70-40-99-47,2325015,12161,18443,30604
nn,28-45-2-42-13-70-40-99-47-51-77-95-4-36-32-75-12-94-81-49-43-72-67-84-38-29-33-82-54-11-26-85-34-19-56-6-8-86-50-60-24-80-68-63-39-53-1-66-27-92,44-90-97-22-59-61-76-57-0-62-5-48-89-9-83-71-20-73-58-16-14-10-31-46-91-7-41-88-30-79-55-96-74-18-52-78-17-23-37-35-98-93-21-15-87-69-65-64-3-25,2290322,12480,14147,26627
nn,51-77-95-4-36-32-75-12-94-81-49-43-72-67-84-38-29-47-99-70-40-13-2-45-28-33-82-54-11-26-85-34-19-56-6-8-86-50-60-24-80-68-63-39-53-1-66-27-92-57,0-62-5-48-89-9-83-71-20-73-58-16-14-10-31-90-97-22-44-46-91-7-41-88-30-79-55-96-74-18-52-78-17-23-37-35-98-93-21-15-87-69-65-64-3-25-76-59-61-42,2318207,12269,16476,28745
nn,94-12-32-75-81-49-43-72-67-84-38-29-95-77-51-4-36-47-99-70-40-13-2-45-28-33-82-54-11-26-85-34-19-56-6-8-86-50-60-24-80-68-63-39-53-1-66-27-92-57,7-91-0-62-5-48-89-9-83-71-20-73-58-16-14-10-31-90-97-22-44-46-76-59-61-42-41-88-30-79-55-96-74-18-52-78-17-23-37-35-98-93-21-15-87-69-65-64-3-25,2335676,12747,15698,28445
nn,6-8-56-86-50-60-24-80-68-72-49-43-1-53-39-63-67-84-38-29-95-77-51-4-36-32-75-12-94-81-47-99-70-40-13-2-45-28-33-82-54-11-26-85-34-19-61-59-76-22,10-14-16-31-90-97-44-46-62-5-48-89-9-83-71-20-73-58-35-37-23-17-78-52-87-15-21-93-69-65-64-3-96-55-79-30-88-41-7-91-0-92-27-66-57-74-18-25-98-42,2334824,11735,18933,30668
nn,0-62-5-48-89-9-83-71-20-73-58-16-14-10-31-90-97-22-44-46-92-27-66-57-60-24-80-68-72-49-43-1-53-39-63-67-84-38-29-95-77-51-4-36-32-75-12-94-81-47,17-23-37-35-98-78-52-87-15-21-93-69-65-64-3-96-55-79-30-88-41-7-91-74-18-25-76-59-61-85-26-11-19-56-6-8-86-50-54-82-33-28-45-2-42-13-70-40-99-34,2399815,14094,16998,31092
nn,75-32-12-94-81-49-43-72-67-84-38-29-95-77-51-4-36-47-99-70-40-13-2-45-28-33-82-54-11-26-85-34-19-56-6-8-86-50-60-24-80-68-63-39-53-1-66-27-92-57,64-65-3-96-55-79-30-88-41-7-91-0-62-5-48-89-9-83-71-20-73-58-16-14-10-31-90-97-22-44-46-76-59-61-42-74-18-52-78-17-23-37-35-98-93-21-15-87-69-25,2621082,12707,15267,27974
nn,35-37-23-17-78-52-87-15-21-93-69-65-64-3-96-55-79-30-88-41-7-91-0-62-5-48-89-9-83-71-20-73-58-16-14-10-31-90-97-22-44-46-92-27-66-57-60-24-80-68,11-26-85-34-19-56-6-8-86-50-76-59-61-54-82-33-28-45-2-42-13-70-40-99-47-51-77-95-4-36-32-75-12-94-81-49-43-72-67-84-38-29-1-53-39-63-74-18-25-98,2782324,12500,17658,30158
nn,89-48-5-62-0-91-7-41-88-30-79-55-96-74-18-52-78-17-23-37-35-98-83-9-71-20-73-58-16-14-10-31-90-97-22-44-46-92-27-66-57-60-24-80-68-72-49-43-1-53,29-38-95-77-51-4-36-32-75-12-94-81-67-84-33-82-54-11-26-85-34-19-56-6-8-86-50-76-59-61-45-2-42-28-13-70-40-99-47-63-39-3-64-65-25-69-21-15-87-93,2512286,12853,18096,30949
nn,81-94-12-32-75-36-4-77-51-95-38-29-47-99-70-40-13-2-45-28-33-82-54-11-26-85-34-19-56-6-8-86-50-60-24-80-68-72-49-43-1-53-39-63-67-84-42-61-59-76,17-23-37-35-98-83-9-71-20-73-58-16-14-10-31-90-97-22-44-46-62-5-48-89-78-52-87-15-21-93-69-65-64-3-96-55-79-30-88-41-7-91-0-92-27-66-57-74-18-25,2755918,13252,13528,26780
nn,47-99-70-40-13-2-45-28-33-82-54-11-26-85-34-19-56-6-8-86-50-60-24-80-68-72-49-43-1-53-39-63-67-84-38-29-95-77-51-4-36-32-75-12-94-81-57-27-92-66,52-78-17-23-37-35-98-83-9-71-20-73-58-16-14-10-31-90-97-22-44-46-62-5-48-89-18-74-96-55-79-30-88-41-7-91-0-76-59-61-42-3-64-65-25-69-21-15-87-93,3536552,13003,15809,28812
nn,35-37-23-17-78-52-87-15-21-93-69-65-64-3-96-55-79-30-88-41-7-91-0-62-5-48-89-9-83-71-20-73-58-16-14-10-31-90-97-22-44-46-92-27-66-57-60-24-80-68,19-11-26-85-34-61-59-76-56-6-8-86-50-54-82-33-28-45-2-42-13-70-40-99-47-51-77-95-4-36-32-75-12-94-81-49-43-72-67-84-38-29-1-53-39-63-74-18-25-98,2561784,12500,17386,29886
nn,57-27-92-66-0-62-5-48-89-9-83-71-20-73-58-16-14-10-31-90-97-22-44-46-91-7-41-88-30-79-55-96-74-18-52-78-17-23-37-35-98-93-21-15-87-69-65-64-3-25,6-8-56-86-50-60-24-80-68-72-49-43-1-53-39-63-67-84-38-29-95-77-51-4-36-32-75-12-94-81-47-99-70-40-13-2-45-28-33-82-54-11-26-85-34-19-61-59-76-42,2572073,13603,12502,26105
nn,16-14-10-31-90-97-22-44-46-62-5-48-89-9-83-71-20-73-58-35-37-23-17-78-52-87-15-21-93-69-65-64-3-96-55-79-30-88-41-7-91-0-92-27-66-57-60-24-80-68,94-12-32-75-81-49-43-72-67-84-38-29-95-77-51-4-36-47-99-70-40-13-2-45-28-33-82-54-11-26-85-34-19-56-6-8-86-50-76-59-61-42-63-39-53-1-74-18-25-98,2634064,12150,20705,32855
nn,37-23-17-78-52-87-15-21-93-69-65-64-3-96-55-79-30-88-41-7-91-0-62-5-48-89-9-83-71-20-73-58-16-14-10-31-90-97-22-44-46-92-27-66-57-60-24-80-68-72,38-29-95-77-51-4-36-32-75-12-94-81-49-43-1-53-39-63-67-84-33-82-54-11-26-85-34-19-56-6-8-86-50-76-59-61-45-2-42-28-13-70-40-99-47-74-18-25-35-98,3405548,12936,19917,32853
nn,11-26-85-34-19-56-6-8-86-50-60-24-80-68-72-49-43-1-53-39-63-67-84-38-29-95-77-51-4-36-32-75-12-94-81-47-99-70-40-13-2-45-28-33-82-54-42-61-59-76,74-18-52-78-17-23-37-35-98-83-9-71-20-73-58-16-14-10-31-90-97-22-44-46-62-5-48-89-91-7-41-88-30-79-55-96-3-64-65-25-69-21-15-87-93-0-92-27-66-57,2739320,12315,13541,25856
nn,50-86-8-6-56-19-11-26-85-34-61-59-76-22-97-90-44-31-10-14-16-73-20-58-71-9-83-35-37-23-17-78-52-87-15-21-93-69-65-64-3-96-55-79-30-88-41-7-91-0,92-27-66-57-60-24-80-68-72-49-43-1-53-39-63-67-84-38-29-95-77-51-4-36-32-75-12-94-81-47-99-70-40-13-2-45-28-33-82-54-42-46-62-5-48-89-18-74-25-98,4026339,10363,17757,28120
nn,6-8-56-86-50-60-24-80-68-72-49-43-1-53-39-63-67-84-38-29-95-77-51-4-36-32-75-12-94-81-47-99-70-40-13-2-45-28-33-82-54-11-26-85-34-19-61-59-76-22,21-15-87-93-69-52-78-17-23-37-35-98-83-9-71-20-73-58-16-14-10-31-90-97-44-46-62-5-48-89-18-74-96-55-79-30-88-41-7-91-0-92-27-66-57-42-3-64-65-25,2684202,11735,16148,27883
nn,23-37-35-98-17-78-52-87-15-21-93-69-65-64-3-96-55-79-30-88-41-7-91-0-62-5-48-89-9-83-71-20-73-58-16-14-10-31-90-97-22-44-46-92-27-66-57-60-24-80,19-11-26-85-34-61-59-76-56-6-8-86-50-68-72-49-43-1-53-39-63-67-84-38-29-95-77-51-4-36-32-75-12-94-81-47-99-70-40-13-2-45-28-33-82-54-42-74-18-25,3207860,12905,17742,30647
nn,0-62-5-48-89-9-83-71-20-73-58-16-14-10-31-90-97-22-44-46-92-27-66-57-60-24-80-68-72-49-43-1-53-39-63-67-84-38-29-95-77-51-4-36-32-75-12-94-81-47,50-86-8-6-56-19-11-26-85-34-61-59-76-54-82-33-28-45-2-42-13-70-40-99-7-91-74-18-52-78-17-23-37-35-98-93-21-15-87-69-65-64-3-96-55-79-30-88-41-25,2467064,14094,16736,30830
nn,50-86-8-6-56-19-11-26-85-34-61-59-76-22-97-90-44-31-10-14-16-73-20-58-71-9-83-35-37-23-17-78-52-87-15-21-93-69-65-64-3-96-55-79-30-88-41-7-91-0,32-75-12-94-81-49-43-72-67-84-38-29-95-77-51-4-36-47-99-70-40-13-2-45-28-33-82-54-42-24-80-60-57-27-92-66-68-63-39-53-1-46-62-5-48-89-18-74-25-98,2316286,10363,20504,30867
nn,85-26-11-19-56-6-8-86-50-60-24-80-68-72-49-43-1-53-39-63-67-84-38-29-95-77-51-4-36-32-75-12-94-81-47-99-70-40-13-2-45-28-33-82-54-34-61-59-76-22,35-37-23-17-78-52-87-15-21-93-69-65-64-3-96-55-79-30-88-41-7-91-0-62-5-48-89-9-83-71-20-73-58-16-14-10-31-90-97-44-46-92-27-66-57-74-18-25-98-42,6081033,11794,19521,31315
nn,9-83-71-20-73-58-16-14-10-31-90-97-22-44-46-62-5-48-89-78-52-87-15-21-93-69-65-64-3-96-55-79-30-88-41-7-91-0-92-27-66-57-60-24-80-68-72-49-43-1,70-40-99-47-13-2-45-28-33-82-54-11-26-85-34-19-56-6-8-86-50-76-59-61-42-29-38-95-77-51-4-36-32-75-12-94-81-67-84-63-39-53-74-18-17-23-37-35-98-25,2893904,12811,19410,32221
nn,31-10-14-16-73-20-58-71-9-83-35-37-23-17-78-52-87-15-21-93-69-65-64-3-96-55-79-30-88-41-7-91-0-62-5-48-89-18-74-25-98-46-90-97-22-44-59-61-76-19,49-43-72-67-84-38-29-95-77-51-4-36-32-75-12-94-81-1-53-39-63-68-80-24-60-50-86-8-6-56-11-26-85-34-54-82-33-28-45-2-42-13-70-40-99-47-57-27-92-66,2498030,14877,12661,27538
nn,85-26-11-19-56-6-8-86-50-60-24-80-68-72-49-43-1-53-39-63-67-84-38-29-95-77-51-4-36-32-75-12-94-81-47-99-70-40-13-2-45-28-33-82-54-34-61-59-76-22,79-30-88-41-7-91-0-62-5-48-89-9-83-71-20-73-58-16-14-10-31-90-97-44-46-92-27-66-57-74-18-52-78-17-23-37-35-98-93-21-15-87-69-65-64-3-96-55-25-42,6982989,11794,18989,30783
nn,80-24-60-50-86-8-6-56-19-11-26-85-34-61-59-76-22-97-90-44-31-10-14-16-73-20-58-71-9-83-35-37-23-17-78-52-87-15-21-93-69-65-64-3-96-55-79-30-88-41,51-77-95-4-36-32-75-12-94-81-49-43-72-67-84-38-29-47-99-70-40-13-2-45-28-33-82-54-42-68-63-39-53-1-66-27-92-57-0-62-5-48-89-18-74-91-7-46-98-25,2916522,10298,20576,30874
nn,22-97-90-44-31-10-14-16-73-20-58-71-9-83-35-37-23-17-78-52-87-15-21-93-69-65-64-3-96-55-79-30-88-41-7-91-0-62-5-48-89-18-74-25-98-46-92-27-66-57,60-24-80-68-72-49-43-1-53-39-63-67-84-38-29-95-77-51-4-36-32-75-12-94-81-47-99-70-40-13-2-45-28-33-82-54-11-26-85-34-19-56-6-8-86-50-76-59-61-42,2604386,14257,13107,27364
nn,34-85-26-11-19-56-6-8-86-50-60-24-80-68-72-49-43-1-53-39-63-67-84-38-29-95-77-51-4-36-32-75-12-94-81-47-99-70-40-13-2-45-28-33-82-54-42-61-59-76,79-30-88-41-7-91-0-62-5-48-89-9-83-71-20-73-58-16-14-10-31-90-97-22-44-46-92-27-66-57-74-18-52-78-17-23-37-35-98-93-21-15-87-69-65-64-3-96-55-25,2730956,12148,13519,25667
nn,87-15-21-93-69-52-78-17-23-37-35-98-83-9-71-20-73-58-16-14-10-31-90-97-22-44-46-62-5-48-89-18-74-96-55-79-30-88-41-7-91-0-92-27-66-57-60-24-80-68,63-39-53-1-43-49-72-67-84-38-29-95-77-51-4-36-32-75-12-94-81-47-99-70-40-13-2-45-28-33-82-54-11-26-85-34-19-56-6-8-86-50-76-59-61-42-3-64-65-25,2901096,13146,16967,30113
nn,14-16-10-31-90-97-22-44-46-62-5-48-89-9-83-71-20-73-58-35-37-23-17-78-52-87-15-21-93-69-65-64-3-96-55-79-30-88-41-7-91-0-92-27-66-57-60-24-80-68,99-70-40-13-2-45-28-33-82-54-11-26-85-34-19-56-6-8-86-50-76-59-61-42-47-51-77-95-4-36-32-75-12-94-81-49-43-72-67-84-38-29-1-53-39-63-74-18-25-98,2613369,12142,19690,31832
nn,88-41-30-79-55-96-74-18-52-78-17-23-37-35-98-83-9-71-20-73-58-16-14-10-31-90-97-22-44-46-62-5-48-89-91-7-0-92-27-66-57-60-24-80-68-72-49-43-1-53,85-26-11-19-56-6-8-86-50-76-59-61-34-54-82-33-28-45-2-42-13-70-40-99-47-51-77-95-4-36-32-75-12-94-81-38-29-84-67-63-39-3-64-65-25-69-21-15-87-93,7068852,12432,15537,27969
nn,14-16-10-31-90-97-22-44-46-62-5-48-89-9-83-71-20-73-58-35-37-23-17-78-52-87-15-21-93-69-65-64-3-96-55-79-30-88-41-7-91-0-92-27-66-57-60-24-80-68,94-12-32-75-81-49-43-72-67-84-38-29-95-77-51-4-36-47-99-70-40-13-2-45-28-33-82-54-11-26-85-34-19-56-6-8-86-50-76-59-61-42-63-39-53-1-74-18-25-98,3255961,12142,20705,32847
nn,32-75-12-94-81-49-43-72-67-84-38-29-95-77-51-4-36-47-99-70-40-13-2-45-28-33-82-54-11-26-85-34-19-56-6-8-86-50-60-24-80-68-63-39-53-1-66-27-92-57,62-5-48-89-9-83-71-20-73-58-16-14-10-31-90-97-22-44-46-0-91-7-41-88-30-79-55-96-74-18-52-78-17-23-37-35-98-93-21-15-87-69-65-64-3-25-76-59-61-42,2645387,12689,16434,29123
nn,29-38-95-77-51-4-36-32-75-12-94-81-49-43-72-67-84-80-24-60-50-86-8-6-56-19-11-26-85-34-61-59-76-22-97-90-44-31-10-14-16-73-20-58-71-9-83-35-37-23,70-40-99-47-13-2-45-28-33-82-54-42-68-63-39-53-1-66-27-92-57-0-62-5-48-89-78-52-87-15-21-93-69-65-64-3-96-55-79-30-88-41-7-91-74-18-17-98-46-25,2916124,12655,20620,33275
nn,97-90-44-22-59-61-76-19-11-26-85-34-56-6-8-86-50-60-24-80-68-72-49-43-1-53-39-63-67-84-38-29-95-77-51-4-36-32-75-12-94-81-47-99-70-40-13-2-45-28,79-30-88-41-7-91-0-62-5-48-89-9-83-71-20-73-58-16-14-10-31-46-92-27-66-57-54-82-33-42-74-18-52-78-17-23-37-35-98-93-21-15-87-69-65-64-3-96-55-25,3172504,12681,15991,28672
nn,31-10-14-16-73-20-58-71-9-83-35-37-23-17-78-52-87-15-21-93-69-65-64-3-96-55-79-30-88-41-7-91-0-62-5-48-89-18-74-25-98-46-90-97-22-44-59-61-76-19,94-12-32-75-81-49-43-72-67-84-38-29-95-77-51-4-36-47-99-70-40-13-2-45-28-33-82-54-11-26-85-34-56-6-8-86-50-60-24-80-68-63-39-53-1-66-27-92-57-42,2351571,14877,14329,29206
nn,76-59-61-85-26-11-19-56-6-8-86-50-60-24-80-68-72-49-43-1-53-39-63-67-84-38-29-95-77-51-4-36-32-75-12-94-81-47-99-70-40-13-2-45-28-33-82-54-34-22,23-37-35-98-17-78-52-87-15-21-93-69-65-64-3-96-55-79-30-88-41-7-91-0-62-5-48-89-9-83-71-20-73-58-16-14-10-31-90-97-44-46-92-27-66-57-74-18-25-42,2438851,11786,19124,30910
nn,83-9-71-20-73-58-16-14-10-31-90-97-22-44-46-62-5-48-89-78-52-87-15-21-93-69-65-64-3-96-55-79-30-88-41-7-91-0-92-27-66-57-60-24-80-68-72-49-43-1,42-2-45-28-13-70-40-99-47-51-77-95-4-36-32-75-12-94-81-38-29-84-67-63-39-53-50-86-8-6-56-19-11-26-85-34-61-59-76-54-82-33-74-18-17-23-37-35-98-25,4694202,12906,19307,32213
nn,27-92-57-60-24-80-68-72-49-43-1-53-39-63-67-84-38-29-95-77-51-4-36-32-75-12-94-81-47-99-70-40-13-2-45-28-33-82-54-11-26-85-34-19-56-6-8-86-50-76,64-65-3-96-55-79-30-88-41-7-91-0-62-5-48-89-9-83-71-20-73-58-16-14-10-31-90-97-22-44-46-66-74-18-52-78-17-23-37-35-98-93-21-15-87-69-25-59-61-42,7179144,11737,19174,30911
nn,56-6-8-86-50-60-24-80-68-72-49-43-1-53-39-63-67-84-38-29-95-77-51-4-36-32-75-12-94-81-47-99-70-40-13-2-45-28-33-82-54-11-26-85-34-19-61-59-76-22,96-55-79-30-88-41-7-91-0-62-5-48-89-9-83-71-20-73-58-16-14-10-31-90-97-44-46-92-27-66-57-74-18-52-78-17-23-37-35-98-93-21-15-87-69-65-64-3-25-42,2269368,11636,18730,30366
nn,42-2-45-28-13-70-40-99-47-51-77-95-4-36-32-75-12-94-81-49-43-72-67-84-38-29-33-82-54-11-26-85-34-19-56-6-8-86-50-60-24-80-68-63-39-53-1-66-27-92,71-20-73-58-16-14-10-31-90-97-22-44-46-62-5-48-89-9-83-35-37-23-17-78-52-87-15-21-93-69-65-64-3-96-55-79-30-88-41-7-91-0-74-18-25-98-59-61-76-57,2455199,12584,15943,28527
nn,31-10-14-16-73-20-58-71-9-83-35-37-23-17-78-52-87-15-21-93-69-65-64-3-96-55-79-30-88-41-7-91-0-62-5-48-89-18-74-25-98-46-90-97-22-44-59-61-76-19,67-84-38-29-95-77-51-4-36-32-75-12-94-81-49-43-72-68-63-39-53-1-80-24-60-50-86-8-6-56-11-26-85-34-54-82-33-28-45-2-42-13-70-40-99-47-57-27-92-66,1833027,14877,13126,28003
nn,32-75-12-94-81-49-43-72-67-84-38-29-95-77-51-4-36-47-99-70-40-13-2-45-28-33-82-54-11-26-85-34-19-56-6-8-86-50-60-24-80-68-63-39-53-1-66-27-92-57,16-14-10-31-90-97-22-44-46-62-5-48-89-9-83-71-20-73-58-35-37-23-17-78-52-87-15-21-93-69-65-64-3-96-55-79-30-88-41-7-91-0-74-18-25-98-59-61-76-42,1422542,12689,17543,30232
nn,73-20-58-71-9-83-35-37-23-17-78-52-87-15-21-93-69-65-64-3-96-55-79-30-88-41-7-91-0-62-5-48-89-18-74-25-98-16-14-10-31-90-97-22-44-46-92-27-66-57,72-49-43-1-53-39-63-68-80-24-60-50-86-8-6-56-19-11-26-85-34-61-59-76-54-82-33-28-45-2-42-13-70-40-99-47-51-77-95-4-36-32-75-12-94-81-38-29-84-67,2383803,14846,10548,25394
nn,89-48-5-62-0-91-7-41-88-30-79-55-96-74-18-52-78-17-23-37-35-98-83-9-71-20-73-58-16-14-10-31-90-97-22-44-46-92-27-66-57-60-24-80-68-72-49-43-1-53,85-26-11-19-56-6-8-86-50-76-59-61-34-54-82-33-28-45-2-42-13-70-40-99-47-51-77-95-4-36-32-75-12-94-81-38-29-84-67-63-39-3-64-65-25-69-21-15-87-93,1570697,12853,15537,28390
nn,81-94-12-32-75-36-4-77-51-95-38-29-47-99-70-40-13-2-45-28-33-82-54-11-26-85-34-19-56-6-8-86-50-60-24-80-68-72-49-43-1-53-39-63-67-84-42-61-59-76,98-35-37-23-17-78-52-87-15-21-93-69-65-64-3-96-55-79-30-88-41-7-91-0-62-5-48-89-9-83-71-20-73-58-16-14-10-31-90-97-22-44-46-92-27-66-57-74-18-25,1426631,13252,13699,26951
nn,69-21-15-87-93-17-23-37-35-98-83-9-71-20-73-58-16-14-10-31-90-97-22-44-46-62-5-48-89-78-52-18-74-96-55-79-30-88-41-7-91-0-92-27-66-57-60-24-80-68,32-75-12-94-81-49-43-72-67-84-38-29-95-77-51-4-36-47-99-70-40-13-2-45-28-33-82-54-11-26-85-34-19-56-6-8-86-50-76-59-61-42-63-39-53-1-3-64-65-25,2441038,13163,18455,31618
nn,32-75-12-94-81-49-43-72-67-84-38-29-95-77-51-4-36-47-99-70-40-13-2-45-28-33-82-54-11-26-85-34-19-56-6-8-86-50-60-24-80-68-63-39-53-1-66-27-92-57,69-21-15-87-93-17-23-37-35-98-83-9-71-20-73-58-16-14-10-31-90-97-22-44-46-62-5-48-89-78-52-18-74-96-55-79-30-88-41-7-91-0-76-59-61-42-3-64-65-25,2363936,12689,15801,28490
nn,71-20-73-58-16-14-10-31-90-97-22-44-46-62-5-48-89-9-83-35-37-23-17-78-52-87-15-21-93-69-65-64-3-96-55-79-30-88-41-7-91-0-92-27-66-57-60-24-80-68,42-2-45-28-13-70-40-99-47-51-77-95-4-36-32-75-12-94-81-49-43-72-67-84-38-29-33-82-54-11-26-85-34-19-56-6-8-86-50-76-59-61-63-39-53-1-74-18-25-98,2383991,12108,18814,30922
nn,40-70-99-47-13-2-45-28-33-82-54-11-26-85-34-19-56-6-8-86-50-60-24-80-68-72-49-43-1-53-39-63-67-84-38-29-95-77-51-4-36-32-75-12-94-81-57-27-92-66,65-64-3-96-55-79-30-88-41-7-91-0-62-5-48-89-9-83-71-20-73-58-16-14-10-31-90-97-22-44-46-76-59-61-42-74-18-52-78-17-23-37-35-98-93-21-15-87-69-25,2328394,13186,15238,28424
nn,92-27-66-57-60-24-80-68-72-49-43-1-53-39-63-67-84-38-29-95-77-51-4-36-32-75-12-94-81-47-99-70-40-13-2-45-28-33-82-54-11-26-85-34-19-56-6-8-86-50,91-7-41-88-30-79-55-96-74-18-52-78-17-23-37-35-98-83-9-71-20-73-58-16-14-10-31-90-97-22-44-46-62-5-48-89-87-15-21-93-69-65-64-3-25-0-76-59-61-42,2278849,11496,16231,27727
nn,99-70-40-13-2-45-28-33-82-54-11-26-85-34-19-56-6-8-86-50-60-24-80-68-72-49-43-1-53-39-63-67-84-38-29-95-77-51-4-36-32-75-12-94-81-47-42-61-59-76,9-83-71-20-73-58-16-14-10-31-90-97-22-44-46-62-5-48-89-78-52-87-15-21-93-69-65-64-3-96-55-79-30-88-41-7-91-0-92-27-66-57-74-18-17-23-37-35-98-25,2256853,13634,14854,28488
nn,0-62-5-48-89-9-83-71-20-73-58-16-14-10-31-90-97-22-44-46-92-27-66-57-60-24-80-68-72-49-43-1-53-39-63-67-84-38-29-95-77-51-4-36-32-75-12-94-81-47,42-2-45-28-13-70-40-99-33-82-54-11-26-85-34-19-56-6-8-86-50-76-59-61-91-7-41-88-30-79-55-96-74-18-52-78-17-23-37-35-98-93-21-15-87-69-65-64-3-25,1819231,14094,15939,30033
nn,25-64-65-3-96-55-79-30-88-41-7-91-0-62-5-48-89-9-83-71-20-73-58-16-14-10-31-90-97-22-44-46-92-27-66-57-60-24-80-68-72-49-43-1-53-39-63-67-84-38,35-37-23-17-78-52-87-15-21-93-69-18-74-98-59-61-76-19-11-26-85-34-56-6-8-86-50-54-82-33-28-45-2-42-13-70-40-99-47-51-77-95-4-36-32-75-12-94-81-29,3545002,14285,16824,31109
nn,16-14-10-31-90-97-22-44-46-62-5-48-89-9-83-71-20-73-58-35-37-23-17-78-52-87-15-21-93-69-65-64-3-96-55-79-30-88-41-7-91-0-92-27-66-57-60-24-80-68,8-6-56-86-50-19-11-26-85-34-61-59-76-54-82-33-28-45-2-42-13-70-40-99-47-51-77-95-4-36-32-75-12-94-81-49-43-72-67-84-38-29-1-53-39-63-74-18-25-98,2323923,12150,17713,29863
nn,82-54-33-28-45-2-42-13-70-40-99-47-51-77-95-4-36-32-75-12-94-81-49-43-72-67-84-38-29-8-6-56-86-50-60-24-80-68-63-39-53-1-66-27-92-57-76-59-61-85,93-21-15-87-52-78-17-23-37-35-98-83-9-71-20-73-58-16-14-10-31-90-97-22-44-46-62-5-48-89-18-74-96-55-79-30-88-41-7-91-0-3-64-65-25-69-19-11-26-34,2380140,12337,16598,28935
nn,80-24-60-50-86-8-6-56-19-11-26-85-34-61-59-76-22-97-90-44-31-10-14-16-73-20-58-71-9-83-35-37-23-17-78-52-87-15-21-93-69-65-64-3-96-55-79-30-88-41,84-67-72-49-43-1-53-39-63-68-57-27-92-66-0-62-5-48-89-18-74-91-7-46-98-25-54-82-33-28-45-2-42-13-70-40-99-47-51-77-95-4-36-32-75-12-94-81-38-29,2507983,10298,18089,28387
nn,24-80-60-50-86-8-6-56-19-11-26-85-34-61-59-76-22-97-90-44-31-10-14-16-73-20-58-71-9-83-35-37-23-17-78-52-87-15-21-93-69-65-64-3-96-55-79-30-88-41,99-70-40-13-2-45-28-33-82-54-42-47-51-77-95-4-36-32-75-12-94-81-49-43-72-67-84-38-29-68-63-39-53-1-66-27-92-57-0-62-5-48-89-18-74-91-7-46-98-25,2413575,10338,20800,31138
nn,45-2-42-28-13-70-40-99-47-51-77-95-4-36-32-75-12-94-81-49-43-72-67-84-38-29-33-82-54-11-26-85-34-19-56-6-8-86-50-60-24-80-68-63-39-53-1-66-27-92,87-15-21-93-69-52-78-17-23-37-35-98-83-9-71-20-73-58-16-14-10-31-90-97-22-44-46-62-5-48-89-18-74-96-55-79-30-88-41-7-91-0-57-76-59-61-3-64-65-25,1353287,12631,14287,26918
nn,25-64-65-3-96-55-79-30-88-41-7-91-0-62-5-48-89-9-83-71-20-73-58-16-14-10-31-90-97-22-44-46-92-27-66-57-60-24-80-68-72-49-43-1-53-39-63-67-84-38,13-2-45-28-33-82-54-11-26-85-34-19-56-6-8-86-50-76-59-61-42-70-40-99-47-51-77-95-4-36-32-75-12-94-81-29-74-18-52-78-17-23-37-35-98-93-21-15-87-69,1595661,14285,18051,32336
nn,11-26-85-34-19-56-6-8-86-50-60-24-80-68-72-49-43-1-53-39-63-67-84-38-29-95-77-51-4-36-32-75-12-94-81-47-99-70-40-13-2-45-28-33-82-54-42-61-59-76,98-35-37-23-17-78-52-87-15-21-93-69-65-64-3-96-55-79-30-88-41-7-91-0-62-5-48-89-9-83-71-20-73-58-16-14-10-31-90-97-22-44-46-92-27-66-57-74-18-25,1948238,12315,13699,26014
nn,46-31-10-14-16-73-20-58-71-9-83-35-37-23-17-78-52-87-15-21-93-69-65-64-3-96-55-79-30-88-41-7-91-0-62-5-48-89-18-74-25-98-44-90-97-22-59-61-76-19,45-2-42-28-13-70-40-99-47-51-77-95-4-36-32-75-12-94-81-49-43-72-67-84-38-29-33-82-54-11-26-85-34-56-6-8-86-50-60-24-80-68-63-39-53-1-66-27-92-57,2224635,14874,12668,27542
nn,73-20-58-71-9-83-35-37-23-17-78-52-87-15-21-93-69-65-64-3-96-55-79-30-88-41-7-91-0-62-5-48-89-18-74-25-98-16-14-10-31-90-97-22-44-46-92-27-66-57,59-61-76-19-11-26-85-34-56-6-8-86-50-60-24-80-68-72-49-43-1-53-39-63-67-84-38-29-95-77-51-4-36-32-75-12-94-81-47-99-70-40-13-2-45-28-33-82-54-42,2202610,14846,12492,27338
nn,69-21-15-87-93-17-23-37-35-98-83-9-71-20-73-58-16-14-10-31-90-97-22-44-46-62-5-48-89-78-52-18-74-96-55-79-30-88-41-7-91-0-92-27-66-57-60-24-80-68,33-82-54-11-26-85-34-19-56-6-8-86-50-76-59-61-45-2-42-28-13-70-40-99-47-51-77-95-4-36-32-75-12-94-81-49-43-72-67-84-38-29-1-53-39-63-3-64-65-25,2282899,13163,16992,30155
nn,91-7-41-88-30-79-55-96-74-18-52-78-17-23-37-35-98-83-9-71-20-73-58-16-14-10-31-90-97-22-44-46-62-5-48-89-87-15-21-93-69-65-64-3-25-0-92-27-66-57,1-43-49-72-67-84-38-29-95-77-51-4-36-32-75-12-94-81-63-39-53-68-80-24-60-50-86-8-6-56-19-11-26-85-34-61-59-76-54-82-33-28-45-2-42-13-70-40-99-47,2194554,13218,11983,25201
nn,7-91-0-62-5-48-89-9-83-71-20-73-58-16-14-10-31-90-97-22-44-46-92-27-66-57-60-24-80-68-72-49-43-1-53-39-63-67-84-38-29-95-77-51-4-36-32-75-12-94,40-70-99-47-13-2-45-28-33-82-54-11-26-85-34-19-56-6-8-86-50-76-59-61-42-81-88-41-30-79-55-96-74-18-52-78-17-23-37-35-98-93-21-15-87-69-65-64-3-25,2399208,12977,18603,31580
nn,65-64-3-96-55-79-30-88-41-7-91-0-62-5-48-89-9-83-71-20-73-58-16-14-10-31-90-97-22-44-46-92-27-66-57-60-24-80-68-72-49-43-1-53-39-63-67-84-38-29,87-15-21-93-69-52-78-17-23-37-35-98-18-74-25-76-59-61-85-26-11-19-56-6-8-86-50-54-82-33-28-45-2-42-13-70-40-99-47-51-77-95-4-36-32-75-12-94-81-34,2231545,14159,18092,32251
nn,67-84-38-29-95-77-51-4-36-32-75-12-94-81-49-43-72-68-63-39-53-1-80-24-60-50-86-8-6-56-19-11-26-85-34-61-59-76-22-97-90-44-31-10-14-16-73-20-58-71,91-7-41-88-30-79-55-96-74-18-52-78-17-23-37-35-98-83-9-89-48-5-62-0-92-27-66-57-46-87-15-21-93-69-65-64-3-25-54-82-33-28-45-2-42-13-70-40-99-47,2474401,12151,18074,30225
nn,41-88-30-79-55-96-74-18-52-78-17-23-37-35-98-83-9-71-20-73-58-16-14-10-31-90-97-22-44-46-62-5-48-89-91-7-0-92-27-66-57-60-24-80-68-72-49-43-1-53,85-26-11-19-56-6-8-86-50-76-59-61-34-54-82-33-28-45-2-42-13-70-40-99-47-51-77-95-4-36-32-75-12-94-81-38-29-84-67-63-39-3-64-65-25-69-21-15-87-93,2277619,12506,15537,28043
nn,49-43-72-67-84-38-29-95-77-51-4-36-32-75-12-94-81-1-53-39-63-68-80-24-60-50-86-8-6-56-19-11-26-85-34-61-59-76-22-97-90-44-31-10-14-16-73-20-58-71,92-27-66-57-0-62-5-48-89-9-83-35-37-23-17-78-52-87-15-21-93-69-65-64-3-96-55-79-30-88-41-7-91-74-18-25-98-46-54-82-33-28-45-2-42-13-70-40-99-47,2283366,11794,17239,29033
nn,70-40-99-47-13-2-45-28-33-82-54-11-26-85-34-19-56-6-8-86-50-60-24-80-68-72-49-43-1-53-39-63-67-84-38-29-95-77-51-4-36-32-75-12-94-81-57-27-92-66,3-64-65-25-69-21-15-87-93-17-23-37-35-98-83-9-71-20-73-58-16-14-10-31-90-97-22-44-46-62-5-48-89-78-52-18-74-96-55-79-30-88-41-7-91-0-76-59-61-42,1670821,13179,15801,28980
nn,63-39-53-1-43-49-72-67-84-38-29-95-77-51-4-36-32-75-12-94-81-68-80-24-60-50-86-8-6-56-19-11-26-85-34-61-59-76-22-97-90-44-31-10-14-16-73-20-58-71,82-54-33-28-45-2-42-13-70-40-99-47-57-27-92-66-0-62-5-48-89-9-83-35-37-23-17-78-52-87-15-21-93-69-65-64-3-96-55-79-30-88-41-7-91-74-18-25-98-46,1455046,11808,16853,28661
nn,86-50-60-24-80-68-72-49-43-1-53-39-63-67-84-38-29-95-77-51-4-36-32-75-12-94-81-47-99-70-40-13-2-45-28-33-82-54-11-26-85-34-19-56-6-8-61-59-76-22,30-79-41-88-7-91-0-62-5-48-89-9-83-71-20-73-58-16-14-10-31-90-97-44-46-92-27-66-57-74-18-52-78-17-23-37-35-98-93-21-15-87-69-65-64-3-96-55-25-42,2311287,11933,19163,31096
ls-random,18-74-41-53-39-63-72-80-24-6-76-22-16-58-31-90-70-99-13-84-67-88-79-55-3-69-15-52-46-61-85-26-11-95-4-36-94-81-92-62-83-17-23-37-98-35-73-71-9-89,45-2-28-91-48-5-0-27-56-19-97-14-20-93-21-87-78-29-51-77-68-66-30-7-57-60-50-86-8-42-40-47-96-64-25-65-10-44-59-34-38-12-32-75-1-43-49-54-82-33,262467574,24952,31947,56899
ls-random,96-81-94-38-8-6-11-54-45-2-4-36-74-17-37-0-57-50-56-86-24-63-53-46-90-97-59-34-85-33-28-29-32-75-12-49-10-58-16-40-70-99-55-25-65-69-15-87-52-18,27-92-35-98-23-83-9-76-82-13-42-26-19-61-22-44-31-14-73-20-71-62-5-21-93-78-89-48-91-3-64-79-30-88-72-67-80-60-66-7-41-84-47-51-77-95-43-1-39-68,95100661,33422,24254,57676
ls-random,68-80-24-19-76-97-90-31-10-20-71-83-9-60-50-28-99-70-42-45-82-66-48-5-27-11-26-85-34-59-44-73-35-98-17-15-21-69-65-64-88-63-81-94-32-36-51-47-38-84,54-2-13-40-77-29-33-23-37-58-22-61-56-6-8-86-72-49-43-1-12-75-4-95-67-55-25-3-16-14-46-62-7-41-79-30-53-39-57-92-0-91-74-96-18-52-87-93-78-89,84691247,23492,27956,51448
ls-random,71-9-89-78-15-69-96-55-41-1-49-75-51-38-56-97-73-98-37-93-87-74-13-40-99-29-84-67-80-60-27-92-0-48-91-66-53-39-63-8-6-11-85-34-42-28-82-61-44-16,94-81-43-88-30-79-18-5-90-22-59-76-50-24-86-19-26-54-33-45-2-77-95-3-64-25-65-52-21-17-23-35-83-20-58-14-10-31-70-47-72-68-7-62-46-57-4-36-32-12,144692313,26992,26596,53588
ls-random,47-99-40-2-45-82-76-83-93-15-21-69-91-0-27-46-44-14-16-58-73-71-89-18-64-25-96-7-94-12-4-49-67-84-6-56-19-85-34-26-11-86-60-43-1-39-37-98-35-59,68-88-30-79-50-8-54-42-70-13-32-75-81-52-78-62-24-80-38-36-51-77-95-29-28-33-61-9-23-17-87-65-3-55-66-57-92-22-97-90-31-10-20-5-48-74-41-53-63-72,77019690,26890,27408,54298
ls-random,16-73-32-12-94-55-17-23-89-91-0-46-97-76-59-61-19-56-8-6-54-72-43-49-38-29-77-36-1-68-60-66-30-79-25-64-69-21-87-52-18-7-33-2-70-40-42-26-44-14,34-22-90-31-9-78-65-3-96-88-53-81-75-4-47-99-13-28-45-82-11-62-5-48-15-93-83-71-20-10-58-35-98-37-74-41-39-63-24-50-86-51-95-84-67-80-57-27-92-85,77101651,27914,24387,52301
ls-random,30-79-55-25-65-3-74-52-21-87-83-23-98-35-9-62-76-19-84-29-77-95-49-72-43-39-41-7-91-27-57-86-56-6-28-45-82-11-22-31-14-61-26-13-70-47-51-75-1-88,42-2-40-99-32-12-94-81-97-90-46-89-18-48-5-24-80-68-63-53-96-64-69-15-93-33-4-36-38-67-66-78-17-37-10-44-59-34-85-8-50-60-92-0-71-20-73-58-16-54,73534369,24386,29299,53685
ls-random,23-0-27-12-75-81-66-5-48-15-69-3-74-97-85-26-11-57-41-30-88-53-1-49-13-2-45-82-44-93-87-52-18-39-43-72-86-56-6-29-32-36-77-95-67-80-14-16-20-98,22-59-61-84-38-51-47-99-28-33-54-19-34-76-92-7-79-68-63-94-4-70-40-42-8-50-24-60-62-9-83-17-37-35-71-73-58-10-31-90-46-89-78-21-65-25-64-96-55-91,98648672,32394,23638,56032
ls-random,64-25-30-88-57-60-86-13-99-70-42-19-22-48-89-74-7-63-75-32-67-80-24-31-10-71-83-78-52-43-4-77-95-29-45-26-85-44-16-98-37-17-93-9-6-82-33-8-27-18,46-14-34-84-12-94-81-1-53-39-66-0-62-5-20-73-58-35-23-87-21-15-49-38-36-51-47-40-2-28-54-11-56-92-41-79-55-96-3-65-69-91-68-72-50-76-61-59-97-90,65181886,31766,25385,57151
ls-random,87-93-21-64-18-0-60-28-45-54-11-61-59-92-30-88-39-49-70-40-42-8-86-24-38-36-4-51-22-44-46-66-53-1-75-32-12-81-5-89-20-73-14-58-98-37-23-83-9-78,17-35-71-91-7-57-80-84-67-72-63-43-94-47-99-13-2-33-50-55-96-3-15-69-65-25-79-41-68-95-77-29-82-6-56-76-16-10-31-90-97-34-85-26-19-27-62-48-74-52,70713159,27931,24883,52814
ls-random,80-0-5-83-71-58-10-60-29-38-41-55-28-13-70-99-47-51-77-95-4-94-96-3-65-18-59-85-11-19-76-46-21-15-52-89-48-91-1-43-49-66-27-92-50-56-6-54-84-67,44-14-16-20-62-72-12-75-32-90-31-73-35-98-37-23-17-78-74-7-88-86-8-26-34-61-22-9-87-93-69-64-25-79-30-53-81-36-40-2-42-45-33-82-24-68-63-39-57-97,55150175,30589,27023,57612
ls-random,49-72-88-55-96-25-65-69-21-15-89-28-29-99-13-42-33-54-11-76-22-0-62-83-98-35-92-27-68-80-60-86-8-19-85-34-59-31-14-23-17-87-52-41-39-81-94-32-4-51,6-56-58-73-20-9-74-91-50-82-45-2-40-70-47-38-43-30-79-7-66-63-1-53-64-3-18-84-95-77-36-75-12-5-48-78-93-37-71-90-97-26-61-44-16-10-46-57-24-67,70966729,26344,30941,57285
ls-random,68-29-47-70-45-85-14-58-35-37-20-73-10-31-90-44-59-19-33-38-72-1-39-66-91-15-21-78-89-0-95-77-32-94-96-3-64-25-65-52-83-9-46-56-50-57-92-7-55-79,84-86-24-80-67-49-43-63-60-27-5-48-62-97-22-61-2-99-40-42-34-26-11-54-82-6-8-76-16-71-98-23-17-93-87-69-18-74-41-30-88-53-81-12-75-36-4-51-13-28,66926635,29593,21232,50825
ls-random,25-96-55-79-30-41-43-84-38-94-75-12-13-2-42-45-28-82-54-85-34-46-0-62-23-37-98-20-73-16-10-31-44-97-57-39-68-80-50-86-19-76-92-27-66-91-5-52-21-65,72-9-17-35-83-90-22-59-61-24-67-36-4-95-33-11-26-14-58-71-7-53-63-70-40-99-47-51-77-29-8-6-56-60-48-89-78-18-74-3-64-69-93-15-87-88-1-81-32-49,107552339,21117,28253,49370
ls-random,38-51-4-36-12-27-0-5-48-74-55-88-53-39-49-67-84-24-60-22-90-44-20-35-37-23-59-42-40-70-2-8-50-7-96-3-25-15-93-83-9-78-87-52-46-61-11-6-54-82,26-45-28-33-19-56-86-41-30-79-64-65-69-21-18-94-75-32-77-95-29-47-99-13-76-97-14-16-58-98-17-89-91-92-57-80-68-72-43-81-1-63-66-62-71-73-10-31-34-85,64885053,25962,25013,50975
ls-random,0-56-6-86-50-80-27-66-39-63-72-49-84-51-40-70-13-2-82-19-87-15-21-17-83-22-34-85-33-95-4-12-88-30-41-48-5-62-97-90-31-10-73-58-98-37-18-3-96-74,29-81-43-1-53-68-76-61-59-64-25-79-60-24-8-54-45-28-47-99-42-26-44-20-23-35-16-14-71-9-78-89-91-94-75-32-36-77-38-67-57-92-7-55-65-69-93-52-46-11,59347220,25121,30781,55902
ls-random,49-94-12-32-29-28-54-6-8-86-76-59-90-91-7-3-65-17-23-89-5-24-80-68-53-30-41-9-83-71-34-85-99-51-77-4-36-38-60-10-14-16-73-98-37-21-69-25-1-43,66-63-39-87-15-93-78-35-58-26-42-40-70-11-19-52-64-96-55-79-88-57-82-33-45-2-13-47-95-84-67-56-61-44-31-46-92-72-81-75-50-22-97-20-62-48-18-74-0-27,54732379,27908,29924,57832
ls-random,8-56-86-50-55-3-65-25-79-53-49-99-40-34-59-0-62-91-63-68-24-97-20-73-14-19-45-28-13-47-51-77-4-12-1-18-52-15-21-93-78-89-48-5-9-35-71-22-54-82,27-33-2-29-38-60-57-92-58-98-37-23-17-83-90-85-26-11-42-70-95-36-94-81-72-67-84-80-6-61-76-44-16-10-31-46-7-41-30-88-39-75-32-43-66-74-96-64-69-87,70818504,28699,27765,56464
ls-random,48-89-35-98-23-69-25-3-18-74-91-92-61-34-54-29-12-75-36-4-63-53-88-55-21-15-9-71-20-27-80-24-97-10-58-14-76-86-56-8-82-45-28-13-47-77-38-49-68-66,59-44-16-73-31-46-62-5-65-64-96-90-22-60-72-43-67-19-85-26-11-33-2-99-70-40-42-6-50-57-0-78-52-7-41-79-30-1-94-32-81-39-83-37-17-93-87-84-95-51,75053633,25857,29761,55618
ls-random,50-60-89-93-21-69-52-3-96-19-85-59-97-90-46-0-27-66-30-55-18-78-17-23-98-35-58-16-34-11-6-8-80-39-1-43-84-38-95-51-32-12-94-81-29-47-99-70-2-33,57-92-74-65-64-25-79-77-13-40-42-45-28-56-86-62-9-83-48-53-63-75-36-4-31-20-71-5-91-7-41-88-24-82-54-26-61-76-15-87-37-73-10-14-44-22-67-49-72-68,66324441,22815,30987,53802
ls-random,27-92-62-78-52-18-64-96-79-30-88-31-14-16-9-93-15-90-97-76-8-50-60-24-81-94-75-32-77-47-38-49-72-43-63-39-66-46-37-98-58-44-26-11-6-54-82-70-99-57,36-12-1-53-73-20-71-83-89-74-55-41-7-68-67-84-28-33-19-61-59-0-91-80-86-56-29-51-95-21-69-65-25-3-45-13-40-2-42-85-34-22-10-35-23-17-87-48-5-4,59103040,25279,32465,57744
ls-random,37-31-22-29-51-99-40-45-28-68-66-41-7-91-97-90-5-48-74-96-30-88-53-1-43-71-9-89-64-25-65-21-87-78-59-11-82-6-56-61-76-50-24-84-94-75-36-85-34-98,23-35-83-18-52-69-3-55-79-57-60-80-8-26-19-86-92-27-0-46-54-33-42-2-13-70-47-77-95-38-67-44-10-20-73-58-16-14-39-63-49-81-12-32-4-72-62-15-93-17,63954965,30413,24583,54996
ls-random,59-46-52-65-3-96-55-91-27-0-5-78-87-93-17-23-57-60-24-80-13-99-70-40-26-10-58-98-35-67-75-94-39-88-30-79-41-49-36-4-8-14-16-28-47-51-77-6-56-85,63-38-84-76-9-89-15-21-37-83-71-31-44-34-61-22-97-90-20-73-19-29-95-32-12-81-1-43-72-68-66-92-7-74-48-62-50-86-33-45-2-42-82-54-11-64-25-69-18-53,65799229,32730,28312,61042
ls-random,89-60-84-38-95-29-80-24-96-3-25-15-93-87-52-33-42-13-99-32-75-12-94-1-72-63-91-7-41-79-30-88-86-56-8-6-54-34-61-59-0-62-46-10-16-73-71-35-37-17,20-58-14-44-85-26-2-45-82-11-19-22-98-23-83-9-74-55-53-39-43-49-81-36-4-40-70-67-68-66-18-64-65-69-21-78-76-28-47-51-77-50-57-27-92-5-48-97-90-31,71931104,25817,26947,52764
ls-random,2-40-47-35-98-23-17-52-18-74-46-90-22-59-92-27-7-41-79-88-12-36-43-55-96-64-69-21-89-62-56-6-82-26-34-85-50-60-24-67-84-29-77-95-38-49-9-83-20-16,99-70-13-42-61-14-10-11-45-28-33-54-19-44-31-97-76-8-86-63-39-53-1-94-75-32-81-72-5-87-15-91-66-68-80-57-0-78-93-37-58-73-71-48-3-65-25-30-4-51,86444698,30194,29128,59322
ls-random,76-27-66-39-63-43-47-70-2-42-82-85-34-14-16-58-37-52-18-74-55-79-30-7-68-49-77-36-94-1-62-89-15-21-87-78-31-44-90-97-22-59-46-65-64-3-92-86-11-19,61-60-57-88-41-91-5-48-9-83-35-98-23-17-0-53-12-75-32-4-51-33-54-6-8-56-50-24-80-84-67-72-81-38-95-29-28-45-26-96-25-69-93-71-13-99-40-20-73-10,64957326,26443,28983,55426
ls-random,83-35-98-23-5-66-39-53-88-79-15-21-93-87-74-75-12-60-90-97-59-19-8-63-1-36-4-40-42-26-34-16-58-20-71-9-52-65-64-55-7-33-28-2-51-77-95-29-82-46,81-94-32-49-72-68-31-10-14-44-22-76-50-84-38-67-80-24-57-27-96-3-25-30-41-91-62-0-92-13-47-99-70-45-54-6-86-56-11-85-61-73-37-17-78-69-18-89-48-43,97262321,31311,24815,56126
ls-random,77-29-76-71-35-98-58-10-60-12-75-43-96-15-93-17-83-16-14-34-26-36-94-81-1-25-65-69-52-19-42-99-13-45-82-54-6-8-50-27-7-91-46-31-90-41-88-68-84-38,63-72-4-32-49-53-30-79-55-3-64-89-48-5-0-92-62-9-23-37-97-40-70-51-95-22-44-73-20-57-80-24-86-56-59-61-85-11-33-28-2-47-67-66-78-87-21-18-74-39,66151245,34685,28882,63567
ls-random,12-75-94-1-53-66-91-48-35-98-37-23-27-80-24-57-92-31-14-10-55-79-30-88-36-4-51-33-82-54-11-26-59-22-97-71-52-87-25-69-21-93-78-83-58-76-70-13-84-67,42-40-99-28-19-61-44-16-73-20-9-62-46-60-50-29-95-77-47-2-45-6-8-56-86-68-72-63-39-41-7-0-43-49-81-32-38-5-89-17-15-65-64-3-96-18-74-90-34-85,80508695,27369,25579,52948
ls-random,27-7-64-65-69-21-15-87-93-23-16-14-20-78-52-48-0-54-42-45-28-24-41-79-55-74-5-62-46-90-44-97-85-26-80-67-29-95-36-12-94-1-63-49-77-51-40-70-13-2,19-11-82-33-72-43-68-60-57-66-88-30-25-17-98-35-58-34-99-47-6-56-8-84-81-75-32-4-38-86-76-50-39-53-92-9-83-37-71-73-10-31-89-18-3-96-91-22-59-61,76578934,24315,27301,51616
ls-random,77-36-68-5-48-91-7-0-46-92-27-26-34-61-87-15-69-18-39-94-32-81-43-73-58-10-31-13-47-70-40-42-6-8-80-24-60-57-20-35-83-17-52-96-55-66-50-19-11-51,53-1-95-4-75-12-49-72-63-44-14-16-71-9-89-62-67-84-38-29-56-59-76-88-30-79-41-90-97-22-85-28-99-2-45-33-82-54-86-3-64-25-65-21-93-98-37-23-78-74,59396888,30835,27331,58166
ls-random,18-91-5-20-58-14-19-6-56-35-98-37-23-17-88-53-1-43-67-38-29-40-95-4-32-12-94-81-49-72-80-24-60-50-97-90-0-7-86-33-54-26-85-34-44-89-52-15-21-65,59-31-10-16-73-71-48-79-30-41-27-92-46-62-9-83-93-69-25-64-3-22-76-11-82-45-2-28-68-63-39-75-36-51-77-84-57-66-55-96-74-87-78-8-47-99-70-13-42-61,132143034,24810,26102,50912
ls-random,89-52-18-96-79-41-81-75-32-12-66-0-9-83-71-73-92-57-67-38-51-53-39-86-8-6-33-28-2-42-11-27-7-64-25-65-15-87-93-17-35-58-31-44-22-97-90-62-5-48,26-85-34-10-20-98-37-23-30-88-95-77-47-13-45-55-3-69-21-78-74-91-46-76-61-59-14-16-19-29-4-36-94-1-43-49-99-40-70-84-72-63-68-80-24-60-50-56-82-54,80480843,24370,27232,51602
ls-random,2-28-29-84-88-55-74-48-5-0-92-57-80-94-75-32-12-86-19-85-61-96-64-25-21-10-44-76-6-8-38-4-77-40-42-34-16-73-35-98-37-78-83-9-46-53-63-67-33-45,3-65-79-30-1-39-41-18-52-15-87-89-97-47-99-70-13-82-54-56-50-24-60-66-27-11-26-59-22-90-71-23-17-93-69-49-95-51-36-81-43-72-68-20-58-14-31-62-91-7,75995824,28989,28652,57641
ls-random,92-74-18-52-69-65-64-55-79-53-43-72-49-36-32-81-1-39-63-80-6-19-85-76-59-22-44-90-88-41-7-62-31-14-58-20-37-89-5-67-95-51-47-70-40-2-42-45-33-54,50-86-56-35-98-23-17-73-16-61-82-28-13-99-29-77-4-38-84-60-9-83-71-34-26-11-8-57-30-96-3-25-15-87-91-66-68-94-75-12-24-97-10-46-0-48-21-93-78-27,90093094,23275,30818,54093
ls-random,95-28-45-82-0-3-65-25-55-30-41-96-74-89-83-37-35-71-20-16-34-85-11-56-8-50-68-57-7-88-63-72-67-84-32-75-12-94-81-46-73-58-98-17-21-87-52-91-43-36,19-76-5-18-69-64-79-4-77-51-47-99-40-70-13-9-23-14-10-31-44-90-97-22-59-61-86-60-24-80-49-1-53-39-66-27-92-62-78-93-15-48-6-54-42-2-29-38-33-26,114610263,26759,26043,52802
ls-random,29-38-84-67-8-56-68-88-21-93-37-83-71-20-58-40-70-99-75-12-1-25-65-5-46-10-16-90-97-50-24-27-0-78-87-55-79-43-36-4-77-51-13-42-45-82-54-19-6-33,91-7-41-30-53-39-81-94-32-63-66-48-89-35-98-23-17-52-9-73-14-44-95-47-2-28-11-86-80-60-76-57-92-96-3-64-69-15-18-74-72-49-26-85-34-61-59-22-31-62,49053852,29721,26777,56498
ls-random,56-8-84-49-81-94-32-38-95-77-51-99-13-26-85-44-58-73-20-48-0-92-86-6-54-82-42-45-88-79-55-69-93-98-37-83-9-18-64-3-91-7-39-1-24-60-50-97-22-59,62-57-72-12-75-43-53-63-68-66-5-89-17-23-35-71-46-90-31-10-16-14-19-11-33-28-29-4-36-30-96-25-65-52-78-74-41-27-76-61-34-2-40-70-47-67-80-15-21-87,65286243,24121,28290,52411
ls-random,53-94-95-29-62-48-18-74-96-41-88-50-84-38-36-4-47-70-40-13-42-8-11-26-85-76-59-22-90-31-73-58-16-56-86-46-98-17-93-15-64-91-92-57-60-24-72-49-43-39,14-44-34-54-82-19-61-97-5-3-65-25-81-12-75-32-77-51-99-67-68-66-27-7-55-79-30-1-63-0-52-69-21-87-78-89-80-28-2-45-33-6-9-83-23-37-35-71-20-10,65352264,24712,28211,52923
ls-random,37-71-60-84-8-82-54-26-34-85-11-6-19-61-22-15-21-65-25-39-1-95-51-29-14-16-73-41-79-30-88-47-99-70-7-96-3-78-9-90-97-46-48-18-74-91-27-92-62-23,2-42-45-28-33-67-80-24-0-83-35-98-17-89-5-44-59-76-56-86-50-57-55-64-69-93-87-52-66-53-63-43-49-38-36-4-77-31-10-58-20-68-72-81-94-12-75-32-40-13,86155484,31570,25686,57256
ls-random,5-0-27-56-6-60-24-72-49-94-81-43-39-7-74-87-21-69-25-64-3-55-30-84-38-95-77-33-11-76-48-18-78-17-23-37-98-9-71-14-31-12-75-51-45-42-26-59-90-46,83-35-22-19-54-82-29-67-80-97-20-73-58-16-10-44-61-34-85-8-68-63-53-1-32-36-4-88-79-65-15-93-52-62-40-70-99-47-13-2-28-86-50-57-66-92-91-41-96-89,71651193,27173,26790,53963
ls-random,24-31-10-14-71-83-89-78-23-35-46-97-59-42-70-45-82-52-65-25-64-96-30-53-94-12-36-77-51-29-67-66-0-62-7-39-43-49-72-6-85-34-19-56-86-50-92-27-57-80,68-3-69-18-74-48-91-63-75-32-99-40-58-98-37-20-73-16-44-90-22-8-95-4-47-13-87-15-21-93-17-9-5-33-28-2-54-11-26-61-76-60-41-55-79-88-1-81-38-84,65998001,26287,33756,60043
ls-random,42-2-82-54-19-76-98-93-15-17-23-37-57-24-68-63-27-0-7-39-1-81-75-47-99-40-70-13-29-38-43-72-8-56-97-90-89-25-79-30-88-41-91-62-58-16-14-31-59-61,84-67-92-18-52-21-87-78-83-9-71-34-85-26-11-95-4-36-32-12-77-51-28-45-33-6-86-50-46-5-48-74-3-96-55-66-80-60-22-44-10-73-20-35-69-65-64-53-94-49,78727373,26439,24926,51365
ls-random,70-99-51-77-75-94-79-25-65-3-52-23-35-46-38-81-43-68-80-24-45-2-42-82-11-76-27-74-96-18-83-9-48-62-91-7-88-66-60-50-56-19-34-61-90-31-71-73-14-44,59-33-28-29-39-53-30-41-63-72-67-84-6-8-86-89-78-17-37-98-58-20-10-0-92-57-13-47-40-26-85-54-32-12-1-55-64-69-21-93-15-87-5-49-36-4-95-97-16-22,65630964,27336,31862,59198
ls-random,84-49-81-94-51-95-29-47-13-56-10-35-98-78-52-65-3-30-41-6-33-45-70-40-42-54-19-34-61-22-97-76-50-92-27-0-48-83-71-73-46-24-80-68-63-39-53-15-21-93,69-87-79-88-75-32-12-26-85-59-5-89-18-74-91-57-86-28-99-2-9-17-23-37-58-31-90-44-14-16-20-62-66-1-43-72-8-11-82-38-77-4-36-67-60-7-55-96-64-25,71574856,27566,29989,57555
ls-random,76-46-62-64-25-52-78-23-98-35-58-10-26-11-82-33-6-8-67-81-12-99-40-47-51-7-87-21-96-30-41-39-43-95-38-84-60-66-0-5-48-9-83-73-31-34-42-2-13-28,3-55-79-88-53-1-4-77-29-85-61-59-22-44-14-16-20-71-92-57-68-63-49-72-80-24-50-86-56-19-97-90-37-17-93-69-15-89-91-27-54-45-70-36-32-75-94-74-18-65,88085326,28957,24836,53793
ls-random,31-10-62-74-1-94-75-81-49-27-92-46-20-71-37-23-17-21-98-58-16-26-29-51-36-84-18-3-64-25-69-52-97-22-50-60-24-43-63-39-53-88-41-55-56-33-70-40-34-44,7-66-57-86-61-59-0-30-79-89-83-9-48-5-68-72-12-32-4-95-77-47-99-13-2-42-45-8-6-19-76-78-87-15-93-35-73-14-90-85-11-54-82-28-38-67-80-91-65-96,66479371,31815,24675,56490
ls-random,46-94-12-75-32-36-99-2-28-82-54-11-6-50-27-74-52-17-93-21-65-25-64-3-79-30-88-66-57-43-81-1-7-91-5-62-24-67-84-95-51-29-26-61-90-31-14-16-20-9,44-97-22-59-76-60-92-0-48-89-78-23-37-4-77-47-13-45-33-72-49-38-70-40-42-34-85-19-56-8-86-96-18-87-15-69-55-41-53-39-63-68-80-10-73-58-98-35-83-71,96897565,24728,25308,50036
ls-random,79-25-64-18-89-48-56-6-2-40-99-28-33-82-44-58-73-22-76-86-50-0-87-15-21-17-78-97-59-11-26-85-34-71-35-83-9-57-24-72-67-84-29-49-43-1-53-39-66-7,13-70-47-68-91-74-65-3-96-55-27-60-80-12-75-32-36-4-51-77-95-38-94-81-63-98-37-23-52-30-88-41-5-62-46-90-61-19-54-45-8-92-69-93-20-16-14-10-31-42,71625272,26188,28810,54998
ls-random,52-48-53-12-32-51-28-33-85-34-78-17-93-15-69-24-80-84-13-70-40-8-65-64-79-68-72-67-49-1-81-94-95-2-42-45-19-22-44-14-16-98-71-56-86-57-91-55-96-18,75-36-4-77-47-99-29-82-54-6-11-26-10-58-73-20-46-92-27-66-41-7-37-23-87-21-25-30-88-39-63-43-60-50-90-97-76-61-59-31-35-83-9-89-3-74-5-62-0-38,71273232,33281,24043,57324
ls-random,38-29-35-17-87-48-0-66-60-76-61-59-14-16-98-37-21-69-25-30-1-81-94-12-32-95-40-54-85-34-97-10-46-62-5-96-55-79-39-63-43-49-72-68-24-86-8-82-67-84,77-51-11-19-27-92-90-31-20-71-9-89-41-88-53-75-36-4-47-2-45-33-6-56-57-7-91-74-18-3-52-78-23-93-15-65-64-83-73-58-44-22-26-42-70-99-13-28-50-80,76769993,26975,24234,51209
ls-random,89-78-23-98-35-14-20-9-96-3-64-15-87-52-61-34-42-45-13-47-28-33-6-8-67-72-43-63-39-57-31-10-76-24-80-4-36-75-1-30-79-41-38-95-77-29-82-11-5-48,46-92-27-68-49-53-88-55-25-65-0-50-86-56-19-26-85-59-22-97-60-84-51-32-12-94-81-66-7-91-74-18-69-21-93-17-62-54-99-70-40-2-44-16-58-37-83-71-73-90,82039793,27252,27090,54342
ls-random,88-18-37-17-87-15-65-64-3-79-30-41-20-58-16-14-10-97-61-34-85-26-11-42-6-8-50-60-67-49-1-53-39-7-91-89-9-48-0-27-92-2-13-40-70-47-4-32-12-94,43-81-75-36-51-99-28-45-82-54-46-52-69-21-93-23-98-35-83-78-62-84-38-95-77-29-33-76-90-71-73-31-44-22-59-19-56-86-72-63-68-80-24-57-66-55-25-96-74-5,71880693,22391,25860,48251
ls-random,70-40-42-13-29-84-67-43-68-60-57-92-0-62-83-98-35-32-12-94-81-52-69-15-17-89-5-22-19-6-56-31-71-20-10-44-26-45-82-54-8-50-7-96-65-30-1-4-47-99,85-11-86-24-80-75-36-95-38-49-25-64-3-74-66-72-63-39-53-79-55-18-78-9-48-91-27-97-90-16-14-34-2-51-77-28-33-61-59-76-46-87-21-93-23-37-58-73-41-88,82215630,30485,29278,59763
ls-random,65-91-0-27-67-49-12-32-51-77-95-38-82-54-26-61-59-80-63-53-88-41-17-23-98-35-58-10-90-6-8-86-50-92-48-18-15-83-9-71-20-73-16-34-45-2-99-47-7-64,40-13-3-52-78-37-14-31-44-56-29-4-36-72-24-60-57-97-22-76-19-85-11-42-28-33-46-62-5-89-87-93-21-69-25-79-30-39-1-94-75-81-43-68-55-96-74-66-84-70,76691652,26375,29635,56010
ls-random,99-70-42-85-46-71-37-17-93-15-78-48-5-74-18-69-25-64-3-91-7-88-12-32-75-1-53-39-63-43-67-24-57-22-97-31-10-16-44-59-61-50-81-4-77-28-86-56-54-45,65-21-87-52-66-60-80-13-40-47-38-49-84-29-2-33-82-11-6-8-90-14-73-20-9-62-0-89-83-23-98-35-58-34-26-19-76-92-27-41-55-79-30-68-72-95-51-36-94-96,133093770,23926,26696,50622
ls-random,79-25-65-48-97-22-31-10-14-58-35-37-18-96-41-68-63-43-81-75-36-29-82-26-85-34-76-19-13-99-77-95-38-49-92-89-15-87-9-71-20-73-46-80-84-28-45-33-86-57,94-72-67-8-6-56-50-24-60-61-59-90-44-16-62-5-0-91-74-3-64-69-21-93-52-78-17-23-98-83-27-11-54-42-2-39-66-7-55-30-88-53-1-4-51-47-70-40-32-12,144359866,26473,23548,50021
ls-random,97-76-86-50-24-43-49-38-28-33-82-54-85-61-22-83-37-23-93-21-65-96-55-30-88-62-0-92-39-81-75-32-77-29-31-20-73-58-14-26-42-99-47-13-45-19-5-52-15-9,27-48-89-78-17-87-69-74-40-70-4-36-12-94-34-59-44-16-98-35-71-91-7-41-46-90-10-18-3-64-25-79-66-57-60-80-67-84-95-51-2-11-6-8-56-63-53-1-72-68,86155679,26711,28346,55057
ls-random,28-82-11-26-85-19-6-56-46-62-5-73-58-35-93-83-71-31-44-97-36-12-94-1-53-96-64-74-7-27-92-48-18-21-15-61-42-2-40-47-95-38-67-72-43-39-68-80-50-86,54-33-45-70-99-13-29-51-77-4-32-75-81-84-49-63-91-0-10-14-16-20-9-78-52-87-69-25-30-79-55-89-98-37-23-17-65-3-41-88-66-57-76-59-8-24-60-90-22-34,90333369,26203,22476,48679
ls-random,54-45-2-40-13-28-33-61-44-16-20-90-32-75-12-81-43-49-72-66-52-17-98-93-21-15-84-38-77-4-53-39-68-80-24-60-7-96-3-30-41-50-86-6-56-76-62-48-89-9,51-47-42-34-59-22-97-46-55-79-88-8-82-70-99-57-27-92-19-85-26-11-63-1-94-36-31-10-14-58-73-71-35-37-23-83-78-87-69-25-64-65-18-74-5-91-0-67-29-95,84926178,29824,26196,56020
ls-random,31-10-58-73-81-94-39-3-65-87-93-83-71-20-44-54-82-77-95-38-8-6-26-85-34-61-97-0-27-66-68-67-84-4-36-32-12-30-79-55-41-72-70-2-33-56-62-48-89-46,14-16-76-43-1-63-53-88-69-21-15-18-74-96-7-91-5-22-90-35-98-37-23-25-64-52-78-17-9-92-57-86-11-45-28-50-60-24-80-49-75-51-29-47-13-99-40-42-19-59,51507237,30176,25784,55960
ls-random,48-5-86-13-70-40-2-26-16-98-35-20-10-31-90-46-41-30-88-50-8-6-56-78-21-93-17-83-9-44-59-19-38-29-82-11-22-97-1-94-75-32-36-4-51-77-68-7-96-64,80-63-43-72-67-84-49-81-12-95-47-99-42-34-14-58-73-76-54-33-28-45-85-61-71-37-23-18-52-87-15-69-65-25-3-79-53-39-66-27-92-0-91-55-74-89-62-57-60-24,60727666,29862,23424,53286
ls-random,88-67-29-13-70-40-42-33-86-50-16-10-92-27-60-80-84-38-32-75-94-81-49-1-63-35-98-37-23-21-87-52-58-20-9-89-74-55-5-62-46-90-97-59-26-11-57-66-7-79,6-22-44-34-85-24-72-43-12-36-4-51-47-99-2-45-82-18-3-64-25-65-83-71-73-14-31-56-8-0-91-41-30-96-69-15-93-17-78-48-53-39-68-76-61-19-54-28-77-95,68058533,24265,26466,50731
ls-random,72-62-9-83-31-44-90-11-56-8-86-46-73-20-89-18-65-69-15-37-82-28-2-40-70-47-29-38-77-4-36-12-94-81-84-24-50-60-57-66-92-91-7-96-64-25-30-41-53-49,19-6-80-68-63-39-43-95-51-99-34-71-17-78-52-3-55-79-88-27-97-10-14-16-58-98-23-35-67-32-75-1-21-93-87-33-45-13-42-54-26-85-61-59-22-5-48-74-0-76,110072724,24786,30973,55759
ls-random,51-4-75-12-43-3-25-15-93-17-71-31-22-76-26-11-42-2-33-6-60-14-16-20-9-18-74-55-79-41-88-53-39-63-66-91-83-35-98-37-23-48-5-0-27-67-28-70-40-99,97-90-59-45-13-47-29-62-89-78-87-21-69-52-65-64-96-30-7-92-57-56-19-61-34-85-54-82-8-86-50-24-80-72-49-1-68-44-10-58-73-46-81-94-32-36-77-95-38-84,113855710,25195,23779,48974
ls-random,70-40-34-44-73-35-37-17-15-89-83-10-31-90-84-38-51-47-99-13-2-45-67-80-24-50-57-27-88-30-79-64-65-3-5-7-0-8-6-11-54-82-77-4-49-68-43-75-32-36,16-14-95-12-94-81-1-72-33-42-28-29-53-25-69-21-93-87-78-9-46-76-61-56-86-60-66-41-91-71-20-39-63-97-22-59-85-26-19-92-62-48-74-55-96-18-52-23-98-58,154154309,24656,28823,53479
ls-random,60-24-86-84-38-95-77-47-99-70-13-2-42-26-85-41-55-96-74-3-69-21-15-87-17-78-48-5-0-92-14-16-58-73-20-61-56-6-29-32-75-12-94-63-35-23-83-9-27-57,91-62-46-66-43-1-39-53-88-25-64-65-93-52-89-71-31-76-19-8-50-67-51-4-36-81-49-72-68-80-28-40-45-33-82-97-90-22-59-11-54-34-44-10-98-37-18-79-30-7,119353558,22334,25358,47692
ls-random,84-86-5-89-23-37-90-59-10-20-71-35-16-14-46-92-27-74-3-25-65-21-93-8-28-13-40-2-45-26-19-61-83-17-52-18-66-68-72-49-43-39-96-55-30-53-75-32-36-51,15-87-78-29-47-99-70-42-33-82-54-11-76-41-7-91-48-62-0-97-44-31-9-98-58-73-22-34-85-6-56-50-57-60-24-80-67-63-1-81-94-12-4-77-95-38-88-79-64-69,81991389,30117,23689,53806
ls-random,12-32-77-13-70-42-45-82-80-24-60-27-55-96-64-3-74-18-78-89-48-91-62-20-73-83-98-17-87-52-7-39-43-94-49-72-67-8-56-19-11-26-34-61-59-15-69-93-16-22,51-95-29-86-50-46-58-71-9-21-65-25-79-81-75-2-28-33-54-6-66-88-30-41-0-92-57-84-36-4-38-76-44-14-10-31-90-97-68-63-1-53-5-23-37-35-85-40-99-47,97697487,25812,30563,56375
ls-random,62-46-76-85-59-22-90-16-73-10-31-92-57-67-75-81-43-63-39-41-55-3-69-93-20-97-56-40-99-51-95-4-36-38-13-2-28-27-0-91-83-37-17-89-5-48-52-15-21-87,61-44-14-34-26-11-54-82-33-6-8-86-65-25-64-96-12-32-94-1-23-98-35-58-71-50-24-60-79-30-88-53-49-84-72-68-66-9-78-18-74-7-80-29-77-47-70-42-45-19,61492579,25463,31442,56905
ls-random,57-66-7-74-96-41-53-1-81-75-32-33-82-86-46-73-58-71-89-79-30-48-5-0-63-72-68-37-17-78-52-50-28-45-99-47-29-95-4-38-84-49-80-31-10-14-61-85-26-19,87-83-62-39-67-24-60-92-27-91-18-3-55-88-43-94-12-36-77-51-13-2-54-6-8-56-76-59-22-97-90-44-16-20-9-34-42-40-70-11-64-25-65-69-21-93-98-35-23-15,62866545,28700,26064,54764
ls-random,93-78-31-85-11-86-57-91-41-53-39-76-59-61-72-1-81-94-12-75-32-67-80-24-60-79-55-25-65-3-62-46-90-97-82-33-45-42-2-70-47-51-16-58-20-35-23-5-48-69,34-40-99-13-28-54-50-7-96-64-21-15-87-52-18-74-89-9-71-10-44-22-26-19-30-88-63-36-4-38-84-92-27-68-95-77-29-8-6-56-49-43-66-0-83-17-37-98-73-14,69011655,27766,27973,55739
ls-random,81-12-32-51-38-49-72-24-57-66-27-92-0-62-91-7-55-25-65-18-74-89-20-73-35-37-98-58-50-86-28-42-33-54-56-19-26-61-97-31-16-14-34-99-47-67-41-88-53-39,90-71-23-17-78-52-79-30-45-13-70-40-2-82-46-9-93-21-15-87-60-80-84-43-1-63-68-5-48-96-3-64-69-83-10-44-95-77-4-36-75-94-29-8-6-11-85-76-59-22,60844928,24514,27609,52123
ls-random,67-84-28-13-2-26-59-22-10-73-58-35-98-93-52-48-5-38-4-95-29-80-41-55-25-3-7-60-24-86-56-76-97-83-78-74-91-27-92-8-82-33-99-47-36-75-12-53-39-72,15-87-45-42-40-70-51-77-32-94-81-49-43-1-64-65-69-9-20-16-14-11-54-6-50-57-46-37-23-89-0-66-68-63-88-30-79-96-18-62-61-19-85-34-44-90-31-71-17-21,121888591,27118,27650,54768
ls-random,85-54-33-6-8-86-50-9-17-98-34-26-42-29-32-75-12-94-81-30-55-91-90-31-46-5-0-92-24-28-13-70-99-47-51-77-67-74-3-96-36-4-52-69-93-78-89-97-22-76,44-35-37-23-80-72-68-7-18-83-20-73-58-16-14-10-71-41-88-45-2-40-49-43-1-63-39-53-79-87-15-21-65-64-25-84-38-95-82-11-19-56-60-57-66-27-48-62-61-59,149893339,33067,29671,62738
ls-random,55-30-88-41-89-48-62-27-57-53-63-67-80-24-8-11-19-59-22-97-76-56-6-28-2-40-77-95-50-44-14-58-37-23-17-93-15-65-3-52-83-20-73-10-90-4-12-1-91-74,0-92-86-82-54-26-85-61-31-9-78-87-94-75-32-36-51-29-38-84-45-42-13-70-99-47-33-34-16-71-35-98-21-69-25-64-96-18-5-46-60-72-49-81-43-39-68-66-79-7,104392820,24556,26773,51329
ls-random,89-48-39-94-75-32-26-34-59-31-10-16-58-20-27-57-72-49-70-40-0-18-65-25-64-96-41-7-91-78-52-69-15-93-17-23-76-33-28-95-77-4-81-43-24-86-50-46-9-83,97-90-87-21-62-92-54-82-67-84-45-13-47-99-2-42-85-61-22-44-14-73-98-37-35-71-19-11-6-8-80-60-66-88-30-79-55-3-74-5-68-63-53-1-12-36-51-38-29-56,60871693,29078,25375,54453
ls-random,69-21-78-83-71-57-60-50-76-90-31-20-25-64-18-89-48-86-33-45-28-99-51-77-49-43-63-41-7-55-37-98-35-16-22-61-34-85-54-6-80-68-84-38-32-75-1-0-91-52,92-27-24-67-8-56-59-44-93-15-87-5-66-39-81-94-12-36-4-95-82-11-26-19-97-46-65-3-96-88-47-70-40-42-14-58-73-10-2-13-29-72-53-30-79-74-17-23-9-62,113728756,27519,31214,58733
ls-random,23-9-71-16-44-22-61-34-85-26-11-51-77-50-57-92-62-89-48-66-68-63-79-3-52-78-60-24-80-7-25-65-69-87-47-99-40-45-33-6-8-28-29-38-94-81-97-58-98-37,43-39-53-15-21-18-74-27-59-76-72-49-12-75-32-95-70-42-19-14-73-35-20-10-31-90-46-0-91-96-55-67-84-4-36-1-30-64-93-17-83-5-41-88-86-56-54-82-2-13,101943852,30691,30882,61573
ls-random,24-66-5-62-76-19-61-90-35-37-96-55-3-25-64-9-16-14-54-28-13-47-99-42-45-44-58-73-92-50-86-6-33-38-12-94-1-72-67-68-39-53-41-21-87-17-23-51-77-95,48-91-7-27-57-59-22-97-46-31-10-20-71-83-98-78-52-18-74-60-80-56-8-84-29-4-36-49-63-88-30-79-65-69-15-93-89-43-81-75-32-11-26-85-34-40-70-2-82-0,86846264,31763,26492,58255
ls-random,97-15-93-23-37-98-58-10-20-71-9-62-0-29-47-28-82-8-56-11-19-59-22-31-16-14-44-42-40-13-86-89-3-25-79-91-92-57-60-80-68-72-43-1-81-4-51-26-34-61,84-67-24-50-6-54-85-76-46-5-48-87-21-69-18-55-30-41-74-52-78-17-83-35-73-90-2-70-99-38-49-63-39-53-88-64-65-96-7-66-27-33-45-95-77-36-32-75-12-94,102346396,26785,23659,50444
ls-random,49-81-43-66-48-5-2-70-40-42-31-16-58-37-93-15-78-9-84-95-77-4-36-32-94-38-82-26-34-59-7-41-27-92-85-11-50-60-24-80-72-39-53-88-96-64-3-74-90-97,79-55-25-65-91-1-12-75-51-29-19-61-22-44-71-52-18-89-57-68-86-8-33-28-45-54-6-56-76-20-35-98-23-83-62-0-46-10-14-73-17-87-21-69-13-99-47-67-63-30,73467284,30553,29818,60371
ls-random,1-43-49-7-18-48-62-0-24-12-75-32-99-70-40-2-45-33-29-51-77-4-38-67-76-22-44-34-85-26-11-8-27-92-46-90-31-71-87-15-93-17-23-58-16-73-3-64-30-41,88-53-39-63-94-81-72-97-10-9-78-21-69-52-96-55-66-86-56-6-82-47-95-36-84-80-50-60-57-74-65-25-79-68-28-13-42-54-19-61-59-14-20-35-98-37-83-89-5-91,113588944,24957,27032,51989
ls-random,16-31-56-4-32-12-81-49-72-8-6-82-28-29-38-1-63-80-83-17-93-21-69-65-96-74-91-7-57-27-0-48-89-23-37-71-97-76-19-11-45-13-99-70-42-26-85-61-44-14,18-5-20-73-58-10-90-22-59-34-54-2-40-47-51-77-33-86-50-41-52-78-98-35-9-46-66-53-39-43-68-24-60-92-62-87-15-55-88-94-75-36-95-84-67-30-79-25-64-3,152142411,23295,27015,50310
ls-random,93-59-61-19-76-71-37-35-58-10-44-22-80-43-12-81-1-96-18-17-83-90-97-46-62-65-64-55-88-50-8-6-11-54-45-28-13-70-2-42-26-85-29-51-95-68-66-74-52-15,47-99-40-33-56-30-79-41-7-57-60-63-39-53-91-0-20-73-31-86-67-32-75-94-98-23-78-3-25-69-21-87-89-48-5-9-16-14-34-82-77-4-36-38-84-24-92-27-72-49,65989850,28596,29891,58487
ls-random,41-30-68-80-24-60-27-52-15-87-71-73-16-14-44-90-97-26-11-19-56-50-67-72-49-32-75-1-79-64-69-21-93-37-98-35-9-48-91-39-81-12-51-47-40-13-29-28-54-7,53-85-34-42-70-99-66-88-55-96-74-5-95-77-4-36-94-43-0-62-46-22-76-57-92-31-10-20-89-78-18-3-25-65-17-23-83-58-59-61-86-84-38-8-6-82-33-45-2-63,86550384,25758,29070,54828
ls-random,12-81-43-18-52-64-3-96-39-63-0-62-5-89-83-9-22-76-34-42-2-29-80-68-1-53-30-79-7-60-86-8-6-11-19-61-59-31-10-37-23-21-46-82-33-13-99-47-77-4,71-20-56-54-45-28-38-84-57-27-48-78-17-98-35-58-73-50-36-95-51-70-40-15-69-65-25-55-41-88-66-92-90-97-26-85-44-14-16-24-67-49-94-75-32-72-91-74-87-93,103127484,27362,31797,59159
ls-random,21-93-15-87-9-45-2-42-26-19-0-91-96-55-88-53-94-75-32-74-18-25-65-52-62-46-31-97-22-60-50-8-6-56-44-14-16-20-23-17-78-5-66-24-84-51-4-39-41-69,64-89-48-57-95-77-99-70-40-35-98-37-72-49-81-12-36-11-85-34-61-59-76-92-27-30-79-83-71-73-58-10-90-68-63-1-43-38-29-47-13-28-33-82-54-86-67-80-7-3,134434259,30007,29178,59185
ls-random,73-58-16-31-97-59-34-11-76-5-48-89-18-74-79-30-94-12-81-7-55-96-64-15-87-52-78-83-82-40-13-29-38-67-72-1-39-60-80-84-28-45-33-6-8-86-50-66-27-20,46-61-19-56-88-41-91-92-57-24-4-36-63-53-10-14-44-22-43-49-99-70-2-42-26-37-23-69-65-25-3-75-32-47-54-85-90-71-35-98-62-0-51-77-95-68-21-93-17-9,114527841,25231,38371,63602
ls-random,14-31-44-90-22-60-43-49-4-38-67-57-0-92-86-33-82-34-73-35-98-37-15-21-65-96-74-52-78-17-23-83-46-42-70-99-13-45-36-32-75-81-63-39-88-30-79-55-91-10,80-66-41-7-18-87-93-69-25-64-3-9-71-59-61-76-97-89-48-5-62-95-77-51-12-94-16-58-20-27-53-1-68-72-29-47-40-2-28-54-6-8-24-50-56-19-85-26-11-84,82072274,25614,26395,52009
ls-random,23-46-86-95-4-36-75-94-81-39-0-91-7-41-79-30-88-72-47-70-42-45-82-16-58-73-71-83-89-5-18-15-25-92-56-11-26-85-34-61-44-22-76-33-29-38-84-80-57-17,50-54-28-13-32-12-1-53-64-65-9-20-10-27-24-51-77-68-63-43-49-67-99-40-2-19-97-90-31-62-48-74-55-96-52-87-78-8-6-59-14-35-98-37-93-21-69-3-66-60,73048856,28082,29986,58068
ls-random,27-57-50-60-68-67-29-95-47-70-42-45-11-34-61-97-37-23-52-96-91-48-83-71-20-10-39-53-88-30-25-69-21-87-78-58-14-44-76-82-33-36-75-81-49-43-41-55-3-65,80-66-79-64-15-93-17-89-7-63-1-94-12-32-4-38-56-19-26-85-59-22-90-46-62-9-35-98-73-16-31-0-5-18-74-92-54-2-40-99-51-77-13-28-6-8-86-24-84-72,138573036,27269,24216,51485
ls-random,40-13-54-26-11-8-60-57-46-20-83-17-37-58-73-16-10-22-92-27-50-86-56-34-61-76-24-68-63-43-81-94-53-91-18-52-89-38-77-4-36-96-64-79-30-88-67-29-47-99,82-6-74-65-25-3-33-45-42-70-2-28-80-66-41-55-7-0-97-90-44-59-85-19-5-48-69-21-15-87-84-95-51-78-93-23-9-72-49-32-75-12-1-39-62-71-35-98-14-31,134084676,27483,36339,63822
ls-random,56-71-17-93-87-52-3-27-50-8-54-42-2-40-70-99-51-77-84-67-76-97-16-10-0-91-5-74-18-78-83-58-59-61-34-85-86-24-80-68-49-75-81-66-7-55-88-29-47-28,57-60-96-69-21-15-94-12-32-36-4-95-38-44-14-73-23-37-98-35-20-31-90-63-72-43-1-39-53-41-30-79-25-65-64-6-33-13-45-82-11-26-19-22-46-9-89-48-62-92,66270272,27437,28132,55569
ls-random,3-64-96-91-60-95-32-75-94-81-72-86-97-71-20-73-16-14-61-19-29-77-51-4-36-1-53-88-30-79-41-98-58-44-22-76-33-45-70-13-28-37-23-93-21-78-89-48-5-74,65-17-35-83-9-10-31-90-59-34-85-50-46-52-87-15-69-18-55-7-62-0-92-27-66-57-68-39-63-49-67-80-24-8-6-2-47-99-40-42-82-54-26-11-56-84-38-12-43-25,92361613,27088,23292,50380
ls-random,75-81-39-53-7-78-93-17-23-83-11-13-99-70-40-45-26-85-61-59-92-0-62-9-71-58-10-31-97-76-60-66-96-18-52-21-64-79-88-68-86-56-8-54-33-84-29-38-4-36,42-2-47-28-82-34-19-6-67-94-12-32-51-77-95-50-3-25-65-69-15-87-37-98-35-20-89-48-91-63-1-43-49-72-80-24-41-30-55-74-5-46-73-16-14-27-57-22-90-44,73758062,24562,25064,49626
ls-random,41-88-55-96-25-69-87-85-26-6-8-56-50-58-98-37-17-9-24-80-72-49-4-95-51-47-70-42-34-59-14-44-76-19-11-54-33-45-32-12-94-63-39-57-62-89-48-5-91-7,68-53-1-43-38-29-84-67-66-74-18-52-15-21-93-78-0-92-27-81-75-36-77-99-40-16-35-23-83-71-20-46-30-79-3-64-65-73-10-31-90-97-22-61-82-2-13-28-86-60,77437557,25376,25611,50987
ls-random,18-91-49-77-2-40-70-99-51-4-32-75-1-63-88-30-3-65-15-52-89-48-62-0-11-26-90-46-27-66-60-50-35-98-37-93-21-17-10-16-14-44-76-56-8-54-45-67-55-96,25-79-41-7-5-97-31-83-23-87-69-78-9-71-20-73-58-22-59-19-82-33-84-24-80-68-72-43-38-29-47-13-42-6-86-57-92-61-34-85-28-95-36-12-94-81-39-53-74-64,58932007,27767,23069,50836
ls-random,41-55-18-17-83-16-14-10-31-44-90-22-60-94-12-4-28-33-86-50-0-15-93-69-65-25-64-3-96-68-95-77-49-43-72-84-8-6-59-61-85-99-47-57-91-74-7-63-39-53,40-42-34-87-21-79-30-88-66-27-92-24-32-75-81-1-48-5-62-19-11-26-20-73-58-35-98-37-23-71-9-78-52-89-46-97-76-56-54-82-45-2-80-67-38-36-51-29-13-70,68990773,27812,26663,54475
ls-random,64-79-66-50-24-43-32-12-94-81-1-53-39-91-48-5-0-84-51-77-38-72-68-74-52-87-93-23-37-98-20-73-10-90-22-59-85-26-86-8-2-42-82-76-46-9-78-15-69-65,56-60-80-70-40-28-57-27-92-71-83-35-17-21-25-55-30-88-75-47-99-13-45-34-61-44-14-16-58-31-67-49-63-41-7-96-3-18-89-62-97-19-11-36-4-95-29-33-54-6,67981550,24348,28529,52877
ls-nn,0-5-9-37-35-20-31-44-22-34-26-11-19-46-15-21-17-23-16-14-10-48-18-3-25-30-41-7-27-39-1-43-49-4-36-32-12-38-29-28-42-40-47-13-2-45-33-6-8-24,99-84-67-82-56-86-50-76-97-90-73-58-98-65-64-96-55-79-88-66-57-60-80-81-94-75-51-77-95-72-68-63-53-52-69-93-87-78-83-71-59-61-92-62-89-74-91-85-54-70,101141609,22153,25601,47754
ls-nn,0-5-9-37-35-20-31-44-22-34-26-11-19-46-15-21-17-23-16-14-10-48-18-3-25-30-41-7-27-39-1-43-49-4-36-32-12-38-29-28-42-40-47-13-2-45-33-6-8-24,99-84-67-82-56-86-50-76-97-90-73-58-98-65-64-96-55-79-88-66-57-60-80-81-94-75-51-77-95-72-68-63-53-52-69-93-87-78-83-71-59-61-92-62-89-74-91-85-54-70,169552016,22153,25601,47754
ls-nn,0-5-9-37-35-20-31-44-22-34-26-11-19-46-15-21-17-23-16-14-10-48-18-3-25-30-41-7-27-39-1-43-49-4-36-32-12-38-29-28-42-40-47-13-2-45-33-6-8-24,99-84-67-82-56-86-50-76-97-90-73-58-98-65-64-96-55-79-88-66-57-60-80-81-94-75-51-77-95-72-68-63-53-52-69-93-87-78-83-71-59-61-92-62-89-74-91-85-54-70,145402167,22153,25601,47754
ls-nn,0-5-9-37-35-20-31-44-22-34-26-11-19-46-15-21-17-23-16-14-10-48-18-3-25-30-41-7-27-39-1-43-49-4-36-32-12-38-29-28-42-40-47-13-2-45-33-6-8-24,99-84-67-82-56-86-50-76-97-90-73-58-98-65-64-96-55-79-88-66-57-60-80-81-94-75-51-77-95-72-68-63-53-52-69-93-87-78-83-71-59-61-92-62-89-74-91-85-54-70,92169907,22153,25601,47754
ls-nn,0-5-9-37-35-20-31-44-22-34-26-11-19-46-15-21-17-23-16-14-10-48-18-3-25-30-41-7-27-39-1-43-49-4-36-32-12-38-29-28-42-40-47-13-2-45-33-6-8-24,99-84-67-82-56-86-50-76-97-90-73-58-98-65-64-96-55-79-88-66-57-60-80-81-94-75-51-77-95-72-68-63-53-52-69-93-87-78-83-71-59-61-92-62-89-74-91-85-54-70,88521209,22153,25601,47754
ls-nn,0-5-9-37-35-20-31-44-22-34-26-11-19-46-15-21-17-23-16-14-10-48-18-3-25-30-41-7-27-39-1-43-49-4-36-32-12-38-29-28-42-40-47-13-2-45-33-6-8-24,99-84-67-82-56-86-50-76-97-90-73-58-98-65-64-96-55-79-88-66-57-60-80-81-94-75-51-77-95-72-68-63-53-52-69-93-87-78-83-71-59-61-92-62-89-74-91-85-54-70,93718937,22153,25601,47754
ls-nn,0-5-9-37-35-20-31-44-22-34-26-11-19-46-15-21-17-23-16-14-10-48-18-3-25-30-41-7-27-39-1-43-49-4-36-32-12-38-29-28-42-40-47-13-2-45-33-6-8-24,99-84-67-82-56-86-50-76-97-90-73-58-98-65-64-96-55-79-88-66-57-60-80-81-94-75-51-77-95-72-68-63-53-52-69-93-87-78-83-71-59-61-92-62-89-74-91-85-54-70,84662720,22153,25601,47754
ls-nn,0-5-9-37-35-20-31-44-22-34-26-11-19-46-15-21-17-23-16-14-10-48-18-3-25-30-41-7-27-39-1-43-49-4-36-32-12-38-29-28-42-40-47-13-2-45-33-6-8-24,99-84-67-82-56-86-50-76-97-90-73-58-98-65-64-96-55-79-88-66-57-60-80-81-94-75-51-77-95-72-68-63-53-52-69-93-87-78-83-71-59-61-92-62-89-74-91-85-54-70,85459988,22153,25601,47754
ls-nn,0-5-9-37-35-20-31-44-22-34-26-11-19-46-15-21-17-23-16-14-10-48-18-3-25-30-41-7-27-39-1-43-49-4-36-32-12-38-29-28-42-40-47-13-2-45-33-6-8-24,99-84-67-82-56-86-50-76-97-90-73-58-98-65-64-96-55-79-88-66-57-60-80-81-94-75-51-77-95-72-68-63-53-52-69-93-87-78-83-71-59-61-92-62-89-74-91-85-54-70,90663592,22153,25601,47754
ls-nn,0-5-9-37-35-20-31-44-22-34-26-11-19-46-15-21-17-23-16-14-10-48-18-3-25-30-41-7-27-39-1-43-49-4-36-32-12-38-29-28-42-40-47-13-2-45-33-6-8-24,99-84-67-82-56-86-50-76-97-90-73-58-98-65-64-96-55-79-88-66-57-60-80-81-94-75-51-77-95-72-68-63-53-52-69-93-87-78-83-71-59-61-92-62-89-74-91-85-54-70,89102575,22153,25601,47754
ls-nn,0-5-9-37-35-20-31-44-22-34-26-11-19-46-15-21-17-23-16-14-10-48-18-3-25-30-41-7-27-39-1-43-49-4-36-32-12-38-29-28-42-40-47-13-2-45-33-6-8-24,99-84-67-82-56-86-50-76-97-90-73-58-98-65-64-96-55-79-88-66-57-60-80-81-94-75-51-77-95-72-68-63-53-52-69-93-87-78-83-71-59-61-92-62-89-74-91-85-54-70,86818987,22153,25601,47754
ls-nn,0-5-9-37-35-20-31-44-22-34-26-11-19-46-15-21-17-23-16-14-10-48-18-3-25-30-41-7-27-39-1-43-49-4-36-32-12-38-29-28-42-40-47-13-2-45-33-6-8-24,99-84-67-82-56-86-50-76-97-90-73-58-98-65-64-96-55-79-88-66-57-60-80-81-94-75-51-77-95-72-68-63-53-52-69-93-87-78-83-71-59-61-92-62-89-74-91-85-54-70,94206680,22153,25601,47754
ls-nn,0-5-9-37-35-20-31-44-22-34-26-11-19-46-15-21-17-23-16-14-10-48-18-3-25-30-41-7-27-39-1-43-49-4-36-32-12-38-29-28-42-40-47-13-2-45-33-6-8-24,99-84-67-82-56-86-50-76-97-90-73-58-98-65-64-96-55-79-88-66-57-60-80-81-94-75-51-77-95-72-68-63-53-52-69-93-87-78-83-71-59-61-92-62-89-74-91-85-54-70,86984917,22153,25601,47754
ls-nn,0-5-9-37-35-20-31-44-22-34-26-11-19-46-15-21-17-23-16-14-10-48-18-3-25-30-41-7-27-39-1-43-49-4-36-32-12-38-29-28-42-40-47-13-2-45-33-6-8-24,99-84-67-82-56-86-50-76-97-90-73-58-98-65-64-96-55-79-88-66-57-60-80-81-94-75-51-77-95-72-68-63-53-52-69-93-87-78-83-71-59-61-92-62-89-74-91-85-54-70,83238218,22153,25601,47754
ls-nn,0-5-9-37-35-20-31-44-22-34-26-11-19-46-15-21-17-23-16-14-10-48-18-3-25-30-41-7-27-39-1-43-49-4-36-32-12-38-29-28-42-40-47-13-2-45-33-6-8-24,99-84-67-82-56-86-50-76-97-90-73-58-98-65-64-96-55-79-88-66-57-60-80-81-94-75-51-77-95-72-68-63-53-52-69-93-87-78-83-71-59-61-92-62-89-74-91-85-54-70,196560560,22153,25601,47754
ls-nn,0-5-9-37-35-20-31-44-22-34-26-11-19-46-15-21-17-23-16-14-10-48-18-3-25-30-41-7-27-39-1-43-49-4-36-32-12-38-29-28-42-40-47-13-2-45-33-6-8-24,99-84-67-82-56-86-50-76-97-90-73-58-98-65-64-96-55-79-88-66-57-60-80-81-94-75-51-77-95-72-68-63-53-52-69-93-87-78-83-71-59-61-92-62-89-74-91-85-54-70,96416728,22153,25601,47754
ls-nn,0-5-9-37-35-20-31-44-22-34-26-11-19-46-15-21-17-23-16-14-10-48-18-3-25-30-41-7-27-39-1-43-49-4-36-32-12-38-29-28-42-40-47-13-2-45-33-6-8-24,99-84-67-82-56-86-50-76-97-90-73-58-98-65-64-96-55-79-88-66-57-60-80-81-94-75-51-77-95-72-68-63-53-52-69-93-87-78-83-71-59-61-92-62-89-74-91-85-54-70,87839331,22153,25601,47754
ls-nn,0-5-9-37-35-20-31-44-22-34-26-11-19-46-15-21-17-23-16-14-10-48-18-3-25-30-41-7-27-39-1-43-49-4-36-32-12-38-29-28-42-40-47-13-2-45-33-6-8-24,99-84-67-82-56-86-50-76-97-90-73-58-98-65-64-96-55-79-88-66-57-60-80-81-94-75-51-77-95-72-68-63-53-52-69-93-87-78-83-71-59-61-92-62-89-74-91-85-54-70,91917951,22153,25601,47754
ls-nn,0-5-9-37-35-20-31-44-22-34-26-11-19-46-15-21-17-23-16-14-10-48-18-3-25-30-41-7-27-39-1-43-49-4-36-32-12-38-29-28-42-40-47-13-2-45-33-6-8-24,99-84-67-82-56-86-50-76-97-90-73-58-98-65-64-96-55-79-88-66-57-60-80-81-94-75-51-77-95-72-68-63-53-52-69-93-87-78-83-71-59-61-92-62-89-74-91-85-54-70,86348936,22153,25601,47754
ls-nn,0-5-9-37-35-20-31-44-22-34-26-11-19-46-15-21-17-23-16-14-10-48-18-3-25-30-41-7-27-39-1-43-49-4-36-32-12-38-29-28-42-40-47-13-2-45-33-6-8-24,99-84-67-82-56-86-50-76-97-90-73-58-98-65-64-96-55-79-88-66-57-60-80-81-94-75-51-77-95-72-68-63-53-52-69-93-87-78-83-71-59-61-92-62-89-74-91-85-54-70,182284403,22153,25601,47754
ls-nn,0-5-9-37-35-20-31-44-22-34-26-11-19-46-15-21-17-23-16-14-10-48-18-3-25-30-41-7-27-39-1-43-49-4-36-32-12-38-29-28-42-40-47-13-2-45-33-6-8-24,99-84-67-82-56-86-50-76-97-90-73-58-98-65-64-96-55-79-88-66-57-60-80-81-94-75-51-77-95-72-68-63-53-52-69-93-87-78-83-71-59-61-92-62-89-74-91-85-54-70,119231209,22153,25601,47754
ls-nn,0-5-9-37-35-20-31-44-22-34-26-11-19-46-15-21-17-23-16-14-10-48-18-3-25-30-41-7-27-39-1-43-49-4-36-32-12-38-29-28-42-40-47-13-2-45-33-6-8-24,99-84-67-82-56-86-50-76-97-90-73-58-98-65-64-96-55-79-88-66-57-60-80-81-94-75-51-77-95-72-68-63-53-52-69-93-87-78-83-71-59-61-92-62-89-74-91-85-54-70,88769935,22153,25601,47754
ls-nn,0-5-9-37-35-20-31-44-22-34-26-11-19-46-15-21-17-23-16-14-10-48-18-3-25-30-41-7-27-39-1-43-49-4-36-32-12-38-29-28-42-40-47-13-2-45-33-6-8-24,99-84-67-82-56-86-50-76-97-90-73-58-98-65-64-96-55-79-88-66-57-60-80-81-94-75-51-77-95-72-68-63-53-52-69-93-87-78-83-71-59-61-92-62-89-74-91-85-54-70,169059164,22153,25601,47754
ls-nn,0-5-9-37-35-20-31-44-22-34-26-11-19-46-15-21-17-23-16-14-10-48-18-3-25-30-41-7-27-39-1-43-49-4-36-32-12-38-29-28-42-40-47-13-2-45-33-6-8-24,99-84-67-82-56-86-50-76-97-90-73-58-98-65-64-96-55-79-88-66-57-60-80-81-94-75-51-77-95-72-68-63-53-52-69-93-87-78-83-71-59-61-92-62-89-74-91-85-54-70,176239300,22153,25601,47754
ls-nn,0-5-9-37-35-20-31-44-22-34-26-11-19-46-15-21-17-23-16-14-10-48-18-3-25-30-41-7-27-39-1-43-49-4-36-32-12-38-29-28-42-40-47-13-2-45-33-6-8-24,99-84-67-82-56-86-50-76-97-90-73-58-98-65-64-96-55-79-88-66-57-60-80-81-94-75-51-77-95-72-68-63-53-52-69-93-87-78-83-71-59-61-92-62-89-74-91-85-54-70,166825678,22153,25601,47754
ls-nn,0-5-9-37-35-20-31-44-22-34-26-11-19-46-15-21-17-23-16-14-10-48-18-3-25-30-41-7-27-39-1-43-49-4-36-32-12-38-29-28-42-40-47-13-2-45-33-6-8-24,99-84-67-82-56-86-50-76-97-90-73-58-98-65-64-96-55-79-88-66-57-60-80-81-94-75-51-77-95-72-68-63-53-52-69-93-87-78-83-71-59-61-92-62-89-74-91-85-54-70,140170541,22153,25601,47754
ls-nn,0-5-9-37-35-20-31-44-22-34-26-11-19-46-15-21-17-23-16-14-10-48-18-3-25-30-41-7-27-39-1-43-49-4-36-32-12-38-29-28-42-40-47-13-2-45-33-6-8-24,99-84-67-82-56-86-50-76-97-90-73-58-98-65-64-96-55-79-88-66-57-60-80-81-94-75-51-77-95-72-68-63-53-52-69-93-87-78-83-71-59-61-92-62-89-74-91-85-54-70,162487087,22153,25601,47754
ls-nn,0-5-9-37-35-20-31-44-22-34-26-11-19-46-15-21-17-23-16-14-10-48-18-3-25-30-41-7-27-39-1-43-49-4-36-32-12-38-29-28-42-40-47-13-2-45-33-6-8-24,99-84-67-82-56-86-50-76-97-90-73-58-98-65-64-96-55-79-88-66-57-60-80-81-94-75-51-77-95-72-68-63-53-52-69-93-87-78-83-71-59-61-92-62-89-74-91-85-54-70,102884199,22153,25601,47754
ls-nn,0-5-9-37-35-20-31-44-22-34-26-11-19-46-15-21-17-23-16-14-10-48-18-3-25-30-41-7-27-39-1-43-49-4-36-32-12-38-29-28-42-40-47-13-2-45-33-6-8-24,99-84-67-82-56-86-50-76-97-90-73-58-98-65-64-96-55-79-88-66-57-60-80-81-94-75-51-77-95-72-68-63-53-52-69-93-87-78-83-71-59-61-92-62-89-74-91-85-54-70,171129128,22153,25601,47754
ls-nn,0-5-9-37-35-20-31-44-22-34-26-11-19-46-15-21-17-23-16-14-10-48-18-3-25-30-41-7-27-39-1-43-49-4-36-32-12-38-29-28-42-40-47-13-2-45-33-6-8-24,99-84-67-82-56-86-50-76-97-90-73-58-98-65-64-96-55-79-88-66-57-60-80-81-94-75-51-77-95-72-68-63-53-52-69-93-87-78-83-71-59-61-92-62-89-74-91-85-54-70,157918783,22153,25601,47754
ls-nn,0-5-9-37-35-20-31-44-22-34-26-11-19-46-15-21-17-23-16-14-10-48-18-3-25-30-41-7-27-39-1-43-49-4-36-32-12-38-29-28-42-40-47-13-2-45-33-6-8-24,99-84-67-82-56-86-50-76-97-90-73-58-98-65-64-96-55-79-88-66-57-60-80-81-94-75-51-77-95-72-68-63-53-52-69-93-87-78-83-71-59-61-92-62-89-74-91-85-54-70,109036575,22153,25601,47754
ls-nn,0-5-9-37-35-20-31-44-22-34-26-11-19-46-15-21-17-23-16-14-10-48-18-3-25-30-41-7-27-39-1-43-49-4-36-32-12-38-29-28-42-40-47-13-2-45-33-6-8-24,99-84-67-82-56-86-50-76-97-90-73-58-98-65-64-96-55-79-88-66-57-60-80-81-94-75-51-77-95-72-68-63-53-52-69-93-87-78-83-71-59-61-92-62-89-74-91-85-54-70,181760284,22153,25601,47754
ls-nn,0-5-9-37-35-20-31-44-22-34-26-11-19-46-15-21-17-23-16-14-10-48-18-3-25-30-41-7-27-39-1-43-49-4-36-32-12-38-29-28-42-40-47-13-2-45-33-6-8-24,99-84-67-82-56-86-50-76-97-90-73-58-98-65-64-96-55-79-88-66-57-60-80-81-94-75-51-77-95-72-68-63-53-52-69-93-87-78-83-71-59-61-92-62-89-74-91-85-54-70,159167620,22153,25601,47754
ls-nn,0-5-9-37-35-20-31-44-22-34-26-11-19-46-15-21-17-23-16-14-10-48-18-3-25-30-41-7-27-39-1-43-49-4-36-32-12-38-29-28-42-40-47-13-2-45-33-6-8-24,99-84-67-82-56-86-50-76-97-90-73-58-98-65-64-96-55-79-88-66-57-60-80-81-94-75-51-77-95-72-68-63-53-52-69-93-87-78-83-71-59-61-92-62-89-74-91-85-54-70,125469747,22153,25601,47754
ls-nn,0-5-9-37-35-20-31-44-22-34-26-11-19-46-15-21-17-23-16-14-10-48-18-3-25-30-41-7-27-39-1-43-49-4-36-32-12-38-29-28-42-40-47-13-2-45-33-6-8-24,99-84-67-82-56-86-50-76-97-90-73-58-98-65-64-96-55-79-88-66-57-60-80-81-94-75-51-77-95-72-68-63-53-52-69-93-87-78-83-71-59-61-92-62-89-74-91-85-54-70,148267540,22153,25601,47754
ls-nn,0-5-9-37-35-20-31-44-22-34-26-11-19-46-15-21-17-23-16-14-10-48-18-3-25-30-41-7-27-39-1-43-49-4-36-32-12-38-29-28-42-40-47-13-2-45-33-6-8-24,99-84-67-82-56-86-50-76-97-90-73-58-98-65-64-96-55-79-88-66-57-60-80-81-94-75-51-77-95-72-68-63-53-52-69-93-87-78-83-71-59-61-92-62-89-74-91-85-54-70,141422808,22153,25601,47754
ls-nn,0-5-9-37-35-20-31-44-22-34-26-11-19-46-15-21-17-23-16-14-10-48-18-3-25-30-41-7-27-39-1-43-49-4-36-32-12-38-29-28-42-40-47-13-2-45-33-6-8-24,99-84-67-82-56-86-50-76-97-90-73-58-98-65-64-96-55-79-88-66-57-60-80-81-94-75-51-77-95-72-68-63-53-52-69-93-87-78-83-71-59-61-92-62-89-74-91-85-54-70,102343522,22153,25601,47754
ls-nn,0-5-9-37-35-20-31-44-22-34-26-11-19-46-15-21-17-23-16-14-10-48-18-3-25-30-41-7-27-39-1-43-49-4-36-32-12-38-29-28-42-40-47-13-2-45-33-6-8-24,99-84-67-82-56-86-50-76-97-90-73-58-98-65-64-96-55-79-88-66-57-60-80-81-94-75-51-77-95-72-68-63-53-52-69-93-87-78-83-71-59-61-92-62-89-74-91-85-54-70,97535535,22153,25601,47754
ls-nn,0-5-9-37-35-20-31-44-22-34-26-11-19-46-15-21-17-23-16-14-10-48-18-3-25-30-41-7-27-39-1-43-49-4-36-32-12-38-29-28-42-40-47-13-2-45-33-6-8-24,99-84-67-82-56-86-50-76-97-90-73-58-98-65-64-96-55-79-88-66-57-60-80-81-94-75-51-77-95-72-68-63-53-52-69-93-87-78-83-71-59-61-92-62-89-74-91-85-54-70,100133444,22153,25601,47754
ls-nn,0-5-9-37-35-20-31-44-22-34-26-11-19-46-15-21-17-23-16-14-10-48-18-3-25-30-41-7-27-39-1-43-49-4-36-32-12-38-29-28-42-40-47-13-2-45-33-6-8-24,99-84-67-82-56-86-50-76-97-90-73-58-98-65-64-96-55-79-88-66-57-60-80-81-94-75-51-77-95-72-68-63-53-52-69-93-87-78-83-71-59-61-92-62-89-74-91-85-54-70,92397107,22153,25601,47754
ls-nn,0-5-9-37-35-20-31-44-22-34-26-11-19-46-15-21-17-23-16-14-10-48-18-3-25-30-41-7-27-39-1-43-49-4-36-32-12-38-29-28-42-40-47-13-2-45-33-6-8-24,99-84-67-82-56-86-50-76-97-90-73-58-98-65-64-96-55-79-88-66-57-60-80-81-94-75-51-77-95-72-68-63-53-52-69-93-87-78-83-71-59-61-92-62-89-74-91-85-54-70,100984910,22153,25601,47754
ls-nn,0-5-9-37-35-20-31-44-22-34-26-11-19-46-15-21-17-23-16-14-10-48-18-3-25-30-41-7-27-39-1-43-49-4-36-32-12-38-29-28-42-40-47-13-2-45-33-6-8-24,99-84-67-82-56-86-50-76-97-90-73-58-98-65-64-96-55-79-88-66-57-60-80-81-94-75-51-77-95-72-68-63-53-52-69-93-87-78-83-71-59-61-92-62-89-74-91-85-54-70,190170731,22153,25601,47754
ls-nn,0-5-9-37-35-20-31-44-22-34-26-11-19-46-15-21-17-23-16-14-10-48-18-3-25-30-41-7-27-39-1-43-49-4-36-32-12-38-29-28-42-40-47-13-2-45-33-6-8-24,99-84-67-82-56-86-50-76-97-90-73-58-98-65-64-96-55-79-88-66-57-60-80-81-94-75-51-77-95-72-68-63-53-52-69-93-87-78-83-71-59-61-92-62-89-74-91-85-54-70,160592126,22153,25601,47754
ls-nn,0-5-9-37-35-20-31-44-22-34-26-11-19-46-15-21-17-23-16-14-10-48-18-3-25-30-41-7-27-39-1-43-49-4-36-32-12-38-29-28-42-40-47-13-2-45-33-6-8-24,99-84-67-82-56-86-50-76-97-90-73-58-98-65-64-96-55-79-88-66-57-60-80-81-94-75-51-77-95-72-68-63-53-52-69-93-87-78-83-71-59-61-92-62-89-74-91-85-54-70,139882249,22153,25601,47754
ls-nn,0-5-9-37-35-20-31-44-22-34-26-11-19-46-15-21-17-23-16-14-10-48-18-3-25-30-41-7-27-39-1-43-49-4-36-32-12-38-29-28-42-40-47-13-2-45-33-6-8-24,99-84-67-82-56-86-50-76-97-90-73-58-98-65-64-96-55-79-88-66-57-60-80-81-94-75-51-77-95-72-68-63-53-52-69-93-87-78-83-71-59-61-92-62-89-74-91-85-54-70,181167440,22153,25601,47754
ls-nn,0-5-9-37-35-20-31-44-22-34-26-11-19-46-15-21-17-23-16-14-10-48-18-3-25-30-41-7-27-39-1-43-49-4-36-32-12-38-29-28-42-40-47-13-2-45-33-6-8-24,99-84-67-82-56-86-50-76-97-90-73-58-98-65-64-96-55-79-88-66-57-60-80-81-94-75-51-77-95-72-68-63-53-52-69-93-87-78-83-71-59-61-92-62-89-74-91-85-54-70,174017800,22153,25601,47754
ls-nn,0-5-9-37-35-20-31-44-22-34-26-11-19-46-15-21-17-23-16-14-10-48-18-3-25-30-41-7-27-39-1-43-49-4-36-32-12-38-29-28-42-40-47-13-2-45-33-6-8-24,99-84-67-82-56-86-50-76-97-90-73-58-98-65-64-96-55-79-88-66-57-60-80-81-94-75-51-77-95-72-68-63-53-52-69-93-87-78-83-71-59-61-92-62-89-74-91-85-54-70,164045066,22153,25601,47754
ls-nn,0-5-9-37-35-20-31-44-22-34-26-11-19-46-15-21-17-23-16-14-10-48-18-3-25-30-41-7-27-39-1-43-49-4-36-32-12-38-29-28-42-40-47-13-2-45-33-6-8-24,99-84-67-82-56-86-50-76-97-90-73-58-98-65-64-96-55-79-88-66-57-60-80-81-94-75-51-77-95-72-68-63-53-52-69-93-87-78-83-71-59-61-92-62-89-74-91-85-54-70,178138917,22153,25601,47754
ls-nn,0-5-9-37-35-20-31-44-22-34-26-11-19-46-15-21-17-23-16-14-10-48-18-3-25-30-41-7-27-39-1-43-49-4-36-32-12-38-29-28-42-40-47-13-2-45-33-6-8-24,99-84-67-82-56-86-50-76-97-90-73-58-98-65-64-96-55-79-88-66-57-60-80-81-94-75-51-77-95-72-68-63-53-52-69-93-87-78-83-71-59-61-92-62-89-74-91-85-54-70,133036353,22153,25601,47754
ls-nn,0-5-9-37-35-20-31-44-22-34-26-11-19-46-15-21-17-23-16-14-10-48-18-3-25-30-41-7-27-39-1-43-49-4-36-32-12-38-29-28-42-40-47-13-2-45-33-6-8-24,99-84-67-82-56-86-50-76-97-90-73-58-98-65-64-96-55-79-88-66-57-60-80-81-94-75-51-77-95-72-68-63-53-52-69-93-87-78-83-71-59-61-92-62-89-74-91-85-54-70,103511601,22153,25601,47754
ls-nn,0-5-9-37-35-20-31-44-22-34-26-11-19-46-15-21-17-23-16-14-10-48-18-3-25-30-41-7-27-39-1-43-49-4-36-32-12-38-29-28-42-40-47-13-2-45-33-6-8-24,99-84-67-82-56-86-50-76-97-90-73-58-98-65-64-96-55-79-88-66-57-60-80-81-94-75-51-77-95-72-68-63-53-52-69-93-87-78-83-71-59-61-92-62-89-74-91-85-54-70,153375260,22153,25601,47754
ls-nn,0-5-9-37-35-20-31-44-22-34-26-11-19-46-15-21-17-23-16-14-10-48-18-3-25-30-41-7-27-39-1-43-49-4-36-32-12-38-29-28-42-40-47-13-2-45-33-6-8-24,99-84-67-82-56-86-50-76-97-90-73-58-98-65-64-96-55-79-88-66-57-60-80-81-94-75-51-77-95-72-68-63-53-52-69-93-87-78-83-71-59-61-92-62-89-74-91-85-54-70,184658582,22153,25601,47754
ls-nn,0-5-9-37-35-20-31-44-22-34-26-11-19-46-15-21-17-23-16-14-10-48-18-3-25-30-41-7-27-39-1-43-49-4-36-32-12-38-29-28-42-40-47-13-2-45-33-6-8-24,99-84-67-82-56-86-50-76-97-90-73-58-98-65-64-96-55-79-88-66-57-60-80-81-94-75-51-77-95-72-68-63-53-52-69-93-87-78-83-71-59-61-92-62-89-74-91-85-54-70,143647588,22153,25601,47754
ls-nn,0-5-9-37-35-20-31-44-22-34-26-11-19-46-15-21-17-23-16-14-10-48-18-3-25-30-41-7-27-39-1-43-49-4-36-32-12-38-29-28-42-40-47-13-2-45-33-6-8-24,99-84-67-82-56-86-50-76-97-90-73-58-98-65-64-96-55-79-88-66-57-60-80-81-94-75-51-77-95-72-68-63-53-52-69-93-87-78-83-71-59-61-92-62-89-74-91-85-54-70,181169302,22153,25601,47754
ls-nn,0-5-9-37-35-20-31-44-22-34-26-11-19-46-15-21-17-23-16-14-10-48-18-3-25-30-41-7-27-39-1-43-49-4-36-32-12-38-29-28-42-40-47-13-2-45-33-6-8-24,99-84-67-82-56-86-50-76-97-90-73-58-98-65-64-96-55-79-88-66-57-60-80-81-94-75-51-77-95-72-68-63-53-52-69-93-87-78-83-71-59-61-92-62-89-74-91-85-54-70,133998779,22153,25601,47754
ls-nn,0-5-9-37-35-20-31-44-22-34-26-11-19-46-15-21-17-23-16-14-10-48-18-3-25-30-41-7-27-39-1-43-49-4-36-32-12-38-29-28-42-40-47-13-2-45-33-6-8-24,99-84-67-82-56-86-50-76-97-90-73-58-98-65-64-96-55-79-88-66-57-60-80-81-94-75-51-77-95-72-68-63-53-52-69-93-87-78-83-71-59-61-92-62-89-74-91-85-54-70,100546215,22153,25601,47754
ls-nn,0-5-9-37-35-20-31-44-22-34-26-11-19-46-15-21-17-23-16-14-10-48-18-3-25-30-41-7-27-39-1-43-49-4-36-32-12-38-29-28-42-40-47-13-2-45-33-6-8-24,99-84-67-82-56-86-50-76-97-90-73-58-98-65-64-96-55-79-88-66-57-60-80-81-94-75-51-77-95-72-68-63-53-52-69-93-87-78-83-71-59-61-92-62-89-74-91-85-54-70,100008745,22153,25601,47754
ls-nn,0-5-9-37-35-20-31-44-22-34-26-11-19-46-15-21-17-23-16-14-10-48-18-3-25-30-41-7-27-39-1-43-49-4-36-32-12-38-29-28-42-40-47-13-2-45-33-6-8-24,99-84-67-82-56-86-50-76-97-90-73-58-98-65-64-96-55-79-88-66-57-60-80-81-94-75-51-77-95-72-68-63-53-52-69-93-87-78-83-71-59-61-92-62-89-74-91-85-54-70,95471119,22153,25601,47754
ls-nn,0-5-9-37-35-20-31-44-22-34-26-11-19-46-15-21-17-23-16-14-10-48-18-3-25-30-41-7-27-39-1-43-49-4-36-32-12-38-29-28-42-40-47-13-2-45-33-6-8-24,99-84-67-82-56-86-50-76-97-90-73-58-98-65-64-96-55-79-88-66-57-60-80-81-94-75-51-77-95-72-68-63-53-52-69-93-87-78-83-71-59-61-92-62-89-74-91-85-54-70,103255401,22153,25601,47754
ls-nn,0-5-9-37-35-20-31-44-22-34-26-11-19-46-15-21-17-23-16-14-10-48-18-3-25-30-41-7-27-39-1-43-49-4-36-32-12-38-29-28-42-40-47-13-2-45-33-6-8-24,99-84-67-82-56-86-50-76-97-90-73-58-98-65-64-96-55-79-88-66-57-60-80-81-94-75-51-77-95-72-68-63-53-52-69-93-87-78-83-71-59-61-92-62-89-74-91-85-54-70,96912577,22153,25601,47754
ls-nn,0-5-9-37-35-20-31-44-22-34-26-11-19-46-15-21-17-23-16-14-10-48-18-3-25-30-41-7-27-39-1-43-49-4-36-32-12-38-29-28-42-40-47-13-2-45-33-6-8-24,99-84-67-82-56-86-50-76-97-90-73-58-98-65-64-96-55-79-88-66-57-60-80-81-94-75-51-77-95-72-68-63-53-52-69-93-87-78-83-71-59-61-92-62-89-74-91-85-54-70,95333064,22153,25601,47754
ls-nn,0-5-9-37-35-20-31-44-22-34-26-11-19-46-15-21-17-23-16-14-10-48-18-3-25-30-41-7-27-39-1-43-49-4-36-32-12-38-29-28-42-40-47-13-2-45-33-6-8-24,99-84-67-82-56-86-50-76-97-90-73-58-98-65-64-96-55-79-88-66-57-60-80-81-94-75-51-77-95-72-68-63-53-52-69-93-87-78-83-71-59-61-92-62-89-74-91-85-54-70,98028615,22153,25601,47754
ls-nn,0-5-9-37-35-20-31-44-22-34-26-11-19-46-15-21-17-23-16-14-10-48-18-3-25-30-41-7-27-39-1-43-49-4-36-32-12-38-29-28-42-40-47-13-2-45-33-6-8-24,99-84-67-82-56-86-50-76-97-90-73-58-98-65-64-96-55-79-88-66-57-60-80-81-94-75-51-77-95-72-68-63-53-52-69-93-87-78-83-71-59-61-92-62-89-74-91-85-54-70,93479015,22153,25601,47754
ls-nn,0-5-9-37-35-20-31-44-22-34-26-11-19-46-15-21-17-23-16-14-10-48-18-3-25-30-41-7-27-39-1-43-49-4-36-32-12-38-29-28-42-40-47-13-2-45-33-6-8-24,99-84-67-82-56-86-50-76-97-90-73-58-98-65-64-96-55-79-88-66-57-60-80-81-94-75-51-77-95-72-68-63-53-52-69-93-87-78-83-71-59-61-92-62-89-74-91-85-54-70,94402506,22153,25601,47754
ls-nn,0-5-9-37-35-20-31-44-22-34-26-11-19-46-15-21-17-23-16-14-10-48-18-3-25-30-41-7-27-39-1-43-49-4-36-32-12-38-29-28-42-40-47-13-2-45-33-6-8-24,99-84-67-82-56-86-50-76-97-90-73-58-98-65-64-96-55-79-88-66-57-60-80-81-94-75-51-77-95-72-68-63-53-52-69-93-87-78-83-71-59-61-92-62-89-74-91-85-54-70,102520382,22153,25601,47754
ls-nn,0-5-9-37-35-20-31-44-22-34-26-11-19-46-15-21-17-23-16-14-10-48-18-3-25-30-41-7-27-39-1-43-49-4-36-32-12-38-29-28-42-40-47-13-2-45-33-6-8-24,99-84-67-82-56-86-50-76-97-90-73-58-98-65-64-96-55-79-88-66-57-60-80-81-94-75-51-77-95-72-68-63-53-52-69-93-87-78-83-71-59-61-92-62-89-74-91-85-54-70,97388203,22153,25601,47754
ls-nn,0-5-9-37-35-20-31-44-22-34-26-11-19-46-15-21-17-23-16-14-10-48-18-3-25-30-41-7-27-39-1-43-49-4-36-32-12-38-29-28-42-40-47-13-2-45-33-6-8-24,99-84-67-82-56-86-50-76-97-90-73-58-98-65-64-96-55-79-88-66-57-60-80-81-94-75-51-77-95-72-68-63-53-52-69-93-87-78-83-71-59-61-92-62-89-74-91-85-54-70,86658391,22153,25601,47754
ls-nn,0-5-9-37-35-20-31-44-22-34-26-11-19-46-15-21-17-23-16-14-10-48-18-3-25-30-41-7-27-39-1-43-49-4-36-32-12-38-29-28-42-40-47-13-2-45-33-6-8-24,99-84-67-82-56-86-50-76-97-90-73-58-98-65-64-96-55-79-88-66-57-60-80-81-94-75-51-77-95-72-68-63-53-52-69-93-87-78-83-71-59-61-92-62-89-74-91-85-54-70,93190149,22153,25601,47754
ls-nn,0-5-9-37-35-20-31-44-22-34-26-11-19-46-15-21-17-23-16-14-10-48-18-3-25-30-41-7-27-39-1-43-49-4-36-32-12-38-29-28-42-40-47-13-2-45-33-6-8-24,99-84-67-82-56-86-50-76-97-90-73-58-98-65-64-96-55-79-88-66-57-60-80-81-94-75-51-77-95-72-68-63-53-52-69-93-87-78-83-71-59-61-92-62-89-74-91-85-54-70,88820305,22153,25601,47754
ls-nn,0-5-9-37-35-20-31-44-22-34-26-11-19-46-15-21-17-23-16-14-10-48-18-3-25-30-41-7-27-39-1-43-49-4-36-32-12-38-29-28-42-40-47-13-2-45-33-6-8-24,99-84-67-82-56-86-50-76-97-90-73-58-98-65-64-96-55-79-88-66-57-60-80-81-94-75-51-77-95-72-68-63-53-52-69-93-87-78-83-71-59-61-92-62-89-74-91-85-54-70,99542621,22153,25601,47754
ls-nn,0-5-9-37-35-20-31-44-22-34-26-11-19-46-15-21-17-23-16-14-10-48-18-3-25-30-41-7-27-39-1-43-49-4-36-32-12-38-29-28-42-40-47-13-2-45-33-6-8-24,99-84-67-82-56-86-50-76-97-90-73-58-98-65-64-96-55-79-88-66-57-60-80-81-94-75-51-77-95-72-68-63-53-52-69-93-87-78-83-71-59-61-92-62-89-74-91-85-54-70,100765960,22153,25601,47754
ls-nn,0-5-9-37-35-20-31-44-22-34-26-11-19-46-15-21-17-23-16-14-10-48-18-3-25-30-41-7-27-39-1-43-49-4-36-32-12-38-29-28-42-40-47-13-2-45-33-6-8-24,99-84-67-82-56-86-50-76-97-90-73-58-98-65-64-96-55-79-88-66-57-60-80-81-94-75-51-77-95-72-68-63-53-52-69-93-87-78-83-71-59-61-92-62-89-74-91-85-54-70,93005108,22153,25601,47754
ls-nn,0-5-9-37-35-20-31-44-22-34-26-11-19-46-15-21-17-23-16-14-10-48-18-3-25-30-41-7-27-39-1-43-49-4-36-32-12-38-29-28-42-40-47-13-2-45-33-6-8-24,99-84-67-82-56-86-50-76-97-90-73-58-98-65-64-96-55-79-88-66-57-60-80-81-94-75-51-77-95-72-68-63-53-52-69-93-87-78-83-71-59-61-92-62-89-74-91-85-54-70,88341554,22153,25601,47754
ls-nn,0-5-9-37-35-20-31-44-22-34-26-11-19-46-15-21-17-23-16-14-10-48-18-3-25-30-41-7-27-39-1-43-49-4-36-32-12-38-29-28-42-40-47-13-2-45-33-6-8-24,99-84-67-82-56-86-50-76-97-90-73-58-98-65-64-96-55-79-88-66-57-60-80-81-94-75-51-77-95-72-68-63-53-52-69-93-87-78-83-71-59-61-92-62-89-74-91-85-54-70,102560392,22153,25601,47754
ls-nn,0-5-9-37-35-20-31-44-22-34-26-11-19-46-15-21-17-23-16-14-10-48-18-3-25-30-41-7-27-39-1-43-49-4-36-32-12-38-29-28-42-40-47-13-2-45-33-6-8-24,99-84-67-82-56-86-50-76-97-90-73-58-98-65-64-96-55-79-88-66-57-60-80-81-94-75-51-77-95-72-68-63-53-52-69-93-87-78-83-71-59-61-92-62-89-74-91-85-54-70,103168413,22153,25601,47754
ls-nn,0-5-9-37-35-20-31-44-22-34-26-11-19-46-15-21-17-23-16-14-10-48-18-3-25-30-41-7-27-39-1-43-49-4-36-32-12-38-29-28-42-40-47-13-2-45-33-6-8-24,99-84-67-82-56-86-50-76-97-90-73-58-98-65-64-96-55-79-88-66-57-60-80-81-94-75-51-77-95-72-68-63-53-52-69-93-87-78-83-71-59-61-92-62-89-74-91-85-54-70,95747464,22153,25601,47754
ls-nn,0-5-9-37-35-20-31-44-22-34-26-11-19-46-15-21-17-23-16-14-10-48-18-3-25-30-41-7-27-39-1-43-49-4-36-32-12-38-29-28-42-40-47-13-2-45-33-6-8-24,99-84-67-82-56-86-50-76-97-90-73-58-98-65-64-96-55-79-88-66-57-60-80-81-94-75-51-77-95-72-68-63-53-52-69-93-87-78-83-71-59-61-92-62-89-74-91-85-54-70,98439614,22153,25601,47754
ls-nn,0-5-9-37-35-20-31-44-22-34-26-11-19-46-15-21-17-23-16-14-10-48-18-3-25-30-41-7-27-39-1-43-49-4-36-32-12-38-29-28-42-40-47-13-2-45-33-6-8-24,99-84-67-82-56-86-50-76-97-90-73-58-98-65-64-96-55-79-88-66-57-60-80-81-94-75-51-77-95-72-68-63-53-52-69-93-87-78-83-71-59-61-92-62-89-74-91-85-54-70,94102943,22153,25601,47754
ls-nn,0-5-9-37-35-20-31-44-22-34-26-11-19-46-15-21-17-23-16-14-10-48-18-3-25-30-41-7-27-39-1-43-49-4-36-32-12-38-29-28-42-40-47-13-2-45-33-6-8-24,99-84-67-82-56-86-50-76-97-90-73-58-98-65-64-96-55-79-88-66-57-60-80-81-94-75-51-77-95-72-68-63-53-52-69-93-87-78-83-71-59-61-92-62-89-74-91-85-54-70,92303550,22153,25601,47754
ls-nn,0-5-9-37-35-20-31-44-22-34-26-11-19-46-15-21-17-23-16-14-10-48-18-3-25-30-41-7-27-39-1-43-49-4-36-32-12-38-29-28-42-40-47-13-2-45-33-6-8-24,99-84-67-82-56-86-50-76-97-90-73-58-98-65-64-96-55-79-88-66-57-60-80-81-94-75-51-77-95-72-68-63-53-52-69-93-87-78-83-71-59-61-92-62-89-74-91-85-54-70,190566414,22153,25601,47754
ls-nn,0-5-9-37-35-20-31-44-22-34-26-11-19-46-15-21-17-23-16-14-10-48-18-3-25-30-41-7-27-39-1-43-49-4-36-32-12-38-29-28-42-40-47-13-2-45-33-6-8-24,99-84-67-82-56-86-50-76-97-90-73-58-98-65-64-96-55-79-88-66-57-60-80-81-94-75-51-77-95-72-68-63-53-52-69-93-87-78-83-71-59-61-92-62-89-74-91-85-54-70,106692780,22153,25601,47754
ls-nn,0-5-9-37-35-20-31-44-22-34-26-11-19-46-15-21-17-23-16-14-10-48-18-3-25-30-41-7-27-39-1-43-49-4-36-32-12-38-29-28-42-40-47-13-2-45-33-6-8-24,99-84-67-82-56-86-50-76-97-90-73-58-98-65-64-96-55-79-88-66-57-60-80-81-94-75-51-77-95-72-68-63-53-52-69-93-87-78-83-71-59-61-92-62-89-74-91-85-54-70,91263704,22153,25601,47754
ls-nn,0-5-9-37-35-20-31-44-22-34-26-11-19-46-15-21-17-23-16-14-10-48-18-3-25-30-41-7-27-39-1-43-49-4-36-32-12-38-29-28-42-40-47-13-2-45-33-6-8-24,99-84-67-82-56-86-50-76-97-90-73-58-98-65-64-96-55-79-88-66-57-60-80-81-94-75-51-77-95-72-68-63-53-52-69-93-87-78-83-71-59-61-92-62-89-74-91-85-54-70,88535293,22153,25601,47754
ls-nn,0-5-9-37-35-20-31-44-22-34-26-11-19-46-15-21-17-23-16-14-10-48-18-3-25-30-41-7-27-39-1-43-49-4-36-32-12-38-29-28-42-40-47-13-2-45-33-6-8-24,99-84-67-82-56-86-50-76-97-90-73-58-98-65-64-96-55-79-88-66-57-60-80-81-94-75-51-77-95-72-68-63-53-52-69-93-87-78-83-71-59-61-92-62-89-74-91-85-54-70,87937625,22153,25601,47754
ls-nn,0-5-9-37-35-20-31-44-22-34-26-11-19-46-15-21-17-23-16-14-10-48-18-3-25-30-41-7-27-39-1-43-49-4-36-32-12-38-29-28-42-40-47-13-2-45-33-6-8-24,99-84-67-82-56-86-50-76-97-90-73-58-98-65-64-96-55-79-88-66-57-60-80-81-94-75-51-77-95-72-68-63-53-52-69-93-87-78-83-71-59-61-92-62-89-74-91-85-54-70,86136205,22153,25601,47754
ls-nn,0-5-9-37-35-20-31-44-22-34-26-11-19-46-15-21-17-23-16-14-10-48-18-3-25-30-41-7-27-39-1-43-49-4-36-32-12-38-29-28-42-40-47-13-2-45-33-6-8-24,99-84-67-82-56-86-50-76-97-90-73-58-98-65-64-96-55-79-88-66-57-60-80-81-94-75-51-77-95-72-68-63-53-52-69-93-87-78-83-71-59-61-92-62-89-74-91-85-54-70,88511041,22153,25601,47754
ls-nn,0-5-9-37-35-20-31-44-22-34-26-11-19-46-15-21-17-23-16-14-10-48-18-3-25-30-41-7-27-39-1-43-49-4-36-32-12-38-29-28-42-40-47-13-2-45-33-6-8-24,99-84-67-82-56-86-50-76-97-90-73-58-98-65-64-96-55-79-88-66-57-60-80-81-94-75-51-77-95-72-68-63-53-52-69-93-87-78-83-71-59-61-92-62-89-74-91-85-54-70,92725851,22153,25601,47754
ls-nn,0-5-9-37-35-20-31-44-22-34-26-11-19-46-15-21-17-23-16-14-10-48-18-3-25-30-41-7-27-39-1-43-49-4-36-32-12-38-29-28-42-40-47-13-2-45-33-6-8-24,99-84-67-82-56-86-50-76-97-90-73-58-98-65-64-96-55-79-88-66-57-60-80-81-94-75-51-77-95-72-68-63-53-52-69-93-87-78-83-71-59-61-92-62-89-74-91-85-54-70,86655204,22153,25601,47754
ls-nn,0-5-9-37-35-20-31-44-22-34-26-11-19-46-15-21-17-23-16-14-10-48-18-3-25-30-41-7-27-39-1-43-49-4-36-32-12-38-29-28-42-40-47-13-2-45-33-6-8-24,99-84-67-82-56-86-50-76-97-90-73-58-98-65-64-96-55-79-88-66-57-60-80-81-94-75-51-77-95-72-68-63-53-52-69-93-87-78-83-71-59-61-92-62-89-74-91-85-54-70,93829197,22153,25601,47754
ls-nn,0-5-9-37-35-20-31-44-22-34-26-11-19-46-15-21-17-23-16-14-10-48-18-3-25-30-41-7-27-39-1-43-49-4-36-32-12-38-29-28-42-40-47-13-2-45-33-6-8-24,99-84-67-82-56-86-50-76-97-90-73-58-98-65-64-96-55-79-88-66-57-60-80-81-94-75-51-77-95-72-68-63-53-52-69-93-87-78-83-71-59-61-92-62-89-74-91-85-54-70,135229148,22153,25601,47754
ls-nn,0-5-9-37-35-20-31-44-22-34-26-11-19-46-15-21-17-23-16-14-10-48-18-3-25-30-41-7-27-39-1-43-49-4-36-32-12-38-29-28-42-40-47-13-2-45-33-6-8-24,99-84-67-82-56-86-50-76-97-90-73-58-98-65-64-96-55-79-88-66-57-60-80-81-94-75-51-77-95-72-68-63-53-52-69-93-87-78-83-71-59-61-92-62-89-74-91-85-54-70,153883752,22153,25601,47754
ls-nn,0-5-9-37-35-20-31-44-22-34-26-11-19-46-15-21-17-23-16-14-10-48-18-3-25-30-41-7-27-39-1-43-49-4-36-32-12-38-29-28-42-40-47-13-2-45-33-6-8-24,99-84-67-82-56-86-50-76-97-90-73-58-98-65-64-96-55-79-88-66-57-60-80-81-94-75-51-77-95-72-68-63-53-52-69-93-87-78-83-71-59-61-92-62-89-74-91-85-54-70,90506914,22153,25601,47754
ls-nn,0-5-9-37-35-20-31-44-22-34-26-11-19-46-15-21-17-23-16-14-10-48-18-3-25-30-41-7-27-39-1-43-49-4-36-32-12-38-29-28-42-40-47-13-2-45-33-6-8-24,99-84-67-82-56-86-50-76-97-90-73-58-98-65-64-96-55-79-88-66-57-60-80-81-94-75-51-77-95-72-68-63-53-52-69-93-87-78-83-71-59-61-92-62-89-74-91-85-54-70,88338679,22153,25601,47754
ls-nn,0-5-9-37-35-20-31-44-22-34-26-11-19-46-15-21-17-23-16-14-10-48-18-3-25-30-41-7-27-39-1-43-49-4-36-32-12-38-29-28-42-40-47-13-2-45-33-6-8-24,99-84-67-82-56-86-50-76-97-90-73-58-98-65-64-96-55-79-88-66-57-60-80-81-94-75-51-77-95-72-68-63-53-52-69-93-87-78-83-71-59-61-92-62-89-74-91-85-54-70,91988398,22153,25601,47754
ls-nn,0-5-9-37-35-20-31-44-22-34-26-11-19-46-15-21-17-23-16-14-10-48-18-3-25-30-41-7-27-39-1-43-49-4-36-32-12-38-29-28-42-40-47-13-2-45-33-6-8-24,99-84-67-82-56-86-50-76-97-90-73-58-98-65-64-96-55-79-88-66-57-60-80-81-94-75-51-77-95-72-68-63-53-52-69-93-87-78-83-71-59-61-92-62-89-74-91-85-54-70,86563646,22153,25601,47754
ls-nn,0-5-9-37-35-20-31-44-22-34-26-11-19-46-15-21-17-23-16-14-10-48-18-3-25-30-41-7-27-39-1-43-49-4-36-32-12-38-29-28-42-40-47-13-2-45-33-6-8-24,99-84-67-82-56-86-50-76-97-90-73-58-98-65-64-96-55-79-88-66-57-60-80-81-94-75-51-77-95-72-68-63-53-52-69-93-87-78-83-71-59-61-92-62-89-74-91-85-54-70,85881479,22153,25601,47754
ls-nn,0-5-9-37-35-20-31-44-22-34-26-11-19-46-15-21-17-23-16-14-10-48-18-3-25-30-41-7-27-39-1-43-49-4-36-32-12-38-29-28-42-40-47-13-2-45-33-6-8-24,99-84-67-82-56-86-50-76-97-90-73-58-98-65-64-96-55-79-88-66-57-60-80-81-94-75-51-77-95-72-68-63-53-52-69-93-87-78-83-71-59-61-92-62-89-74-91-85-54-70,93093884,22153,25601,47754
ls-nn,0-5-9-37-35-20-31-44-22-34-26-11-19-46-15-21-17-23-16-14-10-48-18-3-25-30-41-7-27-39-1-43-49-4-36-32-12-38-29-28-42-40-47-13-2-45-33-6-8-24,99-84-67-82-56-86-50-76-97-90-73-58-98-65-64-96-55-79-88-66-57-60-80-81-94-75-51-77-95-72-68-63-53-52-69-93-87-78-83-71-59-61-92-62-89-74-91-85-54-70,86613701,22153,25601,47754
ls-nn,0-5-9-37-35-20-31-44-22-34-26-11-19-46-15-21-17-23-16-14-10-48-18-3-25-30-41-7-27-39-1-43-49-4-36-32-12-38-29-28-42-40-47-13-2-45-33-6-8-24,99-84-67-82-56-86-50-76-97-90-73-58-98-65-64-96-55-79-88-66-57-60-80-81-94-75-51-77-95-72-68-63-53-52-69-93-87-78-83-71-59-61-92-62-89-74-91-85-54-70,90659809,22153,25601,47754
ls-nn,0-5-9-37-35-20-31-44-22-34-26-11-19-46-15-21-17-23-16-14-10-48-18-3-25-30-41-7-27-39-1-43-49-4-36-32-12-38-29-28-42-40-47-13-2-45-33-6-8-24,99-84-67-82-56-86-50-76-97-90-73-58-98-65-64-96-55-79-88-66-57-60-80-81-94-75-51-77-95-72-68-63-53-52-69-93-87-78-83-71-59-61-92-62-89-74-91-85-54-70,93024020,22153,25601,47754
ils,0-5-9-37-35-20-31-44-22-34-26-11-19-46-15-21-17-23-16-14-10-48-18-3-25-30-41-7-27-39-1-43-49-4-36-32-12-38-29-28-42-40-47-13-2-45-33-6-8-24,99-84-67-82-56-86-50-76-97-90-73-58-98-65-64-96-55-79-88-66-57-60-80-81-94-75-51-77-95-72-68-63-53-52-69-93-87-78-83-71-59-61-92-62-89-74-91-85-54-70,9067609331,22153,25601,47754
ils,99-84-67-82-56-86-50-76-97-90-73-58-98-65-64-96-55-79-88-66-57-60-80-81-94-75-51-77-95-72-68-63-53-52-69-93-87-78-83-71-59-61-92-62-89-74-91-85-54-70,0-5-9-37-35-20-31-44-22-34-26-11-19-46-15-21-17-23-16-14-10-48-18-3-25-30-41-7-27-39-1-43-49-4-36-32-12-38-29-28-42-40-47-13-2-45-33-6-8-24,7729113472,25601,22153,47754
ils,99-84-67-82-56-86-50-76-97-90-73-58-98-65-64-96-55-79-88-66-57-60-80-81-94-75-51-77-95-72-68-63-53-52-69-93-87-78-83-71-59-61-92-62-89-74-91-85-54-70,0-5-9-37-35-20-31-44-22-34-26-11-19-46-15-21-17-23-16-14-10-48-18-3-25-30-41-7-27-39-1-43-49-4-36-32-12-38-29-28-42-40-47-13-2-45-33-6-8-24,9695708800,25601,22153,47754
ils,19-56-51-4-36-32-75-12-94-38-29-28-82-8-84-43-39-60-50-24-80-88-30-41-91-74-64-65-69-21-52-17-23-37-35-20-58-16-14-44-90-97-61-26-11-42-40-70-13-45,98-71-73-10-68-72-49-81-1-25-3-18-96-55-79-7-5-62-59-34-85-54-33-2-99-47-6-76-22-31-46-0-66-53-63-27-92-57-67-95-77-86-87-15-93-78-89-48-9-83,8503462080,18563,27718,46281
ils,99-84-67-82-56-86-50-76-97-90-73-58-98-65-64-96-55-79-88-66-57-60-80-81-94-75-51-77-95-72-68-63-53-52-69-93-87-78-83-71-59-61-92-62-89-74-91-85-54-70,0-5-9-37-35-20-31-44-22-34-26-11-19-46-15-21-17-23-16-14-10-48-18-3-25-30-41-7-27-39-1-43-49-4-36-32-12-38-29-28-42-40-47-13-2-45-33-6-8-24,8810683575,25601,22153,47754
ils,99-84-67-82-56-86-50-76-97-90-73-58-98-65-64-96-55-79-88-66-57-60-80-81-94-75-51-77-95-72-68-63-53-52-69-93-87-78-83-71-59-61-92-62-89-74-91-85-54-70,0-5-9-37-35-20-31-44-22-34-26-11-19-46-15-21-17-23-16-14-10-48-18-3-25-30-41-7-27-39-1-43-49-4-36-32-12-38-29-28-42-40-47-13-2-45-33-6-8-24,7910829631,25601,22153,47754
ils,0-5-9-37-35-20-31-44-22-34-26-11-19-46-15-21-17-23-16-14-10-48-18-3-25-30-41-7-27-39-1-43-49-4-36-32-12-38-29-28-42-40-47-13-2-45-33-6-8-24,99-84-67-82-56-86-50-76-97-90-73-58-98-65-64-96-55-79-88-66-57-60-80-81-94-75-51-77-95-72-68-63-53-52-69-93-87-78-83-71-59-61-92-62-89-74-91-85-54-70,8335668963,22153,25601,47754
ils,0-5-9-37-35-20-31-44-22-34-26-11-19-46-15-21-17-23-16-14-10-48-18-3-25-30-41-7-27-39-1-43-49-4-36-32-12-38-29-28-42-40-47-13-2-45-33-6-8-24,99-84-67-82-56-86-50-76-97-90-73-58-98-65-64-96-55-79-88-66-57-60-80-81-94-75-51-77-95-72-68-63-53-52-69-93-87-78-83-71-59-61-92-62-89-74-91-85-54-70,8227525004,22153,25601,47754
ils,99-84-67-82-56-86-50-76-97-90-73-58-98-65-64-96-55-79-88-66-57-60-80-81-94-75-51-77-95-72-68-63-53-52-69-93-87-78-83-71-59-61-92-62-89-74-91-85-54-70,0-5-9-37-35-20-31-44-22-34-26-11-19-46-15-21-17-23-16-14-10-48-18-3-25-30-41-7-27-39-1-43-49-4-36-32-12-38-29-28-42-40-47-13-2-45-33-6-8-24,8278358046,25601,22153,47754
ils,99-84-67-82-56-86-50-76-97-90-73-58-98-65-64-96-55-79-88-66-57-60-80-81-94-75-51-77-95-72-68-63-53-52-69-93-87-78-83-71-59-61-92-62-89-74-91-85-54-70,0-5-9-37-35-20-31-44-22-34-26-11-19-46-15-21-17-23-16-14-10-48-18-3-25-30-41-7-27-39-1-43-49-4-36-32-12-38-29-28-42-40-47-13-2-45-33-6-8-24,8422526252,25601,22153,47754
ils,99-84-67-82-56-86-50-76-97-90-73-58-98-65-64-96-55-79-88-66-57-60-80-81-94-75-51-77-95-72-68-63-53-52-69-93-87-78-83-71-59-61-92-62-89-74-91-85-54-70,0-5-9-37-35-20-31-44-22-34-26-11-19-46-15-21-17-23-16-14-10-48-18-3-25-30-41-7-27-39-1-43-49-4-36-32-12-38-29-28-42-40-47-13-2-45-33-6-8-24,8175184949,25601,22153,47754
ils,0-5-9-37-35-20-31-44-22-34-26-11-19-46-15-21-17-23-16-14-10-48-18-3-25-30-41-7-27-39-1-43-49-4-36-32-12-38-29-28-42-40-47-13-2-45-33-6-8-24,99-84-67-82-56-86-50-76-97-90-73-58-98-65-64-96-55-79-88-66-57-60-80-81-94-75-51-77-95-72-68-63-53-52-69-93-87-78-83-71-59-61-92-62-89-74-91-85-54-70,8476616573,22153,25601,47754
ils,0-5-9-37-35-20-31-44-22-34-26-11-19-46-15-21-17-23-16-14-10-48-18-3-25-30-41-7-27-39-1-43-49-4-36-32-12-38-29-28-42-40-47-13-2-45-33-6-8-24,99-84-67-82-56-86-50-76-97-90-73-58-98-65-64-96-55-79-88-66-57-60-80-81-94-75-51-77-95-72-68-63-53-52-69-93-87-78-83-71-59-61-92-62-89-74-91-85-54-70,7887111746,22153,25601,47754
ils,99-84-67-82-56-86-50-76-97-90-73-58-98-65-64-96-55-79-88-66-57-60-80-81-94-75-51-77-95-72-68-63-53-52-69-93-87-78-83-71-59-61-92-62-89-74-91-85-54-70,0-5-9-37-35-20-31-44-22-34-26-11-19-46-15-21-17-23-16-14-10-48-18-3-25-30-41-7-27-39-1-43-49-4-36-32-12-38-29-28-42-40-47-13-2-45-33-6-8-24,7939315446,25601,22153,47754
ils,27-92-62-46-50-60-72-49-86-56-76-44-16-10-31-33-2-40-70-99-47-38-43-63-41-55-18-89-5-19-54-34-61-59-71-9-83-17-52-87-69-65-64-79-68-84-95-51-12-1,20-35-98-37-23-78-93-21-15-25-3-96-74-97-57-24-80-88-30-7-91-48-0-66-53-39-67-81-94-75-32-36-4-77-29-13-42-26-85-11-82-45-28-8-6-22-90-14-58-73,8054172661,27118,19878,46996
ils,99-84-67-82-56-86-50-76-97-90-73-58-98-65-64-96-55-79-88-66-57-60-80-81-94-75-51-77-95-72-68-63-53-52-69-93-87-78-83-71-59-61-92-62-89-74-91-85-54-70,0-5-9-37-35-20-31-44-22-34-26-11-19-46-15-21-17-23-16-14-10-48-18-3-25-30-41-7-27-39-1-43-49-4-36-32-12-38-29-28-42-40-47-13-2-45-33-6-8-24,7841070835,25601,22153,47754
ils,90-34-85-26-2-13-28-33-82-54-8-86-60-63-1-32-36-4-49-50-76-44-16-20-73-58-98-23-83-9-62-92-57-29-51-47-99-70-6-56-27-41-96-3-65-69-15-52-78-71,91-7-39-43-81-94-75-12-77-40-42-45-11-24-80-68-72-67-84-38-95-53-88-30-79-25-64-93-17-37-35-89-74-55-18-21-87-48-5-0-66-19-61-59-22-97-31-14-10-46,7644457219,22689,22723,45412
ils,99-84-67-82-56-86-50-76-97-90-73-58-98-65-64-96-55-79-88-66-57-60-80-81-94-75-51-77-95-72-68-63-53-52-69-93-87-78-83-71-59-61-92-62-89-74-91-85-54-70,0-5-9-37-35-20-31-44-22-34-26-11-19-46-15-21-17-23-16-14-10-48-18-3-25-30-41-7-27-39-1-43-49-4-36-32-12-38-29-28-42-40-47-13-2-45-33-6-8-24,7941696588,25601,22153,47754
ils,99-84-67-82-56-86-50-76-97-90-73-58-98-65-64-96-55-79-88-66-57-60-80-81-94-75-51-77-95-72-68-63-53-52-69-93-87-78-83-71-59-61-92-62-89-74-91-85-54-70,0-5-9-37-35-20-31-44-22-34-26-11-19-46-15-21-17-23-16-14-10-48-18-3-25-30-41-7-27-39-1-43-49-4-36-32-12-38-29-28-42-40-47-13-2-45-33-6-8-24,7844550414,25601,22153,47754
ils,99-84-67-82-56-86-50-76-97-90-73-58-98-65-64-96-55-79-88-66-57-60-80-81-94-75-51-77-95-72-68-63-53-52-69-93-87-78-83-71-59-61-92-62-89-74-91-85-54-70,0-5-9-37-35-20-31-44-22-34-26-11-19-46-15-21-17-23-16-14-10-48-18-3-25-30-41-7-27-39-1-43-49-4-36-32-12-38-29-28-42-40-47-13-2-45-33-6-8-24,7424484002,25601,22153,47754
ils,99-84-67-82-56-86-50-76-97-90-73-58-98-65-64-96-55-79-88-66-57-60-80-81-94-75-51-77-95-72-68-63-53-52-69-93-87-78-83-71-59-61-92-62-89-74-91-85-54-70,0-5-9-37-35-20-31-44-22-34-26-11-19-46-15-21-17-23-16-14-10-48-18-3-25-30-41-7-27-39-1-43-49-4-36-32-12-38-29-28-42-40-47-13-2-45-33-6-8-24,7468632488,25601,22153,47754
ils,0-5-9-37-35-20-31-44-22-34-26-11-19-46-15-21-17-23-16-14-10-48-18-3-25-30-41-7-27-39-1-43-49-4-36-32-12-38-29-28-42-40-47-13-2-45-33-6-8-24,99-84-67-82-56-86-50-76-97-90-73-58-98-65-64-96-55-79-88-66-57-60-80-81-94-75-51-77-95-72-68-63-53-52-69-93-87-78-83-71-59-61-92-62-89-74-91-85-54-70,7399426012,22153,25601,47754
ils,99-84-67-82-56-86-50-76-97-90-73-58-98-65-64-96-55-79-88-66-57-60-80-81-94-75-51-77-95-72-68-63-53-52-69-93-87-78-83-71-59-61-92-62-89-74-91-85-54-70,0-5-9-37-35-20-31-44-22-34-26-11-19-46-15-21-17-23-16-14-10-48-18-3-25-30-41-7-27-39-1-43-49-4-36-32-12-38-29-28-42-40-47-13-2-45-33-6-8-24,7386168871,25601,22153,47754
ils,99-84-67-82-56-86-50-76-97-90-73-58-98-65-64-96-55-79-88-66-57-60-80-81-94-75-51-77-95-72-68-63-53-52-69-93-87-78-83-71-59-61-92-62-89-74-91-85-54-70,0-5-9-37-35-20-31-44-22-34-26-11-19-46-15-21-17-23-16-14-10-48-18-3-25-30-41-7-27-39-1-43-49-4-36-32-12-38-29-28-42-40-47-13-2-45-33-6-8-24,7361433710,25601,22153,47754
ils,99-84-67-82-56-86-50-76-97-90-73-58-98-65-64-96-55-79-88-66-57-60-80-81-94-75-51-77-95-72-68-63-53-52-69-93-87-78-83-71-59-61-92-62-89-74-91-85-54-70,0-5-9-37-35-20-31-44-22-34-26-11-19-46-15-21-17-23-16-14-10-48-18-3-25-30-41-7-27-39-1-43-49-4-36-32-12-38-29-28-42-40-47-13-2-45-33-6-8-24,7526519458,25601,22153,47754
ils,99-84-67-82-56-86-50-76-97-90-73-58-98-65-64-96-55-79-88-66-57-60-80-81-94-75-51-77-95-72-68-63-53-52-69-93-87-78-83-71-59-61-92-62-89-74-91-85-54-70,0-5-9-37-35-20-31-44-22-34-26-11-19-46-15-21-17-23-16-14-10-48-18-3-25-30-41-7-27-39-1-43-49-4-36-32-12-38-29-28-42-40-47-13-2-45-33-6-8-24,7422620897,25601,22153,47754
ils,99-84-67-82-56-86-50-76-97-90-73-58-98-65-64-96-55-79-88-66-57-60-80-81-94-75-51-77-95-72-68-63-53-52-69-93-87-78-83-71-59-61-92-62-89-74-91-85-54-70,0-5-9-37-35-20-31-44-22-34-26-11-19-46-15-21-17-23-16-14-10-48-18-3-25-30-41-7-27-39-1-43-49-4-36-32-12-38-29-28-42-40-47-13-2-45-33-6-8-24,7636104437,25601,22153,47754
ils,0-5-9-37-35-20-31-44-22-34-26-11-19-46-15-21-17-23-16-14-10-48-18-3-25-30-41-7-27-39-1-43-49-4-36-32-12-38-29-28-42-40-47-13-2-45-33-6-8-24,99-84-67-82-56-86-50-76-97-90-73-58-98-65-64-96-55-79-88-66-57-60-80-81-94-75-51-77-95-72-68-63-53-52-69-93-87-78-83-71-59-61-92-62-89-74-91-85-54-70,7248053557,22153,25601,47754
ils,0-5-9-37-35-20-31-44-22-34-26-11-19-46-15-21-17-23-16-14-10-48-18-3-25-30-41-7-27-39-1-43-49-4-36-32-12-38-29-28-42-40-47-13-2-45-33-6-8-24,99-84-67-82-56-86-50-76-97-90-73-58-98-65-64-96-55-79-88-66-57-60-80-81-94-75-51-77-95-72-68-63-53-52-69-93-87-78-83-71-59-61-92-62-89-74-91-85-54-70,7602216423,22153,25601,47754
ils,99-84-67-82-56-86-50-76-97-90-73-58-98-65-64-96-55-79-88-66-57-60-80-81-94-75-51-77-95-72-68-63-53-52-69-93-87-78-83-71-59-61-92-62-89-74-91-85-54-70,0-5-9-37-35-20-31-44-22-34-26-11-19-46-15-21-17-23-16-14-10-48-18-3-25-30-41-7-27-39-1-43-49-4-36-32-12-38-29-28-42-40-47-13-2-45-33-6-8-24,7391133504,25601,22153,47754
ils,99-84-67-82-56-86-50-76-97-90-73-58-98-65-64-96-55-79-88-66-57-60-80-81-94-75-51-77-95-72-68-63-53-52-69-93-87-78-83-71-59-61-92-62-89-74-91-85-54-70,0-5-9-37-35-20-31-44-22-34-26-11-19-46-15-21-17-23-16-14-10-48-18-3-25-30-41-7-27-39-1-43-49-4-36-32-12-38-29-28-42-40-47-13-2-45-33-6-8-24,9396051510,25601,22153,47754
ils,99-84-67-82-56-86-50-76-97-90-73-58-98-65-64-96-55-79-88-66-57-60-80-81-94-75-51-77-95-72-68-63-53-52-69-93-87-78-83-71-59-61-92-62-89-74-91-85-54-70,0-5-9-37-35-20-31-44-22-34-26-11-19-46-15-21-17-23-16-14-10-48-18-3-25-30-41-7-27-39-1-43-49-4-36-32-12-38-29-28-42-40-47-13-2-45-33-6-8-24,7974016826,25601,22153,47754
ils,99-84-67-82-56-86-50-76-97-90-73-58-98-65-64-96-55-79-88-66-57-60-80-81-94-75-51-77-95-72-68-63-53-52-69-93-87-78-83-71-59-61-92-62-89-74-91-85-54-70,0-5-9-37-35-20-31-44-22-34-26-11-19-46-15-21-17-23-16-14-10-48-18-3-25-30-41-7-27-39-1-43-49-4-36-32-12-38-29-28-42-40-47-13-2-45-33-6-8-24,7331943364,25601,22153,47754
ils,99-84-67-82-56-86-50-76-97-90-73-58-98-65-64-96-55-79-88-66-57-60-80-81-94-75-51-77-95-72-68-63-53-52-69-93-87-78-83-71-59-61-92-62-89-74-91-85-54-70,0-5-9-37-35-20-31-44-22-34-26-11-19-46-15-21-17-23-16-14-10-48-18-3-25-30-41-7-27-39-1-43-49-4-36-32-12-38-29-28-42-40-47-13-2-45-33-6-8-24,7661536746,25601,22153,47754
ils,99-84-67-82-56-86-50-76-97-90-73-58-98-65-64-96-55-79-88-66-57-60-80-81-94-75-51-77-95-72-68-63-53-52-69-93-87-78-83-71-59-61-92-62-89-74-91-85-54-70,0-5-9-37-35-20-31-44-22-34-26-11-19-46-15-21-17-23-16-14-10-48-18-3-25-30-41-7-27-39-1-43-49-4-36-32-12-38-29-28-42-40-47-13-2-45-33-6-8-24,7658979203,25601,22153,47754
ils,99-84-67-82-56-86-50-76-97-90-73-58-98-65-64-96-55-79-88-66-57-60-80-81-94-75-51-77-95-72-68-63-53-52-69-93-87-78-83-71-59-61-92-62-89-74-91-85-54-70,0-5-9-37-35-20-31-44-22-34-26-11-19-46-15-21-17-23-16-14-10-48-18-3-25-30-41-7-27-39-1-43-49-4-36-32-12-38-29-28-42-40-47-13-2-45-33-6-8-24,7408866071,25601,22153,47754
ils,56-85-11-54-82-84-80-24-27-0-89-87-21-93-37-35-58-16-10-90-46-62-5-48-74-25-52-78-83-44-59-76-63-53-1-36-51-29-99-70-40-42-28-66-30-79-41-7-57-86,13-2-45-26-19-6-67-81-94-12-75-32-4-77-95-38-49-43-96-18-15-69-65-64-3-9-71-31-97-22-61-34-14-73-20-98-23-17-92-68-72-39-88-55-91-60-50-8-33-47,8108635588,22736,24134,46870
ils,99-84-67-82-56-86-50-76-97-90-73-58-98-65-64-96-55-79-88-66-57-60-80-81-94-75-51-77-95-72-68-63-53-52-69-93-87-78-83-71-59-61-92-62-89-74-91-85-54-70,0-5-9-37-35-20-31-44-22-34-26-11-19-46-15-21-17-23-16-14-10-48-18-3-25-30-41-7-27-39-1-43-49-4-36-32-12-38-29-28-42-40-47-13-2-45-33-6-8-24,7394019113,25601,22153,47754
ils,10-89-83-98-37-78-87-65-25-64-3-30-7-66-50-82-33-28-29-51-77-68-48-5-62-92-27-57-86-8-11-97-59-61-34-2-13-47-36-94-1-63-49-67-38-99-70-42-44-14,22-76-56-6-19-85-26-54-45-40-95-4-43-53-39-80-24-90-31-16-58-35-93-15-21-69-18-74-72-81-75-32-12-84-60-46-71-9-23-17-52-41-88-79-55-96-91-0-20-73,7382641303,25128,23540,48668
ils,99-84-67-82-56-86-50-76-97-90-73-58-98-65-64-96-55-79-88-66-57-60-80-81-94-75-51-77-95-72-68-63-53-52-69-93-87-78-83-71-59-61-92-62-89-74-91-85-54-70,0-5-9-37-35-20-31-44-22-34-26-11-19-46-15-21-17-23-16-14-10-48-18-3-25-30-41-7-27-39-1-43-49-4-36-32-12-38-29-28-42-40-47-13-2-45-33-6-8-24,7910531435,25601,22153,47754
ils,99-84-67-82-56-86-50-76-97-90-73-58-98-65-64-96-55-79-88-66-57-60-80-81-94-75-51-77-95-72-68-63-53-52-69-93-87-78-83-71-59-61-92-62-89-74-91-85-54-70,0-5-9-37-35-20-31-44-22-34-26-11-19-46-15-21-17-23-16-14-10-48-18-3-25-30-41-7-27-39-1-43-49-4-36-32-12-38-29-28-42-40-47-13-2-45-33-6-8-24,9237265446,25601,22153,47754
ils,99-84-67-82-56-86-50-76-97-90-73-58-98-65-64-96-55-79-88-66-57-60-80-81-94-75-51-77-95-72-68-63-53-52-69-93-87-78-83-71-59-61-92-62-89-74-91-85-54-70,0-5-9-37-35-20-31-44-22-34-26-11-19-46-15-21-17-23-16-14-10-48-18-3-25-30-41-7-27-39-1-43-49-4-36-32-12-38-29-28-42-40-47-13-2-45-33-6-8-24,7961723532,25601,22153,47754
ils,99-84-67-82-56-86-50-76-97-90-73-58-98-65-64-96-55-79-88-66-57-60-80-81-94-75-51-77-95-72-68-63-53-52-69-93-87-78-83-71-59-61-92-62-89-74-91-85-54-70,0-5-9-37-35-20-31-44-22-34-26-11-19-46-15-21-17-23-16-14-10-48-18-3-25-30-41-7-27-39-1-43-49-4-36-32-12-38-29-28-42-40-47-13-2-45-33-6-8-24,7664373009,25601,22153,47754
ils,99-84-67-82-56-86-50-76-97-90-73-58-98-65-64-96-55-79-88-66-57-60-80-81-94-75-51-77-95-72-68-63-53-52-69-93-87-78-83-71-59-61-92-62-89-74-91-85-54-70,0-5-9-37-35-20-31-44-22-34-26-11-19-46-15-21-17-23-16-14-10-48-18-3-25-30-41-7-27-39-1-43-49-4-36-32-12-38-29-28-42-40-47-13-2-45-33-6-8-24,7380076003,25601,22153,47754
ils,99-84-67-82-56-86-50-76-97-90-73-58-98-65-64-96-55-79-88-66-57-60-80-81-94-75-51-77-95-72-68-63-53-52-69-93-87-78-83-71-59-61-92-62-89-74-91-85-54-70,0-5-9-37-35-20-31-44-22-34-26-11-19-46-15-21-17-23-16-14-10-48-18-3-25-30-41-7-27-39-1-43-49-4-36-32-12-38-29-28-42-40-47-13-2-45-33-6-8-24,7233045487,25601,22153,47754
ils,0-5-9-37-35-20-31-44-22-34-26-11-19-46-15-21-17-23-16-14-10-48-18-3-25-30-41-7-27-39-1-43-49-4-36-32-12-38-29-28-42-40-47-13-2-45-33-6-8-24,99-84-67-82-56-86-50-76-97-90-73-58-98-65-64-96-55-79-88-66-57-60-80-81-94-75-51-77-95-72-68-63-53-52-69-93-87-78-83-71-59-61-92-62-89-74-91-85-54-70,7347471397,22153,25601,47754
ils,0-5-9-37-35-20-31-44-22-34-26-11-19-46-15-21-17-23-16-14-10-48-18-3-25-30-41-7-27-39-1-43-49-4-36-32-12-38-29-28-42-40-47-13-2-45-33-6-8-24,99-84-67-82-56-86-50-76-97-90-73-58-98-65-64-96-55-79-88-66-57-60-80-81-94-75-51-77-95-72-68-63-53-52-69-93-87-78-83-71-59-61-92-62-89-74-91-85-54-70,7904967996,22153,25601,47754
ils,0-5-9-37-35-20-31-44-22-34-26-11-19-46-15-21-17-23-16-14-10-48-18-3-25-30-41-7-27-39-1-43-49-4-36-32-12-38-29-28-42-40-47-13-2-45-33-6-8-24,99-84-67-82-56-86-50-76-97-90-73-58-98-65-64-96-55-79-88-66-57-60-80-81-94-75-51-77-95-72-68-63-53-52-69-93-87-78-83-71-59-61-92-62-89-74-91-85-54-70,7989481721,22153,25601,47754
ils,36-32-81-80-24-7-89-87-21-69-65-25-64-3-41-72-49-43-1-53-63-68-62-71-20-31-22-76-34-26-54-2-13-47-70-40-42-11-61-59-14-10-73-35-37-23-83-50-29-4,99-45-28-84-38-95-12-75-94-39-5-48-17-78-18-96-55-79-30-88-66-60-86-8-56-57-27-92-0-91-74-52-15-93-98-9-58-16-85-82-33-6-19-97-44-90-46-67-77-51,8964411345,23998,23411,47409
ils,0-5-9-37-35-20-31-44-22-34-26-11-19-46-15-21-17-23-16-14-10-48-18-3-25-30-41-7-27-39-1-43-49-4-36-32-12-38-29-28-42-40-47-13-2-45-33-6-8-24,99-84-67-82-56-86-50-76-97-90-73-58-98-65-64-96-55-79-88-66-57-60-80-81-94-75-51-77-95-72-68-63-53-52-69-93-87-78-83-71-59-61-92-62-89-74-91-85-54-70,8797447598,22153,25601,47754
ils,0-5-9-37-35-20-31-44-22-34-26-11-19-46-15-21-17-23-16-14-10-48-18-3-25-30-41-7-27-39-1-43-49-4-36-32-12-38-29-28-42-40-47-13-2-45-33-6-8-24,99-84-67-82-56-86-50-76-97-90-73-58-98-65-64-96-55-79-88-66-57-60-80-81-94-75-51-77-95-72-68-63-53-52-69-93-87-78-83-71-59-61-92-62-89-74-91-85-54-70,7880735817,22153,25601,47754
ils,91-46-20-83-89-78-17-98-58-73-16-14-44-97-11-45-2-13-40-99-47-51-77-38-28-33-82-54-80-43-94-12-32-4-8-6-56-24-57-27-63-39-41-79-64-69-93-15-87-18,19-61-59-86-29-95-84-67-88-7-62-10-31-90-22-76-50-60-49-72-68-66-92-0-5-48-74-96-3-25-65-21-52-9-71-35-37-23-55-30-53-1-81-75-36-70-42-26-34-85,8354056245,21182,23334,44516
ils,99-84-67-82-56-86-50-76-97-90-73-58-98-65-64-96-55-79-88-66-57-60-80-81-94-75-51-77-95-72-68-63-53-52-69-93-87-78-83-71-59-61-92-62-89-74-91-85-54-70,0-5-9-37-35-20-31-44-22-34-26-11-19-46-15-21-17-23-16-14-10-48-18-3-25-30-41-7-27-39-1-43-49-4-36-32-12-38-29-28-42-40-47-13-2-45-33-6-8-24,11959991058,25601,22153,47754
ils,99-84-67-82-56-86-50-76-97-90-73-58-98-65-64-96-55-79-88-66-57-60-80-81-94-75-51-77-95-72-68-63-53-52-69-93-87-78-83-71-59-61-92-62-89-74-91-85-54-70,0-5-9-37-35-20-31-44-22-34-26-11-19-46-15-21-17-23-16-14-10-48-18-3-25-30-41-7-27-39-1-43-49-4-36-32-12-38-29-28-42-40-47-13-2-45-33-6-8-24,10323384379,25601,22153,47754
ils,0-5-9-37-35-20-31-44-22-34-26-11-19-46-15-21-17-23-16-14-10-48-18-3-25-30-41-7-27-39-1-43-49-4-36-32-12-38-29-28-42-40-47-13-2-45-33-6-8-24,99-84-67-82-56-86-50-76-97-90-73-58-98-65-64-96-55-79-88-66-57-60-80-81-94-75-51-77-95-72-68-63-53-52-69-93-87-78-83-71-59-61-92-62-89-74-91-85-54-70,8433010266,22153,25601,47754
ils,0-5-9-37-35-20-31-44-22-34-26-11-19-46-15-21-17-23-16-14-10-48-18-3-25-30-41-7-27-39-1-43-49-4-36-32-12-38-29-28-42-40-47-13-2-45-33-6-8-24,99-84-67-82-56-86-50-76-97-90-73-58-98-65-64-96-55-79-88-66-57-60-80-81-94-75-51-77-95-72-68-63-53-52-69-93-87-78-83-71-59-61-92-62-89-74-91-85-54-70,8595987649,22153,25601,47754
ils,66-50-57-91-5-96-25-69-21-15-87-17-23-37-35-58-34-26-42-2-95-77-32-94-68-14-16-20-9-78-52-48-22-19-54-82-6-56-8-28-99-47-29-67-49-43-63-88-30-79,86-24-80-4-36-75-12-81-1-74-18-93-98-85-11-33-45-13-70-40-51-38-84-72-39-53-27-92-90-97-59-61-76-0-7-41-55-3-64-65-83-71-73-10-31-44-46-89-62-60,7730749847,24494,24912,49406
ils,0-5-9-37-35-20-31-44-22-34-26-11-19-46-15-21-17-23-16-14-10-48-18-3-25-30-41-7-27-39-1-43-49-4-36-32-12-38-29-28-42-40-47-13-2-45-33-6-8-24,99-84-67-82-56-86-50-76-97-90-73-58-98-65-64-96-55-79-88-66-57-60-80-81-94-75-51-77-95-72-68-63-53-52-69-93-87-78-83-71-59-61-92-62-89-74-91-85-54-70,9043828914,22153,25601,47754
ils,0-5-9-37-35-20-31-44-22-34-26-11-19-46-15-21-17-23-16-14-10-48-18-3-25-30-41-7-27-39-1-43-49-4-36-32-12-38-29-28-42-40-47-13-2-45-33-6-8-24,99-84-67-82-56-86-50-76-97-90-73-58-98-65-64-96-55-79-88-66-57-60-80-81-94-75-51-77-95-72-68-63-53-52-69-93-87-78-83-71-59-61-92-62-89-74-91-85-54-70,7618822465,22153,25601,47754
ils,0-5-9-37-35-20-31-44-22-34-26-11-19-46-15-21-17-23-16-14-10-48-18-3-25-30-41-7-27-39-1-43-49-4-36-32-12-38-29-28-42-40-47-13-2-45-33-6-8-24,99-84-67-82-56-86-50-76-97-90-73-58-98-65-64-96-55-79-88-66-57-60-80-81-94-75-51-77-95-72-68-63-53-52-69-93-87-78-83-71-59-61-92-62-89-74-91-85-54-70,10574828374,22153,25601,47754
ils,0-5-9-37-35-20-31-44-22-34-26-11-19-46-15-21-17-23-16-14-10-48-18-3-25-30-41-7-27-39-1-43-49-4-36-32-12-38-29-28-42-40-47-13-2-45-33-6-8-24,99-84-67-82-56-86-50-76-97-90-73-58-98-65-64-96-55-79-88-66-57-60-80-81-94-75-51-77-95-72-68-63-53-52-69-93-87-78-83-71-59-61-92-62-89-74-91-85-54-70,13273879027,22153,25601,47754
ils,99-84-67-82-56-86-50-76-97-90-73-58-98-65-64-96-55-79-88-66-57-60-80-81-94-75-51-77-95-72-68-63-53-52-69-93-87-78-83-71-59-61-92-62-89-74-91-85-54-70,0-5-9-37-35-20-31-44-22-34-26-11-19-46-15-21-17-23-16-14-10-48-18-3-25-30-41-7-27-39-1-43-49-4-36-32-12-38-29-28-42-40-47-13-2-45-33-6-8-24,10400139324,25601,22153,47754
ils,99-84-67-82-56-86-50-76-97-90-73-58-98-65-64-96-55-79-88-66-57-60-80-81-94-75-51-77-95-72-68-63-53-52-69-93-87-78-83-71-59-61-92-62-89-74-91-85-54-70,0-5-9-37-35-20-31-44-22-34-26-11-19-46-15-21-17-23-16-14-10-48-18-3-25-30-41-7-27-39-1-43-49-4-36-32-12-38-29-28-42-40-47-13-2-45-33-6-8-24,9692473848,25601,22153,47754
ils,99-84-67-82-56-86-50-76-97-90-73-58-98-65-64-96-55-79-88-66-57-60-80-81-94-75-51-77-95-72-68-63-53-52-69-93-87-78-83-71-59-61-92-62-89-74-91-85-54-70,0-5-9-37-35-20-31-44-22-34-26-11-19-46-15-21-17-23-16-14-10-48-18-3-25-30-41-7-27-39-1-43-49-4-36-32-12-38-29-28-42-40-47-13-2-45-33-6-8-24,9748573541,25601,22153,47754
ils,99-84-67-82-56-86-50-76-97-90-73-58-98-65-64-96-55-79-88-66-57-60-80-81-94-75-51-77-95-72-68-63-53-52-69-93-87-78-83-71-59-61-92-62-89-74-91-85-54-70,0-5-9-37-35-20-31-44-22-34-26-11-19-46-15-21-17-23-16-14-10-48-18-3-25-30-41-7-27-39-1-43-49-4-36-32-12-38-29-28-42-40-47-13-2-45-33-6-8-24,7381981303,25601,22153,47754
ils,99-84-67-82-56-86-50-76-97-90-73-58-98-65-64-96-55-79-88-66-57-60-80-81-94-75-51-77-95-72-68-63-53-52-69-93-87-78-83-71-59-61-92-62-89-74-91-85-54-70,0-5-9-37-35-20-31-44-22-34-26-11-19-46-15-21-17-23-16-14-10-48-18-3-25-30-41-7-27-39-1-43-49-4-36-32-12-38-29-28-42-40-47-13-2-45-33-6-8-24,9260723397,25601,22153,47754
ils,0-5-9-37-35-20-31-44-22-34-26-11-19-46-15-21-17-23-16-14-10-48-18-3-25-30-41-7-27-39-1-43-49-4-36-32-12-38-29-28-42-40-47-13-2-45-33-6-8-24,99-84-67-82-56-86-50-76-97-90-73-58-98-65-64-96-55-79-88-66-57-60-80-81-94-75-51-77-95-72-68-63-53-52-69-93-87-78-83-71-59-61-92-62-89-74-91-85-54-70,8383635472,22153,25601,47754
ils,99-84-67-82-56-86-50-76-97-90-73-58-98-65-64-96-55-79-88-66-57-60-80-81-94-75-51-77-95-72-68-63-53-52-69-93-87-78-83-71-59-61-92-62-89-74-91-85-54-70,0-5-9-37-35-20-31-44-22-34-26-11-19-46-15-21-17-23-16-14-10-48-18-3-25-30-41-7-27-39-1-43-49-4-36-32-12-38-29-28-42-40-47-13-2-45-33-6-8-24,8122748092,25601,22153,47754
ils,0-5-9-37-35-20-31-44-22-34-26-11-19-46-15-21-17-23-16-14-10-48-18-3-25-30-41-7-27-39-1-43-49-4-36-32-12-38-29-28-42-40-47-13-2-45-33-6-8-24,99-84-67-82-56-86-50-76-97-90-73-58-98-65-64-96-55-79-88-66-57-60-80-81-94-75-51-77-95-72-68-63-53-52-69-93-87-78-83-71-59-61-92-62-89-74-91-85-54-70,8460920439,22153,25601,47754
ils,84-29-77-47-40-76-90-46-27-57-60-86-6-82-28-45-11-59-10-20-78-21-15-18-55-79-7-66-80-49-1-53-39-63-31-14-16-73-35-98-93-69-65-64-89-83-9-62-0-24,50-97-22-42-70-99-13-2-30-25-3-96-74-48-5-92-67-32-75-12-94-81-43-52-87-17-23-37-71-58-44-91-41-88-68-72-36-4-51-95-38-33-54-26-85-34-61-19-56-8,10695119188,24239,26229,50468
ils,24-84-67-63-53-49-81-32-4-29-54-8-19-76-31-10-14-58-20-35-9-89-3-55-79-30-41-62-46-92-27-57-60-95-77-47-99-70-28-86-15-21-87-17-23-52-18-74-7-66,88-25-69-93-83-72-43-1-39-96-64-65-78-48-5-91-0-80-50-26-85-61-44-71-37-98-73-16-90-97-22-59-34-42-2-45-33-82-11-56-6-94-75-12-36-38-51-40-13-68,8977640661,22742,27467,50209
ils,0-5-9-37-35-20-31-44-22-34-26-11-19-46-15-21-17-23-16-14-10-48-18-3-25-30-41-7-27-39-1-43-49-4-36-32-12-38-29-28-42-40-47-13-2-45-33-6-8-24,99-84-67-82-56-86-50-76-97-90-73-58-98-65-64-96-55-79-88-66-57-60-80-81-94-75-51-77-95-72-68-63-53-52-69-93-87-78-83-71-59-61-92-62-89-74-91-85-54-70,9346777163,22153,25601,47754
ils,0-5-9-37-35-20-31-44-22-34-26-11-19-46-15-21-17-23-16-14-10-48-18-3-25-30-41-7-27-39-1-43-49-4-36-32-12-38-29-28-42-40-47-13-2-45-33-6-8-24,99-84-67-82-56-86-50-76-97-90-73-58-98-65-64-96-55-79-88-66-57-60-80-81-94-75-51-77-95-72-68-63-53-52-69-93-87-78-83-71-59-61-92-62-89-74-91-85-54-70,7999411438,22153,25601,47754
ils,0-5-9-37-35-20-31-44-22-34-26-11-19-46-15-21-17-23-16-14-10-48-18-3-25-30-41-7-27-39-1-43-49-4-36-32-12-38-29-28-42-40-47-13-2-45-33-6-8-24,99-84-67-82-56-86-50-76-97-90-73-58-98-65-64-96-55-79-88-66-57-60-80-81-94-75-51-77-95-72-68-63-53-52-69-93-87-78-83-71-59-61-92-62-89-74-91-85-54-70,7472597167,22153,25601,47754
ils,0-5-9-37-35-20-31-44-22-34-26-11-19-46-15-21-17-23-16-14-10-48-18-3-25-30-41-7-27-39-1-43-49-4-36-32-12-38-29-28-42-40-47-13-2-45-33-6-8-24,99-84-67-82-56-86-50-76-97-90-73-58-98-65-64-96-55-79-88-66-57-60-80-81-94-75-51-77-95-72-68-63-53-52-69-93-87-78-83-71-59-61-92-62-89-74-91-85-54-70,8513641432,22153,25601,47754
ils,99-84-67-82-56-86-50-76-97-90-73-58-98-65-64-96-55-79-88-66-57-60-80-81-94-75-51-77-95-72-68-63-53-52-69-93-87-78-83-71-59-61-92-62-89-74-91-85-54-70,0-5-9-37-35-20-31-44-22-34-26-11-19-46-15-21-17-23-16-14-10-48-18-3-25-30-41-7-27-39-1-43-49-4-36-32-12-38-29-28-42-40-47-13-2-45-33-6-8-24,12085776598,25601,22153,47754
ils,99-84-67-82-56-86-50-76-97-90-73-58-98-65-64-96-55-79-88-66-57-60-80-81-94-75-51-77-95-72-68-63-53-52-69-93-87-78-83-71-59-61-92-62-89-74-91-85-54-70,0-5-9-37-35-20-31-44-22-34-26-11-19-46-15-21-17-23-16-14-10-48-18-3-25-30-41-7-27-39-1-43-49-4-36-32-12-38-29-28-42-40-47-13-2-45-33-6-8-24,11612005279,25601,22153,47754
ils,99-84-67-82-56-86-50-76-97-90-73-58-98-65-64-96-55-79-88-66-57-60-80-81-94-75-51-77-95-72-68-63-53-52-69-93-87-78-83-71-59-61-92-62-89-74-91-85-54-70,0-5-9-37-35-20-31-44-22-34-26-11-19-46-15-21-17-23-16-14-10-48-18-3-25-30-41-7-27-39-1-43-49-4-36-32-12-38-29-28-42-40-47-13-2-45-33-6-8-24,11022079205,25601,22153,47754
ils,99-84-67-82-56-86-50-76-97-90-73-58-98-65-64-96-55-79-88-66-57-60-80-81-94-75-51-77-95-72-68-63-53-52-69-93-87-78-83-71-59-61-92-62-89-74-91-85-54-70,0-5-9-37-35-20-31-44-22-34-26-11-19-46-15-21-17-23-16-14-10-48-18-3-25-30-41-7-27-39-1-43-49-4-36-32-12-38-29-28-42-40-47-13-2-45-33-6-8-24,9615991231,25601,22153,47754
ils,99-84-67-82-56-86-50-76-97-90-73-58-98-65-64-96-55-79-88-66-57-60-80-81-94-75-51-77-95-72-68-63-53-52-69-93-87-78-83-71-59-61-92-62-89-74-91-85-54-70,0-5-9-37-35-20-31-44-22-34-26-11-19-46-15-21-17-23-16-14-10-48-18-3-25-30-41-7-27-39-1-43-49-4-36-32-12-38-29-28-42-40-47-13-2-45-33-6-8-24,10695579375,25601,22153,47754
ils,0-5-9-37-35-20-31-44-22-34-26-11-19-46-15-21-17-23-16-14-10-48-18-3-25-30-41-7-27-39-1-43-49-4-36-32-12-38-29-28-42-40-47-13-2-45-33-6-8-24,99-84-67-82-56-86-50-76-97-90-73-58-98-65-64-96-55-79-88-66-57-60-80-81-94-75-51-77-95-72-68-63-53-52-69-93-87-78-83-71-59-61-92-62-89-74-91-85-54-70,9270894012,22153,25601,47754
ils,0-5-9-37-35-20-31-44-22-34-26-11-19-46-15-21-17-23-16-14-10-48-18-3-25-30-41-7-27-39-1-43-49-4-36-32-12-38-29-28-42-40-47-13-2-45-33-6-8-24,99-84-67-82-56-86-50-76-97-90-73-58-98-65-64-96-55-79-88-66-57-60-80-81-94-75-51-77-95-72-68-63-53-52-69-93-87-78-83-71-59-61-92-62-89-74-91-85-54-70,9970114205,22153,25601,47754
ils,0-5-9-37-35-20-31-44-22-34-26-11-19-46-15-21-17-23-16-14-10-48-18-3-25-30-41-7-27-39-1-43-49-4-36-32-12-38-29-28-42-40-47-13-2-45-33-6-8-24,99-84-67-82-56-86-50-76-97-90-73-58-98-65-64-96-55-79-88-66-57-60-80-81-94-75-51-77-95-72-68-63-53-52-69-93-87-78-83-71-59-61-92-62-89-74-91-85-54-70,10365577137,22153,25601,47754
ils,0-96-3-64-25-65-9-71-73-46-27-39-63-60-86-6-29-67-68-7-41-30-53-81-38-95-51-32-75-12-94-80-24-56-11-82-28-2-70-42-26-10-98-23-17-93-15-87-18-48,62-91-76-19-8-54-84-49-36-4-77-47-99-40-13-45-33-50-57-92-90-44-97-22-72-43-1-66-88-79-55-85-34-61-59-31-14-16-58-20-89-74-52-69-21-78-37-35-83-5,8908262569,24908,22627,47535
ils,99-84-67-82-56-86-50-76-97-90-73-58-98-65-64-96-55-79-88-66-57-60-80-81-94-75-51-77-95-72-68-63-53-52-69-93-87-78-83-71-59-61-92-62-89-74-91-85-54-70,0-5-9-37-35-20-31-44-22-34-26-11-19-46-15-21-17-23-16-14-10-48-18-3-25-30-41-7-27-39-1-43-49-4-36-32-12-38-29-28-42-40-47-13-2-45-33-6-8-24,10935418283,25601,22153,47754
ils,1-53-39-80-24-67-84-70-40-66-41-55-3-65-35-58-16-44-46-0-30-79-96-69-21-78-83-62-50-28-2-45-82-26-85-19-6-8-56-59-5-89-18-91-94-32-4-51-95-49,81-43-72-38-29-33-76-31-10-14-73-20-52-87-15-93-17-23-37-98-71-9-48-7-74-64-25-88-63-68-60-86-57-27-92-90-97-22-61-34-11-54-42-13-99-47-77-36-75-12,8832455793,26674,20277,46951
ils,80-32-75-94-81-43-72-9-23-37-35-19-11-29-77-4-38-50-56-6-33-13-47-99-70-40-26-76-89-87-21-55-79-88-39-7-96-25-69-78-83-71-73-58-14-10-31-44-97-57,84-67-49-68-66-27-92-74-18-90-22-59-61-34-85-45-42-2-28-24-60-3-64-65-52-15-93-17-98-20-16-46-0-62-5-48-91-41-30-53-63-1-12-36-51-95-82-54-8-86,9125595322,27329,22015,49344
ils,83-35-98-23-3-96-41-28-40-47-36-81-1-63-91-5-48-78-89-62-80-38-95-51-29-56-76-22-97-14-16-93-21-15-65-64-79-53-39-43-84-54-26-61-19-86-60-57-27-9,10-31-44-6-33-45-2-13-32-75-12-94-49-72-24-50-8-85-34-59-92-88-30-55-7-0-46-90-11-82-42-70-99-77-4-67-68-66-74-18-25-69-87-52-17-37-71-20-73-58,11242503154,27600,22095,49695
ils,99-84-67-82-56-86-50-76-97-90-73-58-98-65-64-96-55-79-88-66-57-60-80-81-94-75-51-77-95-72-68-63-53-52-69-93-87-78-83-71-59-61-92-62-89-74-91-85-54-70,0-5-9-37-35-20-31-44-22-34-26-11-19-46-15-21-17-23-16-14-10-48-18-3-25-30-41-7-27-39-1-43-49-4-36-32-12-38-29-28-42-40-47-13-2-45-33-6-8-24,7796819177,25601,22153,47754
ils,0-5-9-37-35-20-31-44-22-34-26-11-19-46-15-21-17-23-16-14-10-48-18-3-25-30-41-7-27-39-1-43-49-4-36-32-12-38-29-28-42-40-47-13-2-45-33-6-8-24,99-84-67-82-56-86-50-76-97-90-73-58-98-65-64-96-55-79-88-66-57-60-80-81-94-75-51-77-95-72-68-63-53-52-69-93-87-78-83-71-59-61-92-62-89-74-91-85-54-70,10383912293,22153,25601,47754
ils,7-53-39-63-60-50-86-8-82-54-85-61-22-97-46-62-0-72-49-75-32-4-38-31-73-10-44-26-45-99-42-34-35-23-78-18-96-79-88-1-94-12-81-41-3-64-69-52-89-48,91-74-25-65-87-15-21-93-17-37-98-83-5-55-30-43-36-95-29-84-6-56-11-33-28-77-51-47-70-40-13-2-19-14-16-58-20-71-9-90-59-76-92-27-57-24-80-67-68-66,8711152797,28791,21997,50788
ils,0-5-9-37-35-20-31-44-22-34-26-11-19-46-15-21-17-23-16-14-10-48-18-3-25-30-41-7-27-39-1-43-49-4-36-32-12-38-29-28-42-40-47-13-2-45-33-6-8-24,99-84-67-82-56-86-50-76-97-90-73-58-98-65-64-96-55-79-88-66-57-60-80-81-94-75-51-77-95-72-68-63-53-52-69-93-87-78-83-71-59-61-92-62-89-74-91-85-54-70,12103309371,22153,25601,47754
ils,99-84-67-82-56-86-50-76-97-90-73-58-98-65-64-96-55-79-88-66-57-60-80-81-94-75-51-77-95-72-68-63-53-52-69-93-87-78-83-71-59-61-92-62-89-74-91-85-54-70,0-5-9-37-35-20-31-44-22-34-26-11-19-46-15-21-17-23-16-14-10-48-18-3-25-30-41-7-27-39-1-43-49-4-36-32-12-38-29-28-42-40-47-13-2-45-33-6-8-24,9404978808,25601,22153,47754
ils,99-84-67-82-56-86-50-76-97-90-73-58-98-65-64-96-55-79-88-66-57-60-80-81-94-75-51-77-95-72-68-63-53-52-69-93-87-78-83-71-59-61-92-62-89-74-91-85-54-70,0-5-9-37-35-20-31-44-22-34-26-11-19-46-15-21-17-23-16-14-10-48-18-3-25-30-41-7-27-39-1-43-49-4-36-32-12-38-29-28-42-40-47-13-2-45-33-6-8-24,10623432647,25601,22153,47754
ils,0-5-9-37-35-20-31-44-22-34-26-11-19-46-15-21-17-23-16-14-10-48-18-3-25-30-41-7-27-39-1-43-49-4-36-32-12-38-29-28-42-40-47-13-2-45-33-6-8-24,99-84-67-82-56-86-50-76-97-90-73-58-98-65-64-96-55-79-88-66-57-60-80-81-94-75-51-77-95-72-68-63-53-52-69-93-87-78-83-71-59-61-92-62-89-74-91-85-54-70,9805271041,22153,25601,47754
ils,58-35-93-15-52-89-48-5-83-9-62-92-27-57-66-79-88-53-75-51-99-70-13-2-68-25-64-65-74-91-97-22-76-59-61-19-26-11-29-95-77-4-36-38-67-50-44-10-16-73,46-34-85-28-47-84-30-55-96-3-69-21-98-37-23-17-78-87-18-0-12-32-40-42-45-33-82-54-7-41-39-63-1-94-81-43-49-72-8-6-56-86-24-80-60-90-31-14-20-71,8878846411,23762,26381,50143
ils,0-5-9-37-35-20-31-44-22-34-26-11-19-46-15-21-17-23-16-14-10-48-18-3-25-30-41-7-27-39-1-43-49-4-36-32-12-38-29-28-42-40-47-13-2-45-33-6-8-24,99-84-67-82-56-86-50-76-97-90-73-58-98-65-64-96-55-79-88-66-57-60-80-81-94-75-51-77-95-72-68-63-53-52-69-93-87-78-83-71-59-61-92-62-89-74-91-85-54-70,12779565820,22153,25601,47754
ils,0-5-9-37-35-20-31-44-22-34-26-11-19-46-15-21-17-23-16-14-10-48-18-3-25-30-41-7-27-39-1-43-49-4-36-32-12-38-29-28-42-40-47-13-2-45-33-6-8-24,99-84-67-82-56-86-50-76-97-90-73-58-98-65-64-96-55-79-88-66-57-60-80-81-94-75-51-77-95-72-68-63-53-52-69-93-87-78-83-71-59-61-92-62-89-74-91-85-54-70,8810838572,22153,25601,47754
ils,99-84-67-82-56-86-50-76-97-90-73-58-98-65-64-96-55-79-88-66-57-60-80-81-94-75-51-77-95-72-68-63-53-52-69-93-87-78-83-71-59-61-92-62-89-74-91-85-54-70,0-5-9-37-35-20-31-44-22-34-26-11-19-46-15-21-17-23-16-14-10-48-18-3-25-30-41-7-27-39-1-43-49-4-36-32-12-38-29-28-42-40-47-13-2-45-33-6-8-24,9614772181,25601,22153,47754
ils,0-5-9-37-35-20-31-44-22-34-26-11-19-46-15-21-17-23-16-14-10-48-18-3-25-30-41-7-27-39-1-43-49-4-36-32-12-38-29-28-42-40-47-13-2-45-33-6-8-24,99-84-67-82-56-86-50-76-97-90-73-58-98-65-64-96-55-79-88-66-57-60-80-81-94-75-51-77-95-72-68-63-53-52-69-93-87-78-83-71-59-61-92-62-89-74-91-85-54-70,9340794607,22153,25601,47754
