name,instance_name,primary_graph,secondary_graph,time_ns,primary_cost,secondary_cost,total_cost
gc,kroA100,30-79-88-41-7-55-96-74-91-0-62-5-48-89-18-3-64-65-25-52-78-87-15-21-69-93-17-23-83-9-71-20-73-58-46-92-27-66-57-60-24-80-68-63-39-53-1-43-72-49,11-26-85-19-56-6-8-54-82-33-45-28-2-42-34-61-59-76-86-50-67-84-29-38-95-77-51-13-70-40-99-47-4-36-12-32-75-94-81-22-97-90-44-31-10-14-16-35-37-98,115813855,13910,16503,30413
gc,kroA100,58-73-20-71-9-83-35-37-23-17-78-89-48-5-62-46-10-16-14-31-44-90-97-22-59-76-61-19-85-34-26-11-56-6-8-86-50-57-92-27-0-91-7-74-18-52-87-15-21-93,28-45-2-42-13-47-99-70-40-33-82-54-29-38-95-77-51-4-36-84-67-72-49-43-80-24-60-68-63-39-53-1-81-94-12-32-75-66-41-88-30-79-55-96-3-64-65-25-69-98,35637779,11284,19000,30284
gc,kroA100,77-51-95-4-36-38-29-47-99-70-13-28-45-2-42-40-33-82-54-84-67-49-72-43-81-94-12-32-75-1-63-39-53-68-80-24-60-50-86-8-6-56-11-26-85-19-34-61-76-59,79-30-88-41-55-96-74-7-91-0-62-5-48-89-18-3-64-65-25-52-78-87-15-21-69-93-17-23-83-9-71-20-73-58-46-92-27-66-57-97-90-31-10-14-16-44-22-35-37-98,45147668,14176,15594,29770
gc,kroA100,35-37-23-17-83-9-71-20-73-58-98-78-89-48-5-62-46-10-16-14-31-90-44-97-22-59-76-61-92-27-0-91-74-18-52-87-15-93-21-69-65-64-3-96-55-7-41-79-30-88,54-82-33-11-26-85-19-6-8-56-86-50-60-24-80-67-84-28-45-2-42-13-70-40-99-47-29-38-95-77-51-4-36-49-72-68-63-39-53-43-1-81-94-12-32-75-34-57-66-25,12872146,14195,18882,33077
gc,kroA100,19-11-26-85-34-61-59-76-56-6-8-86-50-60-24-80-54-82-33-45-28-2-42-13-29-84-67-72-68-57-92-27-66-22-97-90-44-31-10-14-16-46-0-62-5-48-91-7-41-88,38-95-77-51-4-36-12-32-75-94-81-49-43-1-63-39-53-47-99-70-40-30-79-55-96-74-18-89-9-71-20-73-58-83-35-37-23-17-78-52-87-15-21-93-69-3-64-65-25-98,8339697,14038,20021,34059
gc,kroA100,54-82-33-11-26-85-19-6-8-56-86-50-60-24-80-67-84-28-45-2-42-13-70-40-99-47-29-38-95-77-51-4-36-49-72-68-63-39-53-43-1-81-94-12-32-75-34-61-59-76,27-92-57-66-0-91-7-41-88-30-79-55-96-74-5-62-46-90-97-22-44-31-10-14-16-20-73-71-9-48-89-18-52-78-83-58-35-37-23-17-87-15-21-93-69-3-64-65-25-98,6501737,13818,15561,29379
gc,kroA100,61-59-76-19-85-34-26-11-56-6-8-86-50-60-24-80-57-92-27-22-97-90-44-31-10-14-16-46-0-62-5-48-91-7-66-68-72-67-84-54-82-33-45-28-2-42-13-70-40-99,23-37-17-78-83-9-35-98-71-20-73-58-89-52-87-15-93-21-69-18-74-96-3-65-64-25-55-79-30-41-88-39-63-53-1-43-49-38-29-95-77-51-4-36-81-94-12-32-75-47,11155385,13500,18354,31854
gc,kroA100,20-73-58-71-9-83-35-37-23-17-78-89-48-5-62-46-10-16-14-31-90-44-97-22-59-76-61-19-85-34-26-11-56-6-8-86-50-57-92-27-0-91-7-74-18-52-87-15-21-93,30-79-88-41-55-96-3-64-65-25-69-66-39-53-63-68-80-24-60-72-43-1-49-67-84-38-29-95-77-51-4-36-81-94-12-75-32-33-82-54-28-45-2-42-13-47-99-70-40-98,8857380,11460,20721,32181
gc,kroA100,82-54-33-6-8-56-11-26-85-19-34-61-59-76-86-50-60-24-80-67-84-28-45-2-42-13-70-40-99-47-29-38-95-77-51-4-36-49-72-68-63-39-53-43-1-81-94-12-32-75,48-5-62-89-9-83-71-20-73-58-10-46-0-91-74-18-52-78-17-23-37-35-98-87-15-21-93-69-65-3-96-55-7-41-79-30-88-66-27-92-57-90-31-14-16-44-97-22-64-25,10967346,13149,16164,29313
gc,kroA100,25-64-65-3-96-55-74-18-52-69-21-15-87-93-78-17-23-37-83-89-48-5-91-7-41-79-30-88-0-62-9-71-20-73-58-35-98-46-92-27-66-57-60-24-80-68-63-39-53-1,26-85-34-11-19-56-6-8-54-82-33-45-28-2-42-13-70-40-99-47-29-84-86-50-61-59-76-22-97-90-44-31-10-14-16-67-72-49-43-38-95-77-51-4-36-12-32-75-94-81,9935028,15760,14641,30401
gc,kroA100,52-78-87-15-21-93-69-18-74-96-3-64-65-25-89-48-5-62-9-83-17-23-37-35-98-71-20-73-58-10-16-14-31-46-0-91-7-55-79-30-41-88-66-27-92-57-90-97-22-44,72-49-43-1-63-39-53-68-67-84-80-24-60-50-86-8-6-56-19-11-54-82-33-28-29-38-95-77-51-4-36-81-94-12-32-75-47-13-2-45-42-70-99-40-26-85-34-61-76-59,8574995,14925,13915,28840
gc,kroA100,85-26-34-19-11-6-56-8-54-82-33-86-50-61-59-76-22-97-90-44-31-10-14-16-46-92-27-57-60-24-80-67-84-28-45-42-2-13-70-40-99-47-29-38-95-77-51-4-36-49,7-91-41-88-30-79-55-96-74-48-5-62-0-66-68-63-39-53-1-43-72-81-94-12-75-32-89-18-3-64-65-52-78-9-83-71-20-73-58-35-37-23-17-87-15-21-69-93-25-98,13459216,13070,19202,32272
gc,kroA100,90-97-22-44-31-10-14-16-46-0-62-5-48-89-9-71-20-73-58-83-35-37-23-17-78-52-18-74-91-92-27-57-76-59-61-19-85-34-26-11-56-6-8-86-50-60-24-80-68-66,54-82-33-45-28-2-42-13-70-40-99-47-29-84-67-72-49-43-38-95-77-51-4-36-12-32-75-94-81-1-63-39-53-88-41-7-30-79-55-96-3-64-65-87-15-21-93-69-25-98,8973388,12308,16991,29299
gc,kroA100,57-27-92-66-60-50-86-24-80-68-63-39-53-72-67-84-8-56-6-19-76-59-61-22-97-90-44-31-46-0-91-7-41-88-30-79-55-96-74-5-62-48-89-9-71-20-73-10-14-16,99-70-40-13-47-2-45-28-42-33-82-54-29-95-77-51-4-36-38-49-43-81-94-12-32-75-1-11-26-85-34-58-83-35-37-23-17-78-52-18-3-64-65-25-69-15-87-21-93-98,8730280,12938,20054,32992
gc,kroA100,36-4-77-51-95-38-29-47-99-70-13-28-45-2-42-40-32-12-75-94-81-49-43-72-67-84-80-24-68-63-39-1-53-60-50-86-8-6-33-82-54-11-56-19-26-85-34-61-76-59,65-64-3-25-69-21-15-87-52-18-96-74-55-79-30-41-7-91-48-5-89-78-93-17-23-37-83-9-62-0-46-71-20-73-58-35-98-10-16-14-31-90-97-22-44-92-27-66-88-57,7662784,14812,16505,31317
gc,kroA100,89-48-5-62-9-83-78-52-18-74-96-55-91-7-0-46-71-20-73-58-35-37-23-17-87-15-21-93-69-65-3-64-25-79-41-88-30-27-92-66-57-90-31-10-16-14-44-97-22-76,26-85-34-11-19-56-6-8-54-82-33-45-28-2-42-13-70-40-99-47-29-84-86-50-60-24-80-61-59-67-72-68-63-39-53-43-49-38-95-77-51-4-36-12-32-75-94-81-1-98,10302033,15375,18333,33708
gc,kroA100,96-55-74-18-3-64-65-25-52-78-89-48-5-91-7-41-79-30-88-0-62-9-83-17-87-15-21-69-93-23-37-35-71-20-73-58-46-92-27-66-57-60-24-80-68-63-39-53-1-43,22-97-90-44-31-10-14-16-59-76-61-19-85-34-26-11-56-6-8-86-50-54-82-33-45-28-2-42-13-29-84-67-72-49-38-95-77-51-47-99-70-40-4-36-81-94-12-32-75-98,7651729,15344,17427,32771
gc,kroA100,54-82-33-11-26-85-19-6-8-56-86-50-60-24-80-67-84-28-45-2-42-13-70-40-99-47-29-38-95-77-51-4-36-49-72-68-63-39-53-43-1-81-94-12-32-75-34-61-59-76,20-73-58-71-9-83-35-37-23-17-78-89-48-5-62-46-10-16-14-31-90-44-97-22-0-91-7-74-18-52-87-15-21-93-98-69-65-3-96-55-41-88-30-79-92-27-57-66-64-25,8807114,13818,17098,30916
gc,kroA100,17-23-37-78-87-15-21-93-52-18-89-83-9-35-98-71-20-73-58-10-16-14-31-46-62-5-48-74-96-3-65-69-64-25-55-91-7-0-92-27-66-41-79-30-88-57-90-97-44-22,77-51-95-4-36-38-29-47-99-70-13-28-45-2-42-40-33-82-54-84-67-49-72-43-81-94-12-32-75-1-63-39-53-68-80-24-60-50-86-8-6-56-11-26-85-19-34-61-76-59,6705242,16667,14176,30843
gc,kroA100,85-26-34-19-11-6-56-8-54-82-33-86-50-61-59-76-22-97-90-44-31-10-14-16-46-92-27-57-60-24-80-67-84-28-45-42-2-13-70-40-99-47-29-38-95-77-51-4-36-49,94-12-75-32-81-43-1-72-63-39-53-68-66-88-41-30-79-7-91-0-62-5-48-74-55-96-18-89-9-71-20-73-58-83-78-52-3-64-65-25-69-15-87-21-93-17-23-37-35-98,4934274,13070,17490,30560
gc,kroA100,57-27-92-66-60-50-86-24-80-68-63-39-53-72-67-84-8-56-6-19-76-59-61-22-97-90-44-31-46-0-91-7-41-88-30-79-55-96-74-5-62-48-89-9-71-20-73-10-14-16,34-85-26-11-54-82-33-45-42-2-28-13-70-40-99-47-29-38-95-77-51-4-36-49-43-1-81-94-12-32-75-58-83-35-37-23-17-78-52-18-3-64-65-87-15-21-93-69-98-25,4662213,12938,20027,32965
gc,kroA100,44-90-97-22-31-10-14-16-73-20-58-71-46-62-0-92-27-57-76-59-61-19-85-34-26-11-56-6-8-86-50-60-24-80-68-66-91-5-48-89-9-83-35-37-23-17-78-52-18-74,54-82-33-45-28-2-42-13-70-40-99-47-29-84-67-72-49-43-38-95-77-51-4-36-12-32-75-94-81-1-63-39-53-88-41-7-30-79-55-96-3-64-65-87-15-21-93-69-25-98,6327223,12976,16991,29967
gc,kroA100,14-16-10-31-44-90-97-22-46-20-73-58-71-9-83-35-37-23-17-78-89-48-5-62-0-92-27-57-76-59-61-34-85-19-26-11-56-6-8-86-50-60-24-80-66-91-7-74-18-52,93-21-15-87-69-65-64-3-96-55-79-30-41-88-25-98-68-63-39-53-1-43-72-49-67-84-82-54-33-28-45-2-42-13-29-38-95-77-51-4-36-81-94-12-32-75-47-99-70-40,8099937,12877,20682,33559
gc,kroA100,71-20-73-58-9-83-35-37-23-17-78-89-48-5-62-46-31-10-16-14-44-90-97-22-59-76-61-92-27-0-91-74-18-52-87-15-21-93-69-65-3-96-55-7-41-88-30-79-64-25,98-66-57-60-50-86-56-19-85-34-26-11-6-8-24-80-68-63-39-53-1-43-72-67-84-82-54-33-45-28-2-42-13-29-38-49-81-94-12-32-75-36-4-95-77-51-47-99-70-40,9008669,13975,17088,31063
gc,kroA100,98-35-37-23-17-83-9-71-20-73-58-16-14-10-31-46-62-5-48-89-78-87-93-21-15-52-18-74-96-3-65-69-64-25-55-91-0-7-41-79-30-88-27-92-90-44-97-22-59-76,33-82-54-11-6-8-56-19-26-85-34-61-86-50-24-80-60-84-67-28-45-2-42-13-47-29-38-95-77-51-4-36-99-70-40-72-49-43-68-63-39-53-1-81-94-12-32-75-57-66,7120815,14953,16542,31495
gc,kroA100,39-63-53-1-43-72-68-80-24-60-50-86-67-49-84-38-29-95-77-51-4-36-81-94-12-75-32-66-57-27-92-0-7-41-88-30-79-55-91-62-5-48-74-96-18-89-46-90-97-22,21-15-87-93-69-52-78-17-23-37-83-9-71-35-98-20-73-58-10-16-14-31-44-3-65-64-25-76-59-61-19-56-8-6-11-85-26-34-54-82-33-28-45-2-42-13-47-99-70-40,7674510,16157,18378,34535
gc,kroA100,99-70-40-13-47-2-45-28-42-33-82-54-29-95-77-51-4-36-38-84-67-72-49-43-81-94-12-32-75-1-63-68-80-24-86-8-6-56-11-26-85-19-34-61-59-76-50-60-57-27,91-7-41-88-30-79-55-74-48-5-62-0-92-66-46-89-18-96-3-64-65-52-78-9-83-71-20-73-58-10-31-90-97-22-44-14-16-35-37-23-17-87-15-21-93-69-25-98-39-53,8388888,14763,18670,33433
gc,kroA100,55-96-74-18-3-64-65-25-79-30-41-7-91-5-48-89-62-0-88-66-27-92-57-60-24-80-68-63-39-53-1-43-72-49-67-84-50-86-56-8-6-76-46-9-83-78-52-87-15-21,12-32-75-94-81-36-4-95-77-51-38-29-47-99-70-13-28-45-2-42-33-82-54-11-19-26-85-34-61-59-22-97-90-44-31-10-14-16-73-20-71-58-35-37-23-17-93-69-98-40,6325266,15104,16405,31509
gc,kroA100,41-88-30-79-55-7-91-74-96-18-48-5-62-0-27-92-66-57-60-24-80-68-63-39-53-1-43-72-49-67-84-50-86-56-8-6-19-76-97-90-46-89-9-83-78-52-3-64-65-25,13-2-45-28-42-70-99-40-47-29-95-77-51-38-4-36-32-12-75-94-81-33-82-54-11-26-85-34-61-59-22-44-31-10-14-16-73-20-58-71-35-37-23-17-87-15-21-93-69-98,7756709,13983,16057,30040
gc,kroA100,10-14-16-31-44-90-97-22-46-20-73-58-71-9-83-35-37-23-17-78-89-48-5-62-0-92-27-57-76-59-61-19-85-34-26-11-56-6-8-86-50-60-24-80-66-91-7-74-18-52,82-54-33-45-28-2-42-13-70-40-99-47-29-84-67-72-49-43-68-63-39-53-1-38-95-77-51-4-36-12-32-75-94-81-88-41-30-79-55-96-3-64-65-87-15-21-93-69-25-98,6218233,12865,17853,30718
gc,kroA100,17-23-37-78-87-15-21-93-52-18-89-83-9-35-98-71-20-73-58-10-16-14-31-46-62-5-48-74-96-3-65-69-64-25-55-91-7-0-92-27-66-41-79-30-88-57-90-97-44-22,26-85-34-11-19-56-6-8-54-82-33-45-28-2-42-13-70-40-99-47-29-84-86-50-60-24-80-61-59-76-67-72-68-63-39-53-43-49-38-95-77-51-4-36-12-32-75-94-81-1,7707326,16667,14461,31128
gc,kroA100,74-18-96-55-91-7-41-79-30-88-48-5-89-62-0-46-9-83-78-52-87-15-21-69-3-64-65-25-93-17-23-37-35-71-20-73-58-10-31-90-97-22-44-14-16-92-27-66-57-60,28-45-2-42-13-47-99-70-40-33-82-54-11-6-8-56-86-50-24-80-84-29-38-95-77-51-4-36-67-72-49-43-68-63-39-53-1-81-94-12-32-75-19-26-85-34-61-76-59-98,6487291,15588,18169,33757
gc,kroA100,22-97-90-44-31-10-14-16-46-76-59-61-19-85-34-26-11-56-6-8-86-50-60-57-92-27-0-62-5-48-89-9-71-20-73-58-83-35-37-23-17-78-52-18-74-91-7-66-24-80,72-49-43-1-63-39-53-68-67-84-38-29-95-77-51-4-36-81-94-12-32-75-47-13-28-33-82-54-45-2-42-70-99-40-88-41-30-79-55-96-3-64-65-25-69-15-87-21-93-98,5901374,12654,18559,31213
gc,kroA100,69-21-15-87-93-52-78-17-23-37-83-9-89-18-65-64-3-25-96-74-48-5-62-91-7-55-79-30-41-88-0-46-71-35-98-20-73-58-10-16-14-31-90-97-22-44-92-27-66-57,81-94-12-75-32-36-4-95-77-51-38-49-43-1-72-67-84-29-47-13-28-45-2-42-33-82-54-8-6-56-86-80-24-68-63-39-53-60-50-19-11-26-85-34-61-76-59-99-70-40,6222076,15626,14760,30386
gc,kroA100,82-54-33-6-8-56-11-26-85-19-34-61-59-76-86-50-60-24-80-67-84-28-45-2-42-13-70-40-99-47-29-38-95-77-51-4-36-49-72-68-63-39-53-43-1-81-94-12-32-75,58-73-20-71-9-83-35-37-23-17-78-89-48-5-62-46-10-16-14-31-44-90-97-22-0-91-7-74-18-52-87-15-21-93-98-69-65-3-96-55-41-88-30-79-92-27-57-66-64-25,5516445,13149,16974,30123
gc,kroA100,88-41-30-79-55-7-91-0-62-5-48-74-96-18-3-64-65-25-52-89-9-83-78-87-15-21-69-93-17-23-37-35-71-46-27-92-66-57-60-24-80-68-63-39-53-1-43-72-49-67,42-2-45-28-13-70-40-99-47-29-33-82-54-11-26-85-34-19-6-8-56-86-50-84-38-95-77-51-4-36-32-12-75-94-81-61-59-76-22-97-90-44-31-10-14-16-73-20-58-98,5558283,14523,15477,30000
gc,kroA100,41-88-30-79-55-7-91-74-96-18-48-5-62-0-27-92-66-57-60-24-80-68-63-39-53-1-43-72-49-67-84-50-86-56-8-6-19-76-97-90-46-89-9-83-78-52-3-64-65-25,99-70-40-13-47-2-45-28-42-33-82-54-29-95-77-51-4-36-38-12-32-75-94-81-11-26-85-34-61-59-22-44-31-10-14-16-73-20-58-71-35-37-23-17-87-15-21-93-69-98,4639046,13983,17296,31279
gc,kroA100,8-6-56-86-50-60-24-80-19-11-54-82-33-26-85-34-61-76-59-22-97-90-44-31-46-92-57-27-66-68-67-84-72-49-43-63-39-53-1-38-29-28-45-2-42-13-47-99-70-40,14-16-10-73-58-20-71-9-83-35-37-23-17-78-89-48-5-62-0-91-7-74-18-52-87-15-21-93-98-69-65-3-96-55-41-88-30-79-64-25-81-94-12-32-75-36-4-95-77-51,4896768,13857,18096,31953
gc,kroA100,12-32-75-94-81-36-4-95-77-51-38-29-84-67-49-43-1-72-68-63-39-53-80-24-60-50-86-8-6-56-33-28-13-47-99-70-40-2-45-42-82-54-11-19-26-85-34-61-76-59,17-23-37-78-87-15-21-93-52-18-89-83-9-35-98-71-20-73-58-10-16-14-31-46-62-5-48-74-96-3-65-69-64-25-55-91-7-0-92-27-66-41-79-30-88-57-90-97-44-22,6490934,13679,16667,30346
gc,kroA100,19-11-26-85-34-61-59-76-56-6-8-86-50-60-24-80-54-82-33-45-28-2-42-13-29-84-67-72-68-57-92-27-66-22-97-90-44-31-10-14-16-46-0-62-5-48-91-7-41-88,47-99-70-40-51-77-95-4-36-38-49-43-81-94-12-32-75-1-63-39-53-30-79-55-96-74-18-89-9-71-20-73-58-83-35-37-23-17-78-52-87-15-21-93-69-3-64-65-25-98,4823215,14038,18467,32505
gc,kroA100,10-14-16-31-44-90-97-22-46-20-73-58-71-9-83-35-37-23-17-78-89-48-5-62-0-92-27-57-76-59-61-19-85-34-26-11-56-6-8-86-50-60-24-80-66-91-7-74-18-52,15-87-21-93-69-65-64-3-96-55-79-30-41-88-25-98-68-63-39-53-1-43-72-49-67-84-82-54-33-28-45-2-42-13-29-38-95-77-51-4-36-81-94-12-75-32-47-99-70-40,5693507,12865,20612,33477
gc,kroA100,19-11-26-85-34-61-59-76-56-6-8-86-50-60-24-80-54-82-33-45-28-2-42-13-29-84-67-72-68-57-92-27-66-22-97-90-44-31-10-14-16-46-0-62-5-48-91-7-41-88,98-35-37-23-17-83-9-71-20-73-58-78-87-93-21-15-52-89-18-74-96-3-65-69-64-25-55-79-30-39-63-53-1-43-49-38-95-77-51-47-99-70-40-4-36-81-94-12-32-75,7174170,14038,18563,32601
gc,kroA100,96-55-74-18-3-64-65-25-52-78-89-48-5-91-7-41-79-30-88-0-62-9-83-17-87-15-21-69-93-23-37-35-71-20-73-58-46-92-27-66-57-60-24-80-68-63-39-53-1-43,50-86-56-8-6-19-11-26-85-34-61-76-59-22-97-90-44-31-10-14-16-54-82-33-28-45-2-42-13-29-84-67-72-49-38-95-77-51-4-36-81-94-12-32-75-47-99-70-40-98,4971638,15344,18239,33583
gc,kroA100,17-23-37-78-87-15-21-93-52-18-89-83-9-35-98-71-20-73-58-10-16-14-31-46-62-5-48-74-96-3-65-69-64-25-55-91-7-0-92-27-66-41-79-30-88-57-90-97-44-22,75-32-12-94-81-36-4-77-95-51-38-29-84-67-49-43-1-72-63-39-53-68-80-24-60-50-86-8-6-56-33-28-47-99-70-13-2-45-42-40-82-54-11-19-26-85-34-61-76-59,6709071,16667,14449,31116
gc,kroA100,11-26-85-19-56-6-8-54-82-33-45-28-2-42-34-61-59-76-86-50-60-24-80-67-84-29-38-95-77-51-13-70-40-99-47-4-36-49-72-68-57-92-27-66-22-97-90-44-31-10,3-64-65-25-96-18-74-55-79-30-41-7-91-48-5-89-52-87-15-21-69-93-78-17-23-37-83-9-62-0-88-46-71-20-73-58-35-98-16-14-39-53-63-1-43-81-94-12-75-32,12299324,14392,19664,34056
gc,kroA100,71-20-73-58-9-83-35-37-23-17-78-89-48-5-62-46-31-10-16-14-44-90-97-22-59-76-61-92-27-0-91-74-18-52-87-15-21-93-69-65-3-96-55-7-41-88-30-79-64-25,4-36-77-51-95-38-29-47-99-70-13-28-45-2-42-40-84-67-49-43-81-12-32-75-94-72-68-80-24-60-50-86-8-6-33-82-54-11-56-19-26-85-34-57-63-39-1-53-66-98,11420759,13975,19967,33942
gc,kroA100,88-41-30-79-55-7-91-0-62-5-48-74-96-18-3-64-65-25-52-89-9-83-78-87-15-21-69-93-17-23-37-35-71-46-27-92-66-57-60-24-80-68-63-39-53-1-43-72-49-67,38-29-95-77-51-4-36-12-32-75-94-81-84-28-45-2-13-47-99-70-40-42-33-82-54-6-8-56-86-50-11-19-26-85-34-61-76-59-22-97-90-44-31-10-14-16-73-20-58-98,17584107,14523,14608,29131
gc,kroA100,10-14-16-31-44-90-97-22-46-20-73-58-71-9-83-35-37-23-17-78-89-48-5-62-0-92-27-57-76-59-61-19-85-34-26-11-56-6-8-86-50-60-24-80-66-91-7-74-18-52,75-32-12-94-81-36-4-77-95-51-38-29-84-67-49-43-1-72-63-39-53-68-28-47-99-70-13-2-45-33-82-54-42-40-88-41-30-79-55-96-3-64-65-25-69-15-87-21-93-98,10858629,12865,20544,33409
gc,kroA100,34-85-26-11-19-61-59-76-56-6-8-54-82-33-45-42-2-28-13-70-40-99-47-29-86-50-60-24-80-57-92-27-22-97-90-44-31-10-14-16-46-0-62-5-48-91-7-66-68-67,83-9-71-20-73-58-35-37-23-17-78-89-52-87-15-21-93-69-18-74-96-55-3-64-65-25-98-41-79-30-88-39-63-53-1-43-72-49-84-38-95-77-51-4-36-81-94-12-32-75,11147988,13818,18772,32590
gc,kroA100,14-16-10-31-44-90-97-22-46-20-73-58-71-9-83-35-37-23-17-78-89-48-5-62-0-92-27-57-76-59-61-34-85-19-26-11-56-6-8-86-50-60-24-80-66-91-7-74-18-52,79-30-88-41-55-96-3-64-65-25-69-15-87-21-93-98-68-63-39-53-1-43-72-49-67-84-38-29-95-77-51-4-36-81-94-12-75-32-33-82-54-28-45-2-42-13-47-99-70-40,10755654,12877,18291,31168
gc,kroA100,95-77-51-4-36-38-29-47-13-99-70-40-2-28-45-42-33-82-54-84-67-49-72-43-81-94-12-32-75-1-63-39-53-68-80-24-60-50-86-8-6-56-11-26-85-19-34-61-76-59,62-5-48-89-9-83-71-20-73-58-46-0-91-7-74-18-52-78-17-23-37-35-98-10-31-90-97-22-44-14-16-92-27-66-57-41-88-30-79-55-96-3-64-65-87-15-21-93-69-25,10774367,13525,15206,28731
gc,kroA100,32-75-12-94-81-36-4-77-51-95-38-29-84-67-49-43-1-72-68-63-39-53-80-24-60-50-86-8-6-56-33-28-47-99-70-13-2-45-42-40-82-54-11-19-26-85-34-61-76-59,16-14-10-31-44-90-97-22-46-20-73-58-71-9-83-35-37-23-17-78-89-48-5-62-0-92-27-57-66-91-7-74-18-52-87-15-21-93-98-69-65-3-96-55-41-88-30-79-64-25,13605512,14485,15844,30329
gc,kroA100,45-2-28-42-13-70-40-99-47-29-33-82-54-11-26-85-19-6-8-56-86-50-24-80-84-67-38-95-77-51-4-36-32-12-75-94-81-49-72-68-60-57-76-61-34-59-22-97-90-44,96-55-74-18-3-64-65-25-52-78-89-48-5-91-7-41-79-30-88-0-62-9-83-17-87-15-21-69-93-23-37-35-71-20-73-58-46-92-27-66-39-53-63-1-43-31-10-16-14-98,10649553,13609,17544,31153
gc,kroA100,77-51-95-4-36-38-29-47-99-70-13-28-45-2-42-40-33-82-54-84-67-49-72-43-81-94-12-32-75-1-63-39-53-68-80-24-60-50-86-8-6-56-11-26-85-19-34-61-76-59,0-62-5-48-91-7-41-88-30-79-55-74-18-89-9-83-71-46-92-27-66-57-97-90-31-10-14-16-20-73-58-35-37-23-17-78-52-96-3-64-65-69-15-87-21-93-98-44-22-25,5679514,14176,17362,31538
gc,kroA100,21-15-87-93-69-52-78-17-23-37-83-9-89-18-3-65-64-25-96-74-48-5-62-91-7-55-79-30-41-88-0-46-71-35-98-20-73-58-10-16-14-31-90-97-22-44-92-27-66-57,59-61-76-19-85-34-26-11-56-6-8-86-50-60-24-80-68-72-67-84-82-54-33-45-28-2-42-13-29-38-95-77-51-47-99-70-40-4-36-49-43-63-39-53-1-81-94-12-32-75,6423749,15509,14371,29880
gc,kroA100,79-30-88-41-55-96-74-7-91-0-62-5-48-89-18-3-64-65-25-52-78-87-15-21-69-93-17-23-83-9-71-20-73-58-46-92-27-66-57-60-24-80-68-63-39-53-1-43-72-49,11-26-85-19-56-6-8-54-82-33-45-28-2-42-34-61-59-76-86-50-67-84-29-38-95-77-51-13-70-40-99-47-4-36-12-32-75-94-81-22-97-90-44-31-10-14-16-35-37-98,6338803,13919,16503,30422
gc,kroA100,41-88-30-79-55-7-91-74-96-18-48-5-62-0-27-92-66-57-60-24-80-68-63-39-53-1-43-72-49-67-84-50-86-56-8-6-19-76-97-90-46-89-9-83-78-52-3-64-65-25,16-14-10-31-44-22-73-58-20-71-35-37-23-17-98-93-87-15-21-69-59-61-34-85-26-11-54-82-33-45-28-2-42-13-29-38-95-77-51-47-99-70-40-4-36-81-94-12-32-75,3868510,13983,17392,31375
gc,kroA100,7-91-41-88-30-79-55-96-74-48-5-62-0-27-92-66-57-60-24-80-68-63-39-53-1-43-72-49-67-50-86-56-8-6-19-76-97-90-46-89-18-3-64-65-52-78-9-83-71-20,93-21-15-87-69-17-23-37-35-98-58-73-10-16-14-31-44-22-59-61-85-26-34-11-54-82-33-28-45-2-42-13-84-38-29-95-77-51-4-36-81-94-12-32-75-25-47-99-70-40,6759645,13944,22457,36401
gc,kroA100,84-67-72-49-43-68-80-24-60-50-86-8-6-56-82-54-33-28-29-38-95-77-51-4-36-12-32-75-94-81-1-63-39-53-57-66-27-92-76-19-11-26-85-34-61-59-22-97-90-44,35-37-23-17-83-9-71-20-73-58-98-78-89-48-5-62-46-10-16-14-31-0-91-74-18-52-87-15-93-21-69-65-64-3-96-55-7-41-79-30-88-25-45-2-42-13-70-40-99-47,6776914,13138,20032,33170
gc,kroA100,84-67-72-49-43-68-80-24-60-50-86-8-6-56-82-54-33-28-29-38-95-77-51-4-36-12-32-75-94-81-1-63-39-53-57-66-27-92-76-19-11-26-85-34-61-59-22-97-90-44,30-79-88-41-7-55-96-74-91-0-62-5-48-89-18-3-64-65-25-52-78-87-15-21-69-93-17-23-83-9-71-20-73-58-46-31-10-14-16-35-37-98-45-2-42-13-47-99-70-40,7942580,13138,18384,31522
gc,kroA100,42-2-45-28-13-70-40-99-47-29-33-82-54-11-26-85-34-19-6-8-56-86-50-24-80-84-67-38-95-77-51-4-36-32-12-75-94-81-49-72-68-60-57-76-61-59-22-97-90-44,37-23-17-78-83-35-98-9-71-20-73-58-10-16-14-31-46-62-89-48-5-52-87-15-93-21-69-18-74-96-3-65-64-25-55-91-0-7-41-79-30-88-27-92-66-39-63-53-1-43,9429462,13003,17015,30018
gc,kroA100,38-29-95-77-51-4-36-12-32-75-94-81-49-84-67-72-43-1-63-39-53-68-80-24-60-50-86-8-6-56-33-28-45-2-13-47-99-70-40-42-82-54-11-19-26-85-34-61-76-59,0-62-5-48-91-7-41-88-30-79-55-74-18-89-9-83-71-46-92-27-66-57-97-90-31-10-14-16-20-73-58-35-37-23-17-78-52-96-3-64-65-69-15-87-21-93-98-44-22-25,7428425,12427,17362,29789
gc,kroA100,17-23-37-78-87-15-21-93-52-18-89-83-9-35-98-71-20-73-58-10-16-14-31-46-62-5-48-74-96-3-65-69-64-25-55-91-7-0-92-27-66-41-79-30-88-57-90-97-44-22,81-94-12-75-32-36-4-95-77-51-38-49-43-1-72-67-84-29-47-13-28-45-2-42-33-82-54-8-6-56-86-80-24-68-63-39-53-60-50-19-11-26-85-34-61-76-59-99-70-40,12332715,16667,14760,31427
gc,kroA100,48-5-62-89-9-83-71-20-73-58-10-46-0-91-74-18-52-78-17-23-37-35-98-87-15-21-93-69-65-3-96-55-7-41-79-30-88-66-27-92-57-90-31-14-16-44-97-22-76-59,61-85-34-26-19-11-56-6-8-86-50-60-24-80-54-82-33-45-28-2-42-13-70-40-99-47-29-84-67-72-68-63-39-53-43-49-38-95-77-51-4-36-81-1-94-12-32-75-64-25,8206436,14655,18098,32753
gc,kroA100,2-45-28-42-13-70-40-99-47-29-33-82-54-11-26-85-19-6-8-56-86-50-24-80-84-67-38-95-77-51-4-36-32-12-75-94-81-49-72-43-68-60-57-76-61-34-59-22-97-90,25-64-65-3-96-55-74-18-52-69-21-15-87-93-78-17-23-37-83-89-48-5-91-7-41-79-30-88-0-62-9-71-20-73-58-35-98-46-92-27-66-39-53-63-1-31-10-16-14-44,6504751,13875,17675,31550
gc,kroA100,13-2-45-28-42-70-99-40-47-29-95-77-51-38-84-67-33-82-54-11-6-8-56-19-26-85-34-61-59-76-86-50-24-80-60-68-72-49-43-4-36-32-12-75-94-81-1-63-39-53,55-96-74-18-3-64-65-25-79-30-41-7-91-5-48-89-62-0-88-66-27-92-57-46-9-83-78-52-87-15-21-69-93-17-23-37-35-71-20-73-58-10-31-90-97-22-44-14-16-98,6291430,13965,15905,29870
gc,kroA100,70-40-99-13-2-42-45-28-47-29-95-77-51-4-36-38-84-67-33-82-54-11-26-85-19-6-8-56-86-50-24-80-60-68-72-49-43-81-94-12-32-75-1-63-39-53-57-76-61-34,16-14-10-31-44-90-97-22-46-20-73-58-71-9-83-35-37-23-17-78-89-48-5-62-0-92-27-66-91-7-74-18-52-87-15-21-93-98-59-41-88-30-79-55-96-3-64-65-69-25,5198091,14013,17494,31507
gc,kroA100,30-79-88-41-7-55-96-74-91-0-62-5-48-89-18-3-64-65-25-52-78-87-15-21-69-93-17-23-83-9-71-20-73-58-46-92-27-66-57-60-24-80-68-63-39-53-1-43-72-49,84-67-38-29-95-77-51-4-36-12-32-75-94-81-28-33-82-54-8-6-56-86-50-19-11-26-85-34-61-76-59-22-97-90-44-31-10-14-16-45-2-13-47-99-70-40-42-35-37-98,7309127,13910,18785,32695
gc,kroA100,9-83-71-20-73-58-35-37-23-17-78-89-48-5-62-0-91-74-18-52-87-15-21-93-69-65-3-96-55-7-41-79-30-88-46-31-10-16-14-44-90-97-22-92-27-66-57-60-50-86,33-82-54-11-6-8-56-19-26-85-34-61-76-59-45-28-2-42-13-47-29-38-84-67-80-24-68-72-49-43-63-39-53-1-81-95-77-51-4-36-99-70-40-12-32-75-94-64-25-98,7907599,13938,21380,35318
gc,kroA100,92-27-57-66-0-62-46-90-97-22-44-31-10-14-16-20-73-71-9-5-48-91-7-41-88-30-79-55-74-96-18-89-83-58-35-37-23-17-78-52-87-15-21-93-69-3-64-65-25-60,70-40-99-13-2-42-45-28-47-29-95-77-51-4-36-38-84-67-33-82-54-11-26-85-19-6-8-56-86-50-24-80-72-49-43-81-94-12-32-75-1-63-68-39-53-34-61-59-76-98,13696162,14989,18795,33784
gc,kroA100,78-52-87-15-21-93-17-23-37-83-9-89-48-5-62-18-74-96-3-64-65-69-25-55-91-7-0-46-71-20-73-58-35-98-10-16-14-31-90-97-22-44-92-27-66-41-79-30-88-57,80-24-60-50-86-8-6-56-19-11-54-82-33-67-84-72-68-63-39-53-43-49-1-81-38-29-28-45-2-42-13-47-95-77-51-4-36-12-94-75-32-99-70-40-26-85-34-61-76-59,9049468,16592,14557,31149
gc,kroA100,71-20-73-58-9-83-35-37-23-17-78-89-48-5-62-46-31-10-16-14-44-90-97-22-59-76-61-92-27-0-91-74-18-52-87-15-21-93-69-65-3-96-55-7-41-88-30-79-64-25,12-32-75-94-81-36-4-95-77-51-38-29-84-67-49-43-1-72-68-63-39-53-80-24-60-50-86-8-6-56-33-28-13-47-99-70-40-2-45-42-82-54-11-19-26-85-34-57-66-98,6627781,13975,18066,32041
gc,kroA100,70-40-99-13-2-42-45-28-47-29-95-77-51-4-36-38-84-67-33-82-54-11-26-85-19-6-8-56-86-50-24-80-60-68-72-49-43-81-94-12-32-75-1-63-39-53-57-76-61-34,91-7-41-88-30-79-55-74-48-5-62-0-27-92-66-46-89-18-96-3-64-65-52-78-9-83-71-20-73-58-10-31-90-97-22-44-14-16-35-37-23-17-87-15-21-93-69-25-98-59,4386576,14013,17741,31754
gc,kroA100,19-11-26-85-34-61-59-76-56-6-8-86-50-60-24-80-54-82-33-45-28-2-42-13-29-84-67-72-68-57-92-27-66-22-97-90-44-31-10-14-16-46-0-62-5-48-91-7-41-88,78-52-87-15-21-93-17-23-37-83-9-89-18-74-96-3-64-65-69-25-55-79-30-71-20-73-58-35-98-39-63-53-1-43-49-38-95-77-51-4-36-81-94-12-32-75-47-99-70-40,7421865,14038,20155,34193
gc,kroA100,10-14-16-31-44-90-97-22-46-20-73-58-71-9-83-35-37-23-17-78-89-48-5-62-0-92-27-57-76-59-61-19-85-34-26-11-56-6-8-86-50-60-24-80-66-91-7-74-18-52,40-70-99-13-2-42-45-28-47-29-95-77-51-4-36-38-84-67-33-82-54-72-49-43-81-94-12-32-75-1-63-68-39-53-88-41-30-79-55-96-3-64-65-87-15-21-93-69-25-98,8068093,12865,19543,32408
gc,kroA100,29-38-95-77-51-4-36-47-13-28-45-2-42-33-82-54-6-8-56-86-84-67-49-72-43-1-81-94-12-32-75-99-70-40-11-26-85-19-50-24-80-60-68-63-39-53-57-66-27-92,79-30-88-41-55-96-74-7-91-0-62-5-48-89-18-3-64-65-25-52-78-87-15-21-69-93-17-23-83-9-71-20-73-58-46-90-97-22-44-31-10-14-16-35-37-98-76-59-61-34,7453045,15593,16176,31769
gc,kroA100,24-80-60-50-86-8-6-56-19-11-54-82-33-84-67-72-68-63-39-53-43-49-1-57-66-27-92-76-61-59-85-26-34-22-97-90-44-31-46-0-91-7-41-88-30-79-55-96-74-5,73-20-58-71-9-83-35-37-23-17-78-89-48-62-10-16-14-98-93-87-15-21-52-18-3-64-65-69-25-28-45-42-2-13-29-38-95-77-51-47-99-70-40-4-36-81-94-12-32-75,9476600,14350,20265,34615
gc,kroA100,74-18-96-55-91-7-41-79-30-88-48-5-89-62-0-46-9-83-78-52-87-15-21-69-3-64-65-25-93-17-23-37-35-71-20-73-58-10-31-90-97-22-44-14-16-92-27-66-57-60,85-26-34-19-11-6-56-8-54-82-33-86-50-61-59-76-24-80-67-84-28-45-42-2-13-70-40-99-47-29-38-95-77-51-4-36-49-72-68-63-39-53-43-1-81-94-12-32-75-98,7387414,15588,18507,34095
gc,kroA100,13-2-45-28-42-70-99-40-47-29-95-77-51-38-84-67-33-82-54-11-6-8-56-19-26-85-34-61-59-76-86-50-24-80-60-68-72-49-43-4-36-32-12-75-94-81-1-63-39-53,27-92-57-66-0-91-7-41-88-30-79-55-96-74-5-62-46-90-97-22-44-31-10-14-16-20-73-71-9-48-89-18-52-78-83-58-35-37-23-17-87-15-21-93-69-3-64-65-25-98,8393592,13965,15561,29526
gc,kroA100,3-64-65-25-96-18-74-55-79-30-41-7-91-48-5-89-52-87-15-21-69-93-78-17-23-37-83-9-62-0-88-66-27-92-46-71-20-73-58-35-98-10-31-90-97-22-44-14-16-57,67-84-72-49-43-68-80-24-60-50-86-8-6-56-82-54-33-28-29-38-95-77-51-4-36-81-94-12-32-75-1-63-39-53-19-11-26-85-34-61-76-59-45-2-13-47-99-70-40-42,9061476,16700,14464,31164
gc,kroA100,93-21-15-87-69-52-78-17-23-37-35-83-9-89-18-74-96-3-65-64-25-55-48-5-62-91-7-41-79-30-88-0-71-20-73-58-98-10-16-14-31-46-90-97-44-22-92-27-66-57,47-99-70-40-13-2-28-45-42-29-95-77-51-4-36-38-84-67-49-72-43-81-94-12-32-75-33-82-54-6-8-56-11-26-85-19-86-50-24-80-60-68-63-39-53-1-34-61-76-59,6228990,16245,15525,31770
gc,kroA100,45-2-28-42-13-70-40-99-47-29-33-82-54-11-26-85-19-6-8-56-86-50-24-80-84-67-38-95-77-51-4-36-32-12-75-94-81-49-72-68-60-57-76-61-34-59-22-97-90-44,0-62-5-48-91-7-41-88-30-79-55-74-18-89-9-83-71-46-92-27-66-31-10-14-16-20-73-58-35-37-23-17-78-52-96-3-64-65-69-15-87-21-93-98-25-39-63-53-1-43,4674552,13609,18272,31881
gc,kroA100,72-49-43-1-63-39-53-68-67-84-80-24-60-50-86-8-6-56-19-11-54-82-33-28-29-38-95-77-51-4-36-81-94-12-32-75-47-13-2-45-42-70-99-40-26-85-34-61-76-57,35-37-23-17-83-9-71-20-73-58-98-78-89-48-5-62-46-10-16-14-31-90-44-97-22-59-0-91-74-18-52-87-15-93-21-69-65-64-3-96-55-7-41-79-30-88-27-92-66-25,3744099,13799,16541,30340
gc,kroA100,91-7-41-88-30-79-55-74-48-5-62-0-27-92-66-57-46-89-18-96-3-64-65-52-78-9-83-71-20-73-58-10-31-90-97-22-44-14-16-35-37-23-17-87-15-21-93-69-25-98,38-29-95-77-51-4-36-12-32-75-94-81-49-84-67-72-43-1-63-39-53-68-80-24-60-50-86-8-6-56-33-28-45-2-13-47-99-70-40-42-82-54-11-19-26-85-34-61-76-59,5548464,16116,12427,28543
gc,kroA100,11-26-85-19-56-6-8-54-82-33-45-28-2-42-34-61-59-76-86-50-60-24-80-67-84-29-38-95-77-51-13-70-40-99-47-4-36-49-72-68-57-92-27-66-22-97-90-44-31-10,43-1-63-39-53-81-94-12-75-32-88-41-7-91-0-62-5-48-74-55-79-30-96-18-89-46-14-16-73-20-71-9-83-78-52-3-64-65-25-69-15-87-21-93-17-23-37-35-58-98,3753028,14392,18959,33351
gc,kroA100,99-70-40-13-47-2-45-28-42-33-82-54-29-95-77-51-4-36-38-84-67-72-49-43-81-94-12-32-75-1-63-68-80-24-86-8-6-56-11-26-85-19-34-61-59-76-50-60-57-27,66-92-0-91-7-41-88-30-79-55-96-74-5-62-48-89-46-90-97-22-44-31-10-14-16-20-71-9-83-73-58-35-37-23-17-78-18-52-3-64-65-25-69-15-87-21-93-98-39-53,5003133,14763,16050,30813
gc,kroA100,33-82-54-11-6-8-56-19-26-85-34-61-76-86-50-24-80-60-84-67-28-45-2-42-13-47-29-38-95-77-51-4-36-99-70-40-72-49-43-68-63-39-53-1-81-94-12-32-75-57,17-23-37-78-87-15-21-93-52-18-89-83-9-35-98-71-20-73-58-10-16-14-31-46-62-5-48-74-96-3-65-69-64-25-55-91-7-0-92-27-66-41-79-30-88-90-97-44-22-59,3997833,16033,16988,33021
gc,kroA100,62-5-48-89-9-83-71-20-73-58-46-0-91-7-74-18-52-78-17-23-37-35-98-10-31-90-97-22-44-14-16-92-27-66-57-60-50-86-76-59-61-19-56-8-6-11-85-26-34-54,29-38-95-77-51-4-36-47-13-28-45-2-42-33-82-84-67-49-72-43-1-81-94-12-32-75-99-70-40-80-24-68-63-39-53-88-41-30-79-55-96-3-64-65-25-69-15-87-21-93,3729114,14701,18290,32991
gc,kroA100,81-94-12-75-32-36-4-95-77-51-38-49-43-1-72-67-84-29-47-13-28-45-2-42-33-82-54-8-6-56-86-80-24-68-63-39-53-60-50-57-66-27-92-0-7-41-88-30-79-55,18-74-96-3-64-65-52-78-89-48-5-62-91-9-83-17-87-15-21-69-93-23-37-35-71-20-73-58-10-46-31-90-97-22-44-14-16-98-25-76-59-61-19-85-26-11-34-70-99-40,3690792,14706,20905,35611
gc,kroA100,38-29-95-77-51-4-36-12-32-75-94-81-49-84-67-72-43-1-63-39-53-68-80-24-60-50-86-8-6-56-33-28-45-2-13-47-99-70-40-42-82-54-11-19-26-85-34-61-76-59,58-73-20-71-9-83-35-37-23-17-78-89-48-5-62-46-10-16-14-31-44-90-97-22-0-91-7-74-18-52-87-15-21-93-98-69-65-3-96-55-41-88-30-79-92-27-57-66-64-25,3684639,12427,16974,29401
gc,kroA100,52-78-87-15-21-93-69-18-74-96-3-64-65-25-89-48-5-62-9-83-17-23-37-35-98-71-20-73-58-10-16-14-31-46-0-91-7-55-79-30-41-88-66-27-92-57-90-97-22-44,95-77-51-4-36-38-29-47-13-99-70-40-2-28-45-42-33-82-54-84-67-49-72-43-81-94-12-32-75-1-63-39-53-68-80-24-60-50-86-8-6-56-11-26-85-19-34-61-76-59,3669837,14925,13525,28450
gc,kroA100,19-11-26-85-34-61-59-76-56-6-8-86-50-60-24-80-54-82-33-45-28-2-42-13-29-84-67-72-68-57-92-27-66-22-97-90-44-31-10-14-16-46-0-62-5-48-91-7-41-88,35-37-23-17-83-9-71-20-73-58-98-78-89-52-87-15-93-21-69-18-74-96-3-64-65-25-55-79-30-39-63-53-1-43-49-38-95-77-51-47-99-70-40-4-36-81-94-12-32-75,5816060,14038,18135,32173
gc,kroA100,97-90-22-44-31-10-14-16-46-92-27-57-76-59-61-19-85-34-26-11-56-6-8-86-50-60-24-80-68-66-0-62-5-48-89-9-71-20-73-58-83-35-37-23-17-78-52-18-74-91,2-45-28-42-13-70-40-99-47-29-33-82-54-84-67-38-95-77-51-4-36-32-12-75-94-81-49-72-43-1-63-39-53-88-41-7-30-79-55-96-3-64-65-87-15-21-93-69-25-98,3677097,12489,18018,30507
gc,kroA100,99-70-40-13-47-2-45-28-42-33-82-54-29-95-77-51-4-36-38-84-67-72-49-43-81-94-12-32-75-1-63-68-80-24-86-8-6-56-11-26-85-19-34-61-59-76-50-60-57-27,0-62-5-48-91-7-41-88-30-79-55-74-18-89-9-83-71-46-92-66-97-90-31-10-14-16-20-73-58-35-37-23-17-78-52-96-3-64-65-69-15-87-21-93-98-44-22-39-53-25,3653104,14763,18981,33744
gc,kroA100,85-26-34-19-11-6-56-8-54-82-33-86-50-61-59-76-22-97-90-44-31-10-14-16-46-92-27-57-60-24-80-67-84-28-45-42-2-13-70-40-99-47-29-38-95-77-51-4-36-49,37-23-17-78-83-35-98-9-71-20-73-58-89-48-5-62-52-87-15-93-21-69-18-74-96-3-65-64-25-55-91-0-7-41-79-30-88-66-68-63-39-53-1-43-72-81-94-12-32-75,3794606,13070,18331,31401
gc,kroA100,19-11-26-85-34-61-59-76-56-6-8-86-50-60-24-80-54-82-33-45-28-2-42-13-29-84-67-72-68-57-92-27-66-22-97-90-44-31-10-14-16-46-0-62-5-48-91-7-41-88,40-70-99-47-51-77-95-38-4-36-32-12-75-94-81-49-43-1-63-39-53-30-79-55-96-74-89-9-71-20-73-58-83-35-37-23-17-78-52-18-3-64-65-87-15-21-93-69-25-98,3826226,14038,17789,31827
gc,kroA100,61-59-76-19-85-34-26-11-56-6-8-86-50-60-24-80-57-92-27-22-97-90-44-31-10-14-16-46-0-62-5-48-91-7-66-68-72-67-84-54-82-33-45-28-2-42-13-70-40-99,21-15-87-93-69-52-78-17-23-37-83-9-89-18-3-65-64-25-96-74-55-79-30-41-88-71-35-98-20-73-58-39-53-63-1-43-49-81-94-12-75-32-38-29-95-77-51-4-36-47,5230328,13500,19945,33445
gc,kroA100,74-18-96-55-91-7-41-79-30-88-48-5-89-62-0-46-9-83-78-52-87-15-21-69-3-64-65-25-93-17-23-37-35-71-20-73-58-10-31-90-97-22-44-14-16-92-27-66-57-60,12-32-75-94-81-36-4-95-77-51-38-29-84-67-49-43-1-72-68-63-39-53-80-24-50-86-8-6-56-33-28-13-47-99-70-40-2-45-42-82-54-11-19-26-85-34-61-76-59-98,3710274,15588,17152,32740
gc,kroA100,98-35-37-23-17-83-9-71-20-73-58-16-14-10-31-46-62-5-48-89-78-87-93-21-15-52-18-74-96-3-65-69-64-25-55-91-0-7-41-79-30-88-27-92-90-44-97-22-59-76,42-2-45-28-13-70-40-99-47-29-33-82-54-11-26-85-34-19-6-8-56-86-50-24-80-84-67-38-95-77-51-4-36-32-12-75-94-81-49-72-68-60-57-61-66-63-39-43-1-53,4808818,14953,15246,30199
gc,kroA100,9-83-71-20-73-58-35-37-23-17-78-89-48-5-62-0-91-74-18-52-87-15-21-93-69-65-3-96-55-7-41-79-30-88-46-31-10-16-14-44-90-97-22-92-27-66-57-60-50-86,77-51-95-4-36-38-29-47-99-70-13-28-45-2-42-40-33-82-54-84-67-49-72-43-81-94-12-32-75-1-63-39-53-68-80-24-8-6-56-11-26-85-19-34-61-76-59-98-64-25,4033774,13938,19600,33538
nn,kroA100,15-87-21-93-69-52-78-17-23-37-35-98-83-9-71-20-73-58-16-14-10-31-90-97-22-44-46-62-5-48-89-18-74-96-55-79-30-88-41-7-91-0-92-27-66-57-60-24-80-68,4-36-77-51-95-38-29-47-99-70-40-13-2-45-28-33-82-54-11-26-85-34-19-56-6-8-86-50-76-59-61-42-84-67-72-49-43-1-53-39-63-81-94-12-32-75-3-64-65-25,5452309,13228,18698,31926
nn,kroA100,28-45-2-42-13-70-40-99-47-51-77-95-4-36-32-75-12-94-81-49-43-72-67-84-38-29-33-82-54-11-26-85-34-19-56-6-8-86-50-60-24-80-68-63-39-53-1-66-27-92,64-65-3-96-55-79-30-88-41-7-91-0-62-5-48-89-9-83-71-20-73-58-16-14-10-31-90-97-22-44-46-57-76-59-61-35-37-23-17-78-52-87-15-21-93-69-18-74-25-98,4997223,12480,16404,28884
nn,kroA100,4-36-77-51-95-38-29-47-99-70-40-13-2-45-28-33-82-54-11-26-85-34-19-56-6-8-86-50-60-24-80-68-72-49-43-1-53-39-63-67-84-81-94-12-32-75-42-61-59-76,52-78-17-23-37-35-98-83-9-71-20-73-58-16-14-10-31-90-97-22-44-46-62-5-48-89-18-74-96-55-79-30-88-41-7-91-0-92-27-66-57-3-64-65-25-69-21-15-87-93,3864575,14436,12789,27225
nn,kroA100,84-67-72-49-43-1-53-39-63-68-80-24-60-50-86-8-6-56-19-11-26-85-34-61-59-76-22-97-90-44-31-10-14-16-73-20-58-71-9-83-35-37-23-17-78-52-87-15-21-93,69-65-64-3-96-55-79-30-88-41-7-91-0-62-5-48-89-18-74-25-98-46-92-27-66-57-54-82-33-28-45-2-42-13-70-40-99-47-51-77-95-4-36-32-75-12-94-81-38-29,3490109,11855,18696,30551
nn,kroA100,12-32-75-94-81-49-43-72-67-84-38-29-95-77-51-4-36-47-99-70-40-13-2-45-28-33-82-54-11-26-85-34-19-56-6-8-86-50-60-24-80-68-63-39-53-1-66-27-92-57,59-61-76-22-97-90-44-31-10-14-16-73-20-58-71-9-83-35-37-23-17-78-52-87-15-21-93-69-65-64-3-96-55-79-30-88-41-7-91-0-62-5-48-89-18-74-25-98-46-42,1857895,12651,16412,29063
nn,kroA100,51-77-95-4-36-32-75-12-94-81-49-43-72-67-84-38-29-47-99-70-40-13-2-45-28-33-82-54-11-26-85-34-19-56-6-8-86-50-60-24-80-68-63-39-53-1-66-27-92-57,83-9-71-20-73-58-16-14-10-31-90-97-22-44-46-62-5-48-89-78-52-87-15-21-93-69-65-64-3-96-55-79-30-88-41-7-91-0-74-18-17-23-37-35-98-25-76-59-61-42,3375641,12269,18534,30803
nn,kroA100,75-32-12-94-81-49-43-72-67-84-38-29-95-77-51-4-36-47-99-70-40-13-2-45-28-33-82-54-11-26-85-34-19-56-6-8-86-50-60-24-80-68-63-39-53-1-66-27-92-57,37-23-17-78-52-87-15-21-93-69-65-64-3-96-55-79-30-88-41-7-91-0-62-5-48-89-9-83-71-20-73-58-16-14-10-31-90-97-22-44-46-76-59-61-42-74-18-25-35-98,10813948,12707,16330,29037
nn,kroA100,34-85-26-11-19-56-6-8-86-50-60-24-80-68-72-49-43-1-53-39-63-67-84-38-29-95-77-51-4-36-32-75-12-94-81-47-99-70-40-13-2-45-28-33-82-54-42-61-59-76,23-37-35-98-17-78-52-87-15-21-93-69-65-64-3-96-55-79-30-88-41-7-91-0-62-5-48-89-9-83-71-20-73-58-16-14-10-31-90-97-22-44-46-92-27-66-57-74-18-25,16957106,12148,13704,25852
nn,kroA100,63-39-53-1-43-49-72-67-84-38-29-95-77-51-4-36-32-75-12-94-81-68-80-24-60-50-86-8-6-56-19-11-26-85-34-61-59-76-22-97-90-44-31-10-14-16-73-20-58-71,13-2-45-28-33-82-54-42-70-40-99-47-57-27-92-66-0-62-5-48-89-9-83-35-37-23-17-78-52-87-15-21-93-69-65-64-3-96-55-79-30-88-41-7-91-74-18-25-98-46,10946088,11808,17976,29784
nn,kroA100,27-92-57-60-24-80-68-72-49-43-1-53-39-63-67-84-38-29-95-77-51-4-36-32-75-12-94-81-47-99-70-40-13-2-45-28-33-82-54-11-26-85-34-19-56-6-8-86-50-76,41-88-30-79-55-96-74-18-52-78-17-23-37-35-98-83-9-71-20-73-58-16-14-10-31-90-97-22-44-46-62-5-48-89-91-7-0-66-59-61-42-3-64-65-25-69-21-15-87-93,4185694,11737,17722,29459
nn,kroA100,52-78-17-23-37-35-98-83-9-71-20-73-58-16-14-10-31-90-97-22-44-46-62-5-48-89-18-74-96-55-79-30-88-41-7-91-0-92-27-66-57-60-24-80-68-72-49-43-1-53,65-64-3-25-69-21-15-87-93-76-59-61-85-26-11-19-56-6-8-86-50-54-82-33-28-45-2-42-13-70-40-99-47-51-77-95-4-36-32-75-12-94-81-38-29-84-67-63-39-34,3098925,13226,17239,30465
nn,kroA100,11-26-85-34-19-56-6-8-86-50-60-24-80-68-72-49-43-1-53-39-63-67-84-38-29-95-77-51-4-36-32-75-12-94-81-47-99-70-40-13-2-45-28-33-82-54-42-61-59-76,52-78-17-23-37-35-98-83-9-71-20-73-58-16-14-10-31-90-97-22-44-46-62-5-48-89-18-74-96-55-79-30-88-41-7-91-0-92-27-66-57-3-64-65-25-69-21-15-87-93,7194946,12315,12789,25104
nn,kroA100,24-80-60-50-86-8-6-56-19-11-26-85-34-61-59-76-22-97-90-44-31-10-14-16-73-20-58-71-9-83-35-37-23-17-78-52-87-15-21-93-69-65-64-3-96-55-79-30-88-41,68-72-49-43-1-53-39-63-67-84-38-29-95-77-51-4-36-32-75-12-94-81-47-99-70-40-13-2-45-28-33-82-54-42-57-27-92-66-0-62-5-48-89-18-74-91-7-46-98-25,4236454,10338,19349,29687
nn,kroA100,45-2-42-28-13-70-40-99-47-51-77-95-4-36-32-75-12-94-81-49-43-72-67-84-38-29-33-82-54-11-26-85-34-19-56-6-8-86-50-60-24-80-68-63-39-53-1-66-27-92,25-64-65-3-96-55-79-30-88-41-7-91-0-62-5-48-89-9-83-71-20-73-58-16-14-10-31-90-97-22-44-46-57-76-59-61-35-37-23-17-78-52-87-15-21-93-69-18-74-98,3560451,12631,15599,28230
nn,kroA100,9-83-71-20-73-58-16-14-10-31-90-97-22-44-46-62-5-48-89-78-52-87-15-21-93-69-65-64-3-96-55-79-30-88-41-7-91-0-92-27-66-57-60-24-80-68-72-49-43-1,17-23-37-35-98-18-74-25-53-39-63-67-84-38-29-95-77-51-4-36-32-75-12-94-81-47-99-70-40-13-2-45-28-33-82-54-11-26-85-34-19-56-6-8-86-50-76-59-61-42,5744330,12811,18782,31593
nn,kroA100,96-55-79-30-88-41-7-91-0-62-5-48-89-9-83-71-20-73-58-16-14-10-31-90-97-22-44-46-92-27-66-57-60-24-80-68-72-49-43-1-53-39-63-67-84-38-29-95-77-51,21-15-87-93-69-52-78-17-23-37-35-98-18-74-3-64-65-25-76-59-61-85-26-11-19-56-6-8-86-50-54-82-33-28-45-2-42-13-70-40-99-47-4-36-32-75-12-94-81-34,3494864,13750,18304,32054
nn,kroA100,87-15-21-93-69-52-78-17-23-37-35-98-83-9-71-20-73-58-16-14-10-31-90-97-22-44-46-62-5-48-89-18-74-96-55-79-30-88-41-7-91-0-92-27-66-57-60-24-80-68,64-65-3-25-53-39-63-1-43-49-72-67-84-38-29-95-77-51-4-36-32-75-12-94-81-47-99-70-40-13-2-45-28-33-82-54-11-26-85-34-19-56-6-8-86-50-76-59-61-42,4333400,13146,17197,30343
nn,kroA100,23-37-35-98-17-78-52-87-15-21-93-69-65-64-3-96-55-79-30-88-41-7-91-0-62-5-48-89-9-83-71-20-73-58-16-14-10-31-90-97-22-44-46-92-27-66-57-60-24-80,75-32-12-94-81-49-43-72-67-84-38-29-95-77-51-4-36-47-99-70-40-13-2-45-28-33-82-54-11-26-85-34-19-56-6-8-86-50-76-59-61-42-68-63-39-53-1-74-18-25,3761905,12905,18586,31491
nn,kroA100,3-64-65-25-69-21-15-87-93-17-23-37-35-98-83-9-71-20-73-58-16-14-10-31-90-97-22-44-46-62-5-48-89-78-52-18-74-96-55-79-30-88-41-7-91-0-92-27-66-57,13-2-45-28-33-82-54-11-26-85-34-19-56-6-8-86-50-60-24-80-68-72-49-43-1-53-39-63-67-84-38-29-95-77-51-4-36-32-75-12-94-81-47-99-70-40-42-61-59-76,4653842,12781,13124,25905
nn,kroA100,70-40-99-47-13-2-45-28-33-82-54-11-26-85-34-19-56-6-8-86-50-60-24-80-68-72-49-43-1-53-39-63-67-84-38-29-95-77-51-4-36-32-75-12-94-81-57-27-92-66,58-73-20-71-9-83-35-37-23-17-78-52-87-15-21-93-69-65-64-3-96-55-79-30-88-41-7-91-0-62-5-48-89-18-74-25-98-16-14-10-31-90-97-22-44-46-76-59-61-42,4230756,13179,16894,30073
nn,kroA100,0-62-5-48-89-9-83-71-20-73-58-16-14-10-31-90-97-22-44-46-92-27-66-57-60-24-80-68-72-49-43-1-53-39-63-67-84-38-29-95-77-51-4-36-32-75-12-94-81-47,91-7-41-88-30-79-55-96-74-18-52-78-17-23-37-35-98-93-21-15-87-69-65-64-3-25-76-59-61-85-26-11-19-56-6-8-86-50-54-82-33-28-45-2-42-13-70-40-99-34,3333199,14094,15930,30024
nn,kroA100,66-27-92-57-60-24-80-68-72-49-43-1-53-39-63-67-84-38-29-95-77-51-4-36-32-75-12-94-81-47-99-70-40-13-2-45-28-33-82-54-11-26-85-34-19-56-6-8-86-50,25-64-65-3-96-55-79-30-88-41-7-91-0-62-5-48-89-9-83-71-20-73-58-16-14-10-31-90-97-22-44-46-76-59-61-42-74-18-52-78-17-23-37-35-98-93-21-15-87-69,2468244,11498,15267,26765
nn,kroA100,44-90-97-22-59-61-76-19-11-26-85-34-56-6-8-86-50-60-24-80-68-72-49-43-1-53-39-63-67-84-38-29-95-77-51-4-36-32-75-12-94-81-47-99-70-40-13-2-45-28,79-30-88-41-7-91-0-62-5-48-89-9-83-71-20-73-58-16-14-10-31-46-92-27-66-57-54-82-33-42-74-18-52-78-17-23-37-35-98-93-21-15-87-69-65-64-3-96-55-25,3296514,12696,15991,28687
nn,kroA100,87-15-21-93-69-52-78-17-23-37-35-98-83-9-71-20-73-58-16-14-10-31-90-97-22-44-46-62-5-48-89-18-74-96-55-79-30-88-41-7-91-0-92-27-66-57-60-24-80-68,12-32-75-94-81-49-43-72-67-84-38-29-95-77-51-4-36-47-99-70-40-13-2-45-28-33-82-54-11-26-85-34-19-56-6-8-86-50-76-59-61-42-63-39-53-1-3-64-65-25,2811080,13146,18398,31544
nn,kroA100,78-52-87-15-21-93-69-65-64-3-96-55-79-30-88-41-7-91-0-62-5-48-89-9-83-71-20-73-58-16-14-10-31-90-97-22-44-46-92-27-66-57-60-24-80-68-72-49-43-1,61-59-76-19-11-26-85-34-56-6-8-86-50-54-82-33-28-45-2-42-13-70-40-99-47-51-77-95-4-36-32-75-12-94-81-38-29-84-67-63-39-53-74-18-17-23-37-35-98-25,1349584,12938,17231,30169
nn,kroA100,21-15-87-93-69-52-78-17-23-37-35-98-83-9-71-20-73-58-16-14-10-31-90-97-22-44-46-62-5-48-89-18-74-96-55-79-30-88-41-7-91-0-92-27-66-57-60-24-80-68,36-4-77-51-95-38-29-47-99-70-40-13-2-45-28-33-82-54-11-26-85-34-19-56-6-8-86-50-76-59-61-42-84-67-72-49-43-1-53-39-63-81-94-12-32-75-3-64-65-25,1905446,13275,18610,31885
nn,kroA100,80-24-60-50-86-8-6-56-19-11-26-85-34-61-59-76-22-97-90-44-31-10-14-16-73-20-58-71-9-83-35-37-23-17-78-52-87-15-21-93-69-65-64-3-96-55-79-30-88-41,13-2-45-28-33-82-54-42-70-40-99-47-51-77-95-4-36-32-75-12-94-81-49-43-72-67-84-38-29-68-63-39-53-1-66-27-92-57-0-62-5-48-89-18-74-91-7-46-98-25,2412361,10298,20339,30637
nn,kroA100,98-35-37-23-17-78-52-87-15-21-93-69-65-64-3-96-55-79-30-88-41-7-91-0-62-5-48-89-9-83-71-20-73-58-16-14-10-31-90-97-22-44-46-92-27-66-57-60-24-80,47-99-70-40-13-2-45-28-33-82-54-11-26-85-34-19-56-6-8-86-50-76-59-61-42-29-38-95-77-51-4-36-32-75-12-94-81-49-43-72-67-84-68-63-39-53-1-74-18-25,2331487,12698,17937,30635
nn,kroA100,14-16-10-31-90-97-22-44-46-62-5-48-89-9-83-71-20-73-58-35-37-23-17-78-52-87-15-21-93-69-65-64-3-96-55-79-30-88-41-7-91-0-92-27-66-57-60-24-80-68,36-4-77-51-95-38-29-47-99-70-40-13-2-45-28-33-82-54-11-26-85-34-19-56-6-8-86-50-76-59-61-42-84-67-72-49-43-1-53-39-63-81-94-12-32-75-74-18-25-98,1816705,12142,20610,32752
nn,kroA100,37-23-17-78-52-87-15-21-93-69-65-64-3-96-55-79-30-88-41-7-91-0-62-5-48-89-9-83-71-20-73-58-16-14-10-31-90-97-22-44-46-92-27-66-57-60-24-80-68-72,85-26-11-19-56-6-8-86-50-76-59-61-34-54-82-33-28-45-2-42-13-70-40-99-47-51-77-95-4-36-32-75-12-94-81-49-43-1-53-39-63-67-84-38-29-74-18-25-35-98,1459106,12936,17724,30660
nn,kroA100,12-32-75-94-81-49-43-72-67-84-38-29-95-77-51-4-36-47-99-70-40-13-2-45-28-33-82-54-11-26-85-34-19-56-6-8-86-50-60-24-80-68-63-39-53-1-66-27-92-57,64-65-3-96-55-79-30-88-41-7-91-0-62-5-48-89-9-83-71-20-73-58-16-14-10-31-90-97-22-44-46-76-59-61-42-74-18-52-78-17-23-37-35-98-93-21-15-87-69-25,1936993,12651,15267,27918
nn,kroA100,46-31-10-14-16-73-20-58-71-9-83-35-37-23-17-78-52-87-15-21-93-69-65-64-3-96-55-79-30-88-41-7-91-0-62-5-48-89-18-74-25-98-44-90-97-22-59-61-76-19,72-49-43-1-53-39-63-68-80-24-60-50-86-8-6-56-11-26-85-34-54-82-33-28-45-2-42-13-70-40-99-47-51-77-95-4-36-32-75-12-94-81-38-29-84-67-57-27-92-66,1363262,14874,11806,26680
nn,kroA100,77-51-95-4-36-32-75-12-94-81-49-43-72-67-84-38-29-47-99-70-40-13-2-45-28-33-82-54-11-26-85-34-19-56-6-8-86-50-60-24-80-68-63-39-53-1-66-27-92-57,96-55-79-30-88-41-7-91-0-62-5-48-89-9-83-71-20-73-58-16-14-10-31-90-97-22-44-46-76-59-61-42-74-18-52-78-17-23-37-35-98-93-21-15-87-69-65-64-3-25,1338707,12276,15441,27717
nn,kroA100,46-31-10-14-16-73-20-58-71-9-83-35-37-23-17-78-52-87-15-21-93-69-65-64-3-96-55-79-30-88-41-7-91-0-62-5-48-89-18-74-25-98-44-90-97-22-59-61-76-19,39-63-53-1-43-49-72-67-84-38-29-95-77-51-4-36-32-75-12-94-81-68-80-24-60-50-86-8-6-56-11-26-85-34-54-82-33-28-45-2-42-13-70-40-99-47-57-27-92-66,1364956,14874,12679,27553
nn,kroA100,25-64-65-3-96-55-79-30-88-41-7-91-0-62-5-48-89-9-83-71-20-73-58-16-14-10-31-90-97-22-44-46-92-27-66-57-60-24-80-68-72-49-43-1-53-39-63-67-84-38,54-82-33-28-45-2-42-13-70-40-99-47-51-77-95-4-36-32-75-12-94-81-29-8-6-56-86-50-19-11-26-85-34-61-59-76-74-18-52-78-17-23-37-35-98-93-21-15-87-69,1451391,14285,15868,30153
nn,kroA100,0-62-5-48-89-9-83-71-20-73-58-16-14-10-31-90-97-22-44-46-92-27-66-57-60-24-80-68-72-49-43-1-53-39-63-67-84-38-29-95-77-51-4-36-32-75-12-94-81-47,98-35-37-23-17-78-52-87-15-21-93-69-65-64-3-96-55-79-30-88-41-7-91-74-18-25-76-59-61-85-26-11-19-56-6-8-86-50-54-82-33-28-45-2-42-13-70-40-99-34,1440516,14094,16392,30486
nn,kroA100,55-96-74-18-52-78-17-23-37-35-98-83-9-71-20-73-58-16-14-10-31-90-97-22-44-46-62-5-48-89-91-7-41-88-30-79-3-64-65-25-69-21-15-87-93-0-92-27-66-57,24-80-60-50-86-8-6-56-19-11-26-85-34-61-59-76-54-82-33-28-45-2-42-13-70-40-99-47-51-77-95-4-36-32-75-12-94-81-49-43-72-67-84-38-29-68-63-39-53-1,1324470,13970,11793,25763
nn,kroA100,95-77-51-4-36-32-75-12-94-81-49-43-72-67-84-38-29-47-99-70-40-13-2-45-28-33-82-54-11-26-85-34-19-56-6-8-86-50-60-24-80-68-63-39-53-1-66-27-92-57,76-59-61-22-97-90-44-31-10-14-16-73-20-58-71-9-83-35-37-23-17-78-52-87-15-21-93-69-65-64-3-96-55-79-30-88-41-7-91-0-62-5-48-89-18-74-25-98-46-42,1602019,12179,16471,28650
nn,kroA100,33-82-54-11-26-85-34-19-56-6-8-86-50-60-24-80-68-72-49-43-1-53-39-63-67-84-38-29-95-77-51-4-36-32-75-12-94-81-47-99-70-40-13-2-45-28-42-61-59-76,9-83-71-20-73-58-16-14-10-31-90-97-22-44-46-62-5-48-89-78-52-87-15-21-93-69-65-64-3-96-55-79-30-88-41-7-91-0-92-27-66-57-74-18-17-23-37-35-98-25,2342162,12395,14854,27249
nn,kroA100,64-65-3-96-55-79-30-88-41-7-91-0-62-5-48-89-9-83-71-20-73-58-16-14-10-31-90-97-22-44-46-92-27-66-57-60-24-80-68-72-49-43-1-53-39-63-67-84-38-29,76-59-61-85-26-11-19-56-6-8-86-50-54-82-33-28-45-2-42-13-70-40-99-47-51-77-95-4-36-32-75-12-94-81-34-35-37-23-17-78-52-87-15-21-93-69-18-74-25-98,5222345,14162,17728,31890
nn,kroA100,63-39-53-1-43-49-72-67-84-38-29-95-77-51-4-36-32-75-12-94-81-68-80-24-60-50-86-8-6-56-19-11-26-85-34-61-59-76-22-97-90-44-31-10-14-16-73-20-58-71,89-48-5-62-0-91-7-41-88-30-79-55-96-74-18-52-78-17-23-37-35-98-83-9-46-92-27-66-57-54-82-33-28-45-2-42-13-70-40-99-47-3-64-65-25-69-21-15-87-93,2372173,11808,16198,28006
nn,kroA100,30-79-41-88-7-91-0-62-5-48-89-9-83-71-20-73-58-16-14-10-31-90-97-22-44-46-92-27-66-57-60-24-80-68-72-49-43-1-53-39-63-67-84-38-29-95-77-51-4-36,21-15-87-93-69-52-78-17-23-37-35-98-18-74-96-55-3-64-65-25-76-59-61-85-26-11-19-56-6-8-86-50-54-82-33-28-45-2-42-13-70-40-99-47-32-75-12-94-81-34,2369099,13342,18778,32120
nn,kroA100,7-91-0-62-5-48-89-9-83-71-20-73-58-16-14-10-31-90-97-22-44-46-92-27-66-57-60-24-80-68-72-49-43-1-53-39-63-67-84-38-29-95-77-51-4-36-32-75-12-94,18-74-96-55-79-30-88-41-3-64-65-25-69-21-15-87-93-17-23-37-35-98-78-52-76-59-61-85-26-11-19-56-6-8-86-50-54-82-33-28-45-2-42-13-70-40-99-47-81-34,2377458,12977,18207,31184
nn,kroA100,62-5-48-89-9-83-71-20-73-58-16-14-10-31-90-97-22-44-46-0-91-7-41-88-30-79-55-96-74-18-52-78-17-23-37-35-98-93-21-15-87-69-65-64-3-25-66-27-92-57,68-72-49-43-1-53-39-63-80-24-60-50-86-8-6-56-19-11-26-85-34-61-59-76-54-82-33-28-45-2-42-13-70-40-99-47-51-77-95-4-36-32-75-12-94-81-38-29-84-67,2339524,13425,11033,24458
nn,kroA100,36-4-77-51-95-38-29-47-99-70-40-13-2-45-28-33-82-54-11-26-85-34-19-56-6-8-86-50-60-24-80-68-72-49-43-1-53-39-63-67-84-81-94-12-32-75-42-61-59-76,14-16-10-31-90-97-22-44-46-62-5-48-89-9-83-71-20-73-58-35-37-23-17-78-52-87-15-21-93-69-65-64-3-96-55-79-30-88-41-7-91-0-92-27-66-57-74-18-25-98,2394167,14394,14576,28970
nn,kroA100,18-74-96-55-79-30-88-41-7-91-0-62-5-48-89-9-83-71-20-73-58-16-14-10-31-90-97-22-44-46-92-27-66-57-60-24-80-68-72-49-43-1-53-39-63-67-84-38-29-95,54-82-33-28-45-2-42-13-70-40-99-47-51-77-4-36-32-75-12-94-81-50-86-8-6-56-19-11-26-85-34-61-59-76-35-37-23-17-78-52-87-15-21-93-69-65-64-3-25-98,2395049,14142,16268,30410
nn,kroA100,52-78-17-23-37-35-98-83-9-71-20-73-58-16-14-10-31-90-97-22-44-46-62-5-48-89-18-74-96-55-79-30-88-41-7-91-0-92-27-66-57-60-24-80-68-72-49-43-1-53,26-85-34-19-11-6-8-56-86-50-76-59-61-54-82-33-28-45-2-42-13-70-40-99-47-51-77-95-4-36-32-75-12-94-81-38-29-84-67-63-39-3-64-65-25-69-21-15-87-93,2298019,13226,15780,29006
nn,kroA100,65-64-3-96-55-79-30-88-41-7-91-0-62-5-48-89-9-83-71-20-73-58-16-14-10-31-90-97-22-44-46-92-27-66-57-60-24-80-68-72-49-43-1-53-39-63-67-84-38-29,2-45-28-13-70-40-99-47-51-77-95-4-36-32-75-12-94-81-50-86-8-6-56-19-11-26-85-34-61-59-76-54-82-33-42-74-18-52-78-17-23-37-35-98-93-21-15-87-69-25,2446985,14159,18347,32506
nn,kroA100,13-2-45-28-33-82-54-11-26-85-34-19-56-6-8-86-50-60-24-80-68-72-49-43-1-53-39-63-67-84-38-29-95-77-51-4-36-32-75-12-94-81-47-99-70-40-42-61-59-76,66-27-92-57-0-62-5-48-89-9-83-71-20-73-58-16-14-10-31-90-97-22-44-46-91-7-41-88-30-79-55-96-74-18-52-78-17-23-37-35-98-93-21-15-87-69-65-64-3-25,2296473,13124,13407,26531
nn,kroA100,43-49-72-67-84-38-29-95-77-51-4-36-32-75-12-94-81-1-53-39-63-68-80-24-60-50-86-8-6-56-19-11-26-85-34-61-59-76-22-97-90-44-31-10-14-16-73-20-58-71,66-27-92-57-0-62-5-48-89-9-83-35-37-23-17-78-52-87-15-21-93-69-65-64-3-96-55-79-30-88-41-7-91-74-18-25-98-46-54-82-33-28-45-2-42-13-70-40-99-47,2928582,11732,17151,28883
nn,kroA100,80-24-60-50-86-8-6-56-19-11-26-85-34-61-59-76-22-97-90-44-31-10-14-16-73-20-58-71-9-83-35-37-23-17-78-52-87-15-21-93-69-65-64-3-96-55-79-30-88-41,81-94-12-32-75-36-4-77-51-95-38-29-47-99-70-40-13-2-45-28-33-82-54-42-84-67-72-49-43-1-53-39-63-68-57-27-92-66-0-62-5-48-89-18-74-91-7-46-98-25,2367295,10298,18658,28956
nn,kroA100,40-70-99-47-13-2-45-28-33-82-54-11-26-85-34-19-56-6-8-86-50-60-24-80-68-72-49-43-1-53-39-63-67-84-38-29-95-77-51-4-36-32-75-12-94-81-57-27-92-66,16-14-10-31-90-97-22-44-46-62-5-48-89-9-83-71-20-73-58-35-37-23-17-78-52-87-15-21-93-69-65-64-3-96-55-79-30-88-41-7-91-0-74-18-25-98-59-61-76-42,2604068,13186,17543,30729
nn,kroA100,60-24-80-68-72-49-43-1-53-39-63-67-84-38-29-95-77-51-4-36-32-75-12-94-81-47-99-70-40-13-2-45-28-33-82-54-11-26-85-34-19-56-6-8-86-50-57-27-92-66,64-65-3-96-55-79-30-88-41-7-91-0-62-5-48-89-9-83-71-20-73-58-16-14-10-31-90-97-22-44-46-76-59-61-42-74-18-52-78-17-23-37-35-98-93-21-15-87-69-25,2380621,11491,15267,26758
nn,kroA100,99-70-40-13-2-45-28-33-82-54-11-26-85-34-19-56-6-8-86-50-60-24-80-68-72-49-43-1-53-39-63-67-84-38-29-95-77-51-4-36-32-75-12-94-81-47-42-61-59-76,17-23-37-35-98-83-9-71-20-73-58-16-14-10-31-90-97-22-44-46-62-5-48-89-78-52-87-15-21-93-69-65-64-3-96-55-79-30-88-41-7-91-0-92-27-66-57-74-18-25,2314511,13634,13528,27162
nn,kroA100,28-45-2-42-13-70-40-99-47-51-77-95-4-36-32-75-12-94-81-49-43-72-67-84-38-29-33-82-54-11-26-85-34-19-56-6-8-86-50-60-24-80-68-63-39-53-1-66-27-92,15-87-21-93-69-52-78-17-23-37-35-98-83-9-71-20-73-58-16-14-10-31-90-97-22-44-46-62-5-48-89-18-74-96-55-79-30-88-41-7-91-0-57-76-59-61-3-64-65-25,2258448,12480,14294,26774
nn,kroA100,73-20-58-71-9-83-35-37-23-17-78-52-87-15-21-93-69-65-64-3-96-55-79-30-88-41-7-91-0-62-5-48-89-18-74-25-98-16-14-10-31-90-97-22-44-46-92-27-66-57,63-39-53-1-43-49-72-67-84-38-29-95-77-51-4-36-32-75-12-94-81-68-80-24-60-50-86-8-6-56-19-11-26-85-34-61-59-76-54-82-33-28-45-2-42-13-70-40-99-47,2834267,14846,12005,26851
nn,kroA100,78-52-87-15-21-93-69-65-64-3-96-55-79-30-88-41-7-91-0-62-5-48-89-9-83-71-20-73-58-16-14-10-31-90-97-22-44-46-92-27-66-57-60-24-80-68-72-49-43-1,40-70-99-47-13-2-45-28-33-82-54-11-26-85-34-19-56-6-8-86-50-76-59-61-42-29-38-95-77-51-4-36-32-75-12-94-81-67-84-63-39-53-74-18-17-23-37-35-98-25,15961436,12938,19415,32353
nn,kroA100,12-32-75-94-81-49-43-72-67-84-38-29-95-77-51-4-36-47-99-70-40-13-2-45-28-33-82-54-11-26-85-34-19-56-6-8-86-50-60-24-80-68-63-39-53-1-66-27-92-57,55-96-74-18-52-78-17-23-37-35-98-83-9-71-20-73-58-16-14-10-31-90-97-22-44-46-62-5-48-89-91-7-41-88-30-79-3-64-65-25-69-21-15-87-93-0-76-59-61-42,9585533,12651,17005,29656
nn,kroA100,17-23-37-35-98-83-9-71-20-73-58-16-14-10-31-90-97-22-44-46-62-5-48-89-78-52-87-15-21-93-69-65-64-3-96-55-79-30-88-41-7-91-0-92-27-66-57-60-24-80,38-29-95-77-51-4-36-32-75-12-94-81-49-43-72-67-84-68-63-39-53-1-50-86-8-6-56-19-11-26-85-34-61-59-76-54-82-33-28-45-2-42-13-70-40-99-47-74-18-25,2715580,12899,18221,31120
nn,kroA100,41-88-30-79-55-96-74-18-52-78-17-23-37-35-98-83-9-71-20-73-58-16-14-10-31-90-97-22-44-46-62-5-48-89-91-7-0-92-27-66-57-60-24-80-68-72-49-43-1-53,70-40-99-47-13-2-45-28-33-82-54-11-26-85-34-19-56-6-8-86-50-76-59-61-42-29-38-95-77-51-4-36-32-75-12-94-81-67-84-63-39-3-64-65-25-69-21-15-87-93,2956904,12506,17745,30251
nn,kroA100,3-64-65-25-69-21-15-87-93-17-23-37-35-98-83-9-71-20-73-58-16-14-10-31-90-97-22-44-46-62-5-48-89-78-52-18-74-96-55-79-30-88-41-7-91-0-92-27-66-57,60-24-80-68-72-49-43-1-53-39-63-67-84-38-29-95-77-51-4-36-32-75-12-94-81-47-99-70-40-13-2-45-28-33-82-54-11-26-85-34-19-56-6-8-86-50-76-59-61-42,10196769,12781,13107,25888
nn,kroA100,39-63-53-1-43-49-72-67-84-38-29-95-77-51-4-36-32-75-12-94-81-68-80-24-60-50-86-8-6-56-19-11-26-85-34-61-59-76-22-97-90-44-31-10-14-16-73-20-58-71,23-37-35-98-17-78-52-87-15-21-93-69-65-64-3-96-55-79-30-88-41-7-91-0-62-5-48-89-9-83-18-74-25-46-92-27-66-57-54-82-33-28-45-2-42-13-70-40-99-47,13762615,11889,17923,29812
nn,kroA100,42-2-45-28-13-70-40-99-47-51-77-95-4-36-32-75-12-94-81-49-43-72-67-84-38-29-33-82-54-11-26-85-34-19-56-6-8-86-50-60-24-80-68-63-39-53-1-66-27-92,14-16-10-31-90-97-22-44-46-62-5-48-89-9-83-71-20-73-58-35-37-23-17-78-52-87-15-21-93-69-65-64-3-96-55-79-30-88-41-7-91-0-74-18-25-98-59-61-76-57,3391378,12584,15971,28555
nn,kroA100,24-80-60-50-86-8-6-56-19-11-26-85-34-61-59-76-22-97-90-44-31-10-14-16-73-20-58-71-9-83-35-37-23-17-78-52-87-15-21-93-69-65-64-3-96-55-79-30-88-41,66-27-92-57-68-72-49-43-1-53-39-63-67-84-38-29-95-77-51-4-36-32-75-12-94-81-47-99-70-40-13-2-45-28-33-82-54-42-46-62-5-48-89-18-74-91-7-0-98-25,4118460,10338,19138,29476
nn,kroA100,51-77-95-4-36-32-75-12-94-81-49-43-72-67-84-38-29-47-99-70-40-13-2-45-28-33-82-54-11-26-85-34-19-56-6-8-86-50-60-24-80-68-63-39-53-1-66-27-92-57,87-15-21-93-69-52-78-17-23-37-35-98-83-9-71-20-73-58-16-14-10-31-90-97-22-44-46-62-5-48-89-18-74-96-55-79-30-88-41-7-91-0-76-59-61-42-3-64-65-25,7586970,12269,16121,28390
nn,kroA100,17-23-37-35-98-83-9-71-20-73-58-16-14-10-31-90-97-22-44-46-62-5-48-89-78-52-87-15-21-93-69-65-64-3-96-55-79-30-88-41-7-91-0-92-27-66-57-60-24-80,54-82-33-28-45-2-42-13-70-40-99-47-51-77-95-4-36-32-75-12-94-81-49-43-72-67-84-38-29-8-6-56-86-50-19-11-26-85-34-61-59-76-68-63-39-53-1-74-18-25,2033897,12899,17185,30084
nn,kroA100,99-70-40-13-2-45-28-33-82-54-11-26-85-34-19-56-6-8-86-50-60-24-80-68-72-49-43-1-53-39-63-67-84-38-29-95-77-51-4-36-32-75-12-94-81-47-42-61-59-76,31-10-14-16-73-20-58-71-9-83-35-37-23-17-78-52-87-15-21-93-69-65-64-3-96-55-79-30-88-41-7-91-0-62-5-48-89-18-74-25-98-46-90-97-22-44-92-27-66-57,2552466,13634,14968,28602
nn,kroA100,36-4-77-51-95-38-29-47-99-70-40-13-2-45-28-33-82-54-11-26-85-34-19-56-6-8-86-50-60-24-80-68-72-49-43-1-53-39-63-67-84-81-94-12-32-75-42-61-59-76,98-35-37-23-17-78-52-87-15-21-93-69-65-64-3-96-55-79-30-88-41-7-91-0-62-5-48-89-9-83-71-20-73-58-16-14-10-31-90-97-22-44-46-92-27-66-57-74-18-25,2972867,14394,13699,28093
nn,kroA100,74-18-52-78-17-23-37-35-98-83-9-71-20-73-58-16-14-10-31-90-97-22-44-46-62-5-48-89-91-7-41-88-30-79-55-96-3-64-65-25-69-21-15-87-93-0-92-27-66-57,38-29-95-77-51-4-36-32-75-12-94-81-49-43-72-67-84-80-24-60-50-86-8-6-56-19-11-26-85-34-61-59-76-54-82-33-28-45-2-42-13-70-40-99-47-68-63-39-53-1,2291432,13541,12302,25843
nn,kroA100,87-15-21-93-69-52-78-17-23-37-35-98-83-9-71-20-73-58-16-14-10-31-90-97-22-44-46-62-5-48-89-18-74-96-55-79-30-88-41-7-91-0-92-27-66-57-60-24-80-68,72-49-43-1-53-39-63-67-84-38-29-95-77-51-4-36-32-75-12-94-81-47-99-70-40-13-2-45-28-33-82-54-11-26-85-34-19-56-6-8-86-50-76-59-61-42-3-64-65-25,1866878,13146,17646,30792
nn,kroA100,67-84-38-29-95-77-51-4-36-32-75-12-94-81-49-43-72-68-63-39-53-1-80-24-60-50-86-8-6-56-19-11-26-85-34-61-59-76-22-97-90-44-31-10-14-16-73-20-58-71,0-62-5-48-89-9-83-35-37-23-17-78-52-87-15-21-93-69-65-64-3-96-55-79-30-88-41-7-91-74-18-25-98-46-92-27-66-57-54-82-33-28-45-2-42-13-70-40-99-47,3174593,12151,16957,29108
nn,kroA100,35-37-23-17-78-52-87-15-21-93-69-65-64-3-96-55-79-30-88-41-7-91-0-62-5-48-89-9-83-71-20-73-58-16-14-10-31-90-97-22-44-46-92-27-66-57-60-24-80-68,63-39-53-1-43-49-72-67-84-38-29-95-77-51-4-36-32-75-12-94-81-47-99-70-40-13-2-45-28-33-82-54-11-26-85-34-19-56-6-8-86-50-76-59-61-42-74-18-25-98,3062802,12500,19114,31614
nn,kroA100,31-10-14-16-73-20-58-71-9-83-35-37-23-17-78-52-87-15-21-93-69-65-64-3-96-55-79-30-88-41-7-91-0-62-5-48-89-18-74-25-98-46-90-97-22-44-59-61-76-19,40-70-99-47-13-2-45-28-33-82-54-11-26-85-34-56-6-8-86-50-60-24-80-68-72-49-43-1-53-39-63-67-84-38-29-95-77-51-4-36-32-75-12-94-81-57-27-92-66-42,2288534,14877,13312,28189
nn,kroA100,80-24-60-50-86-8-6-56-19-11-26-85-34-61-59-76-22-97-90-44-31-10-14-16-73-20-58-71-9-83-35-37-23-17-78-52-87-15-21-93-69-65-64-3-96-55-79-30-88-41,45-2-42-28-13-70-40-99-47-51-77-95-4-36-32-75-12-94-81-49-43-72-67-84-38-29-33-82-54-57-27-92-66-0-62-5-48-89-18-74-91-7-46-98-25-53-39-63-68-1,4009587,10298,19556,29854
nn,kroA100,48-5-62-0-91-7-41-88-30-79-55-96-74-18-52-78-17-23-37-35-98-83-9-71-20-73-58-16-14-10-31-90-97-22-44-46-92-27-66-57-60-24-80-68-72-49-43-1-53-39,64-65-3-25-69-21-15-87-93-89-76-59-61-85-26-11-19-56-6-8-86-50-54-82-33-28-45-2-42-13-70-40-99-47-51-77-95-4-36-32-75-12-94-81-38-29-84-67-63-34,3816521,12520,17165,29685
nn,kroA100,6-8-56-86-50-60-24-80-68-72-49-43-1-53-39-63-67-84-38-29-95-77-51-4-36-32-75-12-94-81-47-99-70-40-13-2-45-28-33-82-54-11-26-85-34-19-61-59-76-22,89-48-5-62-0-91-7-41-88-30-79-55-96-74-18-52-78-17-23-37-35-98-83-9-71-20-73-58-16-14-10-31-90-97-44-46-92-27-66-57-42-3-64-65-25-69-21-15-87-93,2393022,11735,16072,27807
nn,kroA100,26-85-34-19-11-6-8-56-86-50-60-24-80-68-72-49-43-1-53-39-63-67-84-38-29-95-77-51-4-36-32-75-12-94-81-47-99-70-40-13-2-45-28-33-82-54-42-61-59-76,73-20-58-71-9-83-35-37-23-17-78-52-87-15-21-93-69-65-64-3-96-55-79-30-88-41-7-91-0-62-5-48-89-18-74-25-98-16-14-10-31-90-97-22-44-46-92-27-66-57,2356299,12340,14846,27186
nn,kroA100,27-92-57-60-24-80-68-72-49-43-1-53-39-63-67-84-38-29-95-77-51-4-36-32-75-12-94-81-47-99-70-40-13-2-45-28-33-82-54-11-26-85-34-19-56-6-8-86-50-76,3-64-65-25-69-21-15-87-93-17-23-37-35-98-83-9-71-20-73-58-16-14-10-31-90-97-22-44-46-62-5-48-89-78-52-18-74-96-55-79-30-88-41-7-91-0-66-59-61-42,2190087,11737,16296,28033
nn,kroA100,53-39-63-68-72-49-43-1-81-94-12-32-75-36-4-77-51-95-38-29-47-99-70-40-13-2-45-28-33-82-54-11-26-85-34-19-56-6-8-86-50-60-24-80-67-84-42-61-59-76,78-52-87-15-21-93-69-65-64-3-96-55-79-30-88-41-7-91-0-62-5-48-89-9-83-71-20-73-58-16-14-10-31-90-97-22-44-46-92-27-66-57-74-18-17-23-37-35-98-25,2513457,12855,14403,27258
nn,kroA100,8-6-56-86-50-60-24-80-68-72-49-43-1-53-39-63-67-84-38-29-95-77-51-4-36-32-75-12-94-81-47-99-70-40-13-2-45-28-33-82-54-11-26-85-34-19-61-59-76-22,42-57-27-92-66-0-62-5-48-89-9-83-71-20-73-58-16-14-10-31-90-97-44-46-91-7-41-88-30-79-55-96-74-18-52-78-17-23-37-35-98-93-21-15-87-69-65-64-3-25,2113724,11737,16674,28411
nn,kroA100,53-39-63-68-72-49-43-1-81-94-12-32-75-36-4-77-51-95-38-29-47-99-70-40-13-2-45-28-33-82-54-11-26-85-34-19-56-6-8-86-50-60-24-80-67-84-42-61-59-76,0-62-5-48-89-9-83-71-20-73-58-16-14-10-31-90-97-22-44-46-92-27-66-57-7-91-74-18-52-78-17-23-37-35-98-93-21-15-87-69-65-64-3-96-55-79-30-88-41-25,2096670,12855,14096,26951
nn,kroA100,38-29-95-77-51-4-36-32-75-12-94-81-49-43-72-67-84-80-24-60-50-86-8-6-56-19-11-26-85-34-61-59-76-22-97-90-44-31-10-14-16-73-20-58-71-9-83-35-37-23,3-64-65-25-69-21-15-87-93-17-78-52-18-74-96-55-79-30-88-41-7-91-0-62-5-48-89-46-92-27-66-57-68-63-39-53-1-33-82-54-45-2-42-28-13-70-40-99-47-98,2183421,12674,18063,30737
nn,kroA100,71-20-73-58-16-14-10-31-90-97-22-44-46-62-5-48-89-9-83-35-37-23-17-78-52-87-15-21-93-69-65-64-3-96-55-79-30-88-41-7-91-0-92-27-66-57-60-24-80-68,49-43-72-67-84-38-29-95-77-51-4-36-32-75-12-94-81-1-53-39-63-50-86-8-6-56-19-11-26-85-34-61-59-76-54-82-33-28-45-2-42-13-70-40-99-47-74-18-25-98,1409407,12108,18994,31102
nn,kroA100,31-10-14-16-73-20-58-71-9-83-35-37-23-17-78-52-87-15-21-93-69-65-64-3-96-55-79-30-88-41-7-91-0-62-5-48-89-18-74-25-98-46-90-97-22-44-59-61-76-19,4-36-77-51-95-38-29-47-99-70-40-13-2-45-28-33-82-54-11-26-85-34-56-6-8-86-50-60-24-80-68-72-49-43-1-53-39-63-67-84-81-94-12-32-75-42-57-27-92-66,1336719,14877,15239,30116
nn,kroA100,5-48-62-0-91-7-41-88-30-79-55-96-74-18-52-78-17-23-37-35-98-83-9-71-20-73-58-16-14-10-31-90-97-22-44-46-92-27-66-57-60-24-80-68-72-49-43-1-53-39,69-21-15-87-93-65-64-3-25-89-76-59-61-85-26-11-19-56-6-8-86-50-54-82-33-28-45-2-42-13-70-40-99-47-51-77-95-4-36-32-75-12-94-81-38-29-84-67-63-34,1354502,12527,17582,30109
nn,kroA100,59-61-76-22-97-90-44-31-10-14-16-73-20-58-71-9-83-35-37-23-17-78-52-87-15-21-93-69-65-64-3-96-55-79-30-88-41-7-91-0-62-5-48-89-18-74-25-98-46-92,24-80-60-50-86-8-6-56-19-11-26-85-34-54-82-33-28-45-2-42-13-70-40-99-47-51-77-95-4-36-32-75-12-94-81-49-43-72-67-84-38-29-68-63-39-53-1-66-27-57,1443754,14403,12160,26563
nn,kroA100,0-62-5-48-89-9-83-71-20-73-58-16-14-10-31-90-97-22-44-46-92-27-66-57-60-24-80-68-72-49-43-1-53-39-63-67-84-38-29-95-77-51-4-36-32-75-12-94-81-47,61-59-76-19-11-26-85-34-56-6-8-86-50-54-82-33-28-45-2-42-13-70-40-99-7-91-74-18-52-78-17-23-37-35-98-93-21-15-87-69-65-64-3-96-55-79-30-88-41-25,1591956,14094,17160,31254
nn,kroA100,9-83-71-20-73-58-16-14-10-31-90-97-22-44-46-62-5-48-89-78-52-87-15-21-93-69-65-64-3-96-55-79-30-88-41-7-91-0-92-27-66-57-60-24-80-68-72-49-43-1,37-23-17-35-98-18-74-25-53-39-63-67-84-38-29-95-77-51-4-36-32-75-12-94-81-47-99-70-40-13-2-45-28-33-82-54-11-26-85-34-19-56-6-8-86-50-76-59-61-42,1890448,12811,18949,31760
nn,kroA100,74-18-52-78-17-23-37-35-98-83-9-71-20-73-58-16-14-10-31-90-97-22-44-46-62-5-48-89-91-7-41-88-30-79-55-96-3-64-65-25-69-21-15-87-93-0-92-27-66-57,82-54-33-28-45-2-42-13-70-40-99-47-51-77-95-4-36-32-75-12-94-81-49-43-72-67-84-38-29-8-6-56-86-50-60-24-80-68-63-39-53-1-19-11-26-85-34-61-59-76,2401656,13541,12418,25959
nn,kroA100,26-85-34-19-11-6-8-56-86-50-60-24-80-68-72-49-43-1-53-39-63-67-84-38-29-95-77-51-4-36-32-75-12-94-81-47-99-70-40-13-2-45-28-33-82-54-42-61-59-76,69-21-15-87-93-17-23-37-35-98-83-9-71-20-73-58-16-14-10-31-90-97-22-44-46-62-5-48-89-78-52-18-74-96-55-79-30-88-41-7-91-0-92-27-66-57-3-64-65-25,2427500,12340,12781,25121
nn,kroA100,30-79-41-88-7-91-0-62-5-48-89-9-83-71-20-73-58-16-14-10-31-90-97-22-44-46-92-27-66-57-60-24-80-68-72-49-43-1-53-39-63-67-84-38-29-95-77-51-4-36,70-40-99-47-13-2-45-28-33-82-54-11-26-85-34-19-56-6-8-86-50-76-59-61-42-81-94-12-32-75-55-96-74-18-52-78-17-23-37-35-98-93-21-15-87-69-65-64-3-25,4429167,13342,19433,32775
nn,kroA100,19-11-26-85-34-61-59-76-22-97-90-44-31-10-14-16-73-20-58-71-9-83-35-37-23-17-78-52-87-15-21-93-69-65-64-3-96-55-79-30-88-41-7-91-0-62-5-48-89-18,47-99-70-40-13-2-45-28-33-82-54-6-8-56-86-50-60-24-80-68-72-49-43-1-53-39-63-67-84-38-29-95-77-51-4-36-32-75-12-94-81-57-27-92-66-46-74-25-98-42,2789999,11828,18518,30346
nn,kroA100,5-48-62-0-91-7-41-88-30-79-55-96-74-18-52-78-17-23-37-35-98-83-9-71-20-73-58-16-14-10-31-90-97-22-44-46-92-27-66-57-60-24-80-68-72-49-43-1-53-39,94-12-32-75-81-36-4-77-51-95-38-29-47-99-70-40-13-2-45-28-33-82-54-11-26-85-34-19-56-6-8-86-50-76-59-61-42-84-67-63-89-87-15-21-93-69-65-64-3-25,2386429,12527,17822,30349
nn,kroA100,48-5-62-0-91-7-41-88-30-79-55-96-74-18-52-78-17-23-37-35-98-83-9-71-20-73-58-16-14-10-31-90-97-22-44-46-92-27-66-57-60-24-80-68-72-49-43-1-53-39,86-50-56-6-8-11-26-85-34-19-61-59-76-54-82-33-28-45-2-42-13-70-40-99-47-51-77-95-4-36-32-75-12-94-81-38-29-84-67-63-89-87-15-21-93-69-65-64-3-25,2753121,12520,16075,28595
nn,kroA100,75-32-12-94-81-49-43-72-67-84-38-29-95-77-51-4-36-47-99-70-40-13-2-45-28-33-82-54-11-26-85-34-19-56-6-8-86-50-60-24-80-68-63-39-53-1-66-27-92-57,93-21-15-87-52-78-17-23-37-35-98-83-9-71-20-73-58-16-14-10-31-90-97-22-44-46-62-5-48-89-18-74-96-55-79-30-88-41-7-91-0-76-59-61-42-3-64-65-25-69,2333701,12707,15750,28457
nn,kroA100,30-79-41-88-7-91-0-62-5-48-89-9-83-71-20-73-58-16-14-10-31-90-97-22-44-46-92-27-66-57-60-24-80-68-72-49-43-1-53-39-63-67-84-38-29-95-77-51-4-36,76-59-61-85-26-11-19-56-6-8-86-50-54-82-33-28-45-2-42-13-70-40-99-47-32-75-12-94-81-34-35-37-23-17-78-52-87-15-21-93-69-65-64-3-96-55-74-18-25-98,2389460,13342,18491,31833
nn,kroA100,80-24-60-50-86-8-6-56-19-11-26-85-34-61-59-76-22-97-90-44-31-10-14-16-73-20-58-71-9-83-35-37-23-17-78-52-87-15-21-93-69-65-64-3-96-55-79-30-88-41,27-92-57-66-0-62-5-48-89-18-74-91-7-46-98-25-53-39-63-68-72-49-43-1-81-94-12-32-75-36-4-77-51-95-38-29-47-99-70-40-13-2-45-28-33-82-54-42-84-67,2113338,10298,18631,28929
nn,kroA100,94-12-32-75-81-49-43-72-67-84-38-29-95-77-51-4-36-47-99-70-40-13-2-45-28-33-82-54-11-26-85-34-19-56-6-8-86-50-60-24-80-68-63-39-53-1-66-27-92-57,52-78-17-23-37-35-98-83-9-71-20-73-58-16-14-10-31-90-97-22-44-46-62-5-48-89-18-74-96-55-79-30-88-41-7-91-0-76-59-61-42-3-64-65-25-69-21-15-87-93,2901346,12747,15809,28556
nn,kroA100,28-45-2-42-13-70-40-99-47-51-77-95-4-36-32-75-12-94-81-49-43-72-67-84-38-29-33-82-54-11-26-85-34-19-56-6-8-86-50-60-24-80-68-63-39-53-1-66-27-92,65-64-3-96-55-79-30-88-41-7-91-0-62-5-48-89-9-83-71-20-73-58-16-14-10-31-90-97-22-44-46-57-76-59-61-35-37-23-17-78-52-87-15-21-93-69-18-74-25-98,2169963,12480,16255,28735
nn,kroA100,83-9-71-20-73-58-16-14-10-31-90-97-22-44-46-62-5-48-89-78-52-87-15-21-93-69-65-64-3-96-55-79-30-88-41-7-91-0-92-27-66-57-60-24-80-68-72-49-43-1,81-94-12-32-75-36-4-77-51-95-38-29-47-99-70-40-13-2-45-28-33-82-54-11-26-85-34-19-56-6-8-86-50-76-59-61-42-84-67-63-39-53-74-18-17-23-37-35-98-25,2219238,12906,18415,31321
ls-random,kroA100,58-73-16-10-82-45-6-22-31-90-38-77-51-47-29-67-80-78-87-21-69-64-3-52-89-48-62-41-30-1-81-94-36-43-72-63-39-68-60-50-19-85-61-76-66-27-92-46-9-37,97-44-14-20-35-98-23-83-71-59-34-26-11-56-0-91-7-53-49-99-40-70-13-2-42-28-33-54-8-88-79-55-96-18-15-93-17-5-24-12-75-32-4-95-84-86-57-25-65-74,280841086,25475,27412,52887
ls-random,kroA100,33-67-81-94-12-36-4-49-72-7-96-17-23-76-82-2-99-47-51-32-75-80-90-20-0-91-63-39-53-41-55-65-21-15-87-98-58-16-14-44-22-61-11-6-86-92-27-95-77-28,89-52-78-37-35-73-10-31-97-46-88-30-79-74-18-48-5-42-40-70-13-29-38-84-43-1-68-19-26-85-34-59-71-83-93-69-25-64-3-66-45-54-8-56-50-24-60-57-62-9,145851625,29202,24497,53699
ls-random,kroA100,42-26-46-9-83-20-73-16-10-57-50-6-82-54-59-35-17-52-21-69-65-64-96-43-94-12-32-38-84-67-63-39-80-19-85-34-61-76-0-62-5-79-88-72-95-77-40-70-13-2,24-37-23-78-18-89-90-56-8-86-60-66-27-92-91-74-3-25-55-30-41-7-48-71-31-44-97-22-11-33-45-28-99-47-51-75-81-1-53-68-14-58-98-93-15-87-49-36-4-29,98399297,25407,28179,53586
ls-random,kroA100,8-33-28-2-11-90-31-14-20-98-37-23-83-62-66-53-1-43-49-80-86-56-19-85-76-97-5-52-3-96-4-36-12-81-88-64-65-27-13-47-29-72-68-7-15-21-93-78-92-50,41-39-63-94-75-32-51-77-95-38-84-67-24-22-44-59-61-26-34-16-35-17-87-69-25-91-57-60-6-82-45-99-70-40-42-54-10-58-73-71-9-46-0-48-89-18-74-55-79-30,139465950,31396,22834,54230
ls-random,kroA100,39-0-46-62-9-83-71-10-16-58-98-93-87-52-89-48-91-55-74-18-17-23-37-79-41-88-38-4-95-40-2-28-82-54-56-19-34-59-22-97-57-60-72-43-49-84-24-80-1-63,21-15-30-53-68-67-11-26-85-6-8-33-13-70-99-47-29-51-77-36-32-75-12-94-81-27-92-5-78-35-20-73-14-31-44-90-76-61-42-45-86-50-66-7-96-3-64-25-65-69,99173854,22095,21275,43370
ls-random,kroA100,19-32-94-43-63-71-37-98-14-34-42-99-2-45-61-58-23-17-9-5-48-74-91-46-90-97-22-76-55-30-41-27-92-0-18-52-21-69-65-64-96-60-6-82-33-77-47-54-11-26,49-12-75-81-66-89-83-35-62-57-95-51-4-36-38-67-84-29-70-40-13-28-44-10-16-73-20-3-25-79-88-68-72-1-53-39-7-87-15-93-78-31-59-85-56-8-86-50-24-80,65251136,29573,27343,56916
ls-random,kroA100,36-33-82-54-8-49-1-81-75-32-74-52-78-89-5-62-46-59-34-11-86-57-92-7-79-88-39-63-80-24-50-76-22-44-10-58-20-9-83-37-23-17-87-15-64-28-2-47-51-4,26-85-61-31-14-16-73-71-90-97-60-68-72-43-94-12-77-95-29-38-67-53-30-55-41-66-84-13-99-70-40-42-45-6-0-48-18-35-98-93-21-69-65-25-3-96-91-27-56-19,76199436,24699,23977,48676
ls-random,kroA100,95-81-1-43-84-82-4-36-32-75-94-72-68-57-18-64-25-65-69-83-71-97-19-11-54-6-8-56-88-30-96-74-53-63-73-58-31-22-34-26-85-76-87-21-15-5-42-99-47-77,66-80-13-40-70-38-67-0-91-7-41-79-55-3-89-48-62-86-33-29-51-12-49-39-9-35-20-10-44-90-59-61-45-2-28-78-52-93-17-23-37-98-46-60-24-50-14-16-92-27,111648750,30328,29879,60207
ls-random,kroA100,82-8-56-50-24-63-53-36-4-29-67-80-93-69-25-3-52-89-48-5-0-92-27-66-41-88-30-79-74-91-62-71-37-98-35-73-28-13-70-40-47-32-75-12-60-14-44-61-19-11,16-58-20-83-9-10-85-26-54-6-78-87-15-21-96-68-95-77-51-99-7-18-17-23-33-45-2-42-34-59-46-65-64-55-39-1-43-49-72-57-31-90-97-22-76-86-81-94-38-84,115679085,25700,34299,59999
ls-random,kroA100,75-12-81-80-60-27-92-86-47-70-40-2-42-8-62-5-91-7-63-43-36-4-38-30-79-3-69-52-18-66-67-95-77-51-29-54-11-22-97-31-16-20-71-37-23-17-89-41-88-94,28-84-49-39-53-1-32-99-13-26-85-34-61-76-59-44-10-14-58-73-83-35-98-93-21-65-74-56-6-19-90-46-9-78-87-15-48-0-57-24-72-68-55-25-64-96-50-82-33-45,74334755,28247,26175,54422
ls-random,kroA100,95-77-51-82-26-85-19-61-22-97-89-48-91-7-41-68-47-99-40-13-56-83-87-15-52-96-39-43-12-75-32-36-84-24-57-92-90-31-10-73-20-23-17-93-21-69-25-88-53-49,37-78-18-55-79-66-27-0-62-5-63-72-1-30-64-65-3-74-46-76-60-80-50-86-8-6-28-29-38-4-94-81-67-11-59-44-14-16-34-42-70-2-45-33-54-58-71-9-35-98,87840613,26421,26443,52864
ls-random,kroA100,37-23-91-41-88-30-79-25-3-96-27-57-92-62-5-17-93-21-87-52-7-39-63-80-8-33-28-45-40-70-99-38-81-1-68-60-50-56-6-19-85-34-59-22-97-46-10-71-9-83,90-35-98-48-0-29-47-13-54-11-26-61-44-14-16-78-15-69-74-66-94-12-75-32-95-2-42-82-86-76-31-58-73-20-89-18-65-64-55-53-43-77-51-4-36-49-72-67-84-24,63895719,20543,28065,48608
ls-random,kroA100,79-88-43-49-67-84-45-42-26-76-74-65-64-25-55-68-4-95-82-54-11-59-22-97-46-48-69-15-93-17-37-58-10-90-13-40-70-47-75-1-53-39-24-8-6-56-50-57-91-41,33-19-85-61-44-31-73-35-98-23-83-63-81-94-12-32-36-77-51-99-2-34-14-16-20-71-7-30-96-3-21-87-89-92-60-80-29-38-72-66-27-0-62-5-18-52-78-9-86-28,94857558,27616,26405,54021
ls-random,kroA100,30-79-96-64-21-93-17-23-83-9-71-22-61-34-26-82-4-36-67-80-24-74-48-50-29-95-51-99-2-45-19-76-14-16-58-20-10-68-1-53-41-18-52-37-35-49-32-94-81-88,13-47-38-84-72-43-12-75-77-28-33-54-11-85-59-44-31-46-0-91-5-62-73-98-78-87-15-69-89-90-97-56-86-57-92-27-7-3-65-25-55-66-39-63-60-8-6-42-40-70,70871957,30005,22706,52711
ls-random,kroA100,61-45-40-99-47-13-2-28-24-86-76-22-90-57-63-53-96-3-69-21-87-78-89-9-58-14-10-31-8-33-82-11-98-23-62-5-74-91-92-27-94-12-4-77-67-88-79-0-46-59,17-83-71-44-16-73-20-52-65-64-25-55-30-39-1-81-75-32-36-84-80-41-18-15-93-48-7-66-68-43-49-72-60-50-56-6-19-26-54-29-38-95-51-70-42-85-34-97-35-37,80210806,27876,24786,52662
ls-random,kroA100,15-87-74-91-27-38-77-75-1-43-49-72-67-82-54-26-11-33-45-99-70-2-44-14-16-10-92-60-24-86-6-56-61-59-76-22-58-20-71-62-5-48-35-98-78-7-30-79-55-69,28-42-34-85-19-57-66-88-41-3-64-65-25-94-32-12-81-68-97-90-31-73-46-0-63-39-53-21-93-17-23-37-83-9-84-36-4-47-40-13-51-95-29-80-89-52-18-96-50-8,65159425,22800,31347,54147
ls-random,kroA100,24-66-0-5-48-9-83-37-98-71-73-22-59-92-27-91-74-3-89-17-21-69-65-30-7-86-61-19-42-70-99-2-33-6-56-8-81-12-32-4-95-13-29-38-84-67-43-1-39-80,23-35-40-47-51-77-36-75-94-49-72-68-50-85-34-26-11-54-82-45-28-60-57-41-88-79-55-96-20-58-78-52-25-64-18-62-46-97-90-31-10-16-14-44-76-63-53-87-15-93,84226954,23118,24979,48097
ls-random,kroA100,91-27-92-10-14-16-58-73-20-9-89-5-57-56-6-28-29-49-72-63-88-30-55-74-35-98-37-17-87-21-69-65-64-3-18-90-61-26-11-82-33-42-13-47-51-4-32-81-43-7,50-86-8-54-45-2-40-70-99-77-95-36-38-84-76-97-71-83-23-78-52-48-62-24-80-68-39-53-46-31-44-22-59-34-85-19-67-12-75-94-1-41-79-25-93-15-96-0-66-60,69991303,21628,24210,45838
ls-random,kroA100,37-17-93-69-15-87-52-78-19-33-28-45-82-11-86-60-97-22-59-34-85-2-70-13-29-84-7-55-79-30-53-1-12-36-38-91-3-64-65-5-62-27-80-67-49-68-71-20-73-98,72-94-81-43-89-21-23-83-9-35-58-10-31-90-24-63-39-66-92-57-76-61-26-56-50-0-48-18-25-96-74-41-88-42-40-99-47-51-77-4-32-75-95-54-6-8-44-14-16-46,53155598,27386,28111,55497
ls-random,kroA100,11-34-59-22-44-20-17-37-58-16-14-90-39-53-1-43-72-8-54-82-42-2-70-47-51-4-36-75-12-81-29-76-46-78-87-69-65-64-25-55-79-30-88-41-7-91-66-57-86-6,3-52-15-21-93-23-83-9-35-98-73-97-77-95-38-24-80-68-49-94-32-28-45-33-19-56-50-92-27-60-13-99-40-0-74-96-63-67-84-26-85-61-62-5-48-31-10-71-89-18,93215967,21391,27807,49198
ls-random,kroA100,12-14-16-98-35-20-31-22-11-28-99-47-60-18-87-21-69-64-3-74-54-45-2-42-26-34-61-92-91-7-55-79-67-77-51-62-83-37-23-17-78-52-89-48-66-53-49-38-36-32,13-70-40-6-27-5-71-9-93-15-65-25-96-90-44-59-85-19-82-33-84-63-39-46-73-58-10-57-24-80-72-68-88-30-41-0-97-76-56-8-86-50-43-1-81-94-75-4-95-29,67773651,32233,25238,57471
ls-random,kroA100,21-69-15-87-52-57-60-50-86-56-6-28-2-11-26-34-61-97-90-31-10-20-35-89-18-3-96-55-41-7-66-24-39-63-72-49-36-77-51-99-70-40-42-76-22-44-16-98-37-93,30-94-12-75-32-4-95-29-33-8-19-59-14-46-0-91-79-74-83-9-48-5-62-92-27-68-43-81-38-47-13-45-82-54-85-23-17-65-25-64-78-71-73-58-80-84-67-1-53-88,85561596,19845,26699,46544
ls-random,kroA100,10-31-34-42-13-47-51-77-92-78-93-15-25-64-3-96-74-46-22-61-85-11-56-67-84-32-75-12-1-63-68-60-54-82-29-38-49-79-55-7-91-0-62-5-48-9-35-20-73-14,97-44-16-58-71-66-53-39-80-24-57-41-30-88-50-99-70-40-33-6-8-86-81-94-95-28-2-45-26-59-90-18-52-65-69-21-87-17-23-37-98-83-89-27-72-43-36-4-19-76,75467685,23970,27082,51052
ls-random,kroA100,35-9-71-34-85-11-45-2-40-99-8-23-93-15-87-89-48-66-63-39-53-1-12-75-47-13-28-74-96-64-65-25-55-79-30-41-0-92-60-24-49-38-82-54-22-97-90-44-10-58,78-52-5-62-27-50-84-67-72-68-80-57-7-88-43-95-77-29-86-20-98-37-83-91-81-94-32-36-4-51-70-42-33-76-14-16-73-31-56-6-19-26-61-59-46-18-3-69-21-17,75071245,26620,27886,54506
ls-random,kroA100,58-53-39-63-43-81-36-4-7-15-21-93-87-78-48-91-0-90-97-76-61-85-19-74-18-65-64-96-55-41-38-95-51-28-11-56-6-8-80-67-29-47-99-45-50-60-62-9-37-98,34-44-31-10-14-16-73-20-92-57-68-72-49-1-3-25-69-52-17-89-5-27-86-24-66-79-30-88-33-2-42-82-54-26-59-22-35-23-83-71-46-84-94-12-75-32-77-40-70-13,58650843,27404,27599,55003
ls-random,kroA100,23-90-86-50-57-66-41-30-88-24-8-28-13-99-40-2-45-54-19-76-46-62-15-69-52-48-92-68-63-39-96-74-9-71-20-16-67-49-43-81-75-32-12-38-29-11-85-34-98-37,84-80-60-27-0-5-87-93-21-65-25-55-79-7-91-82-33-42-70-47-94-1-53-89-78-17-83-97-22-59-61-26-56-44-14-58-35-73-10-31-6-51-4-36-72-3-64-18-95-77,54118727,27567,31430,58997
ls-random,kroA100,26-2-40-70-99-4-12-75-94-81-6-8-86-39-53-25-69-93-87-78-98-83-71-59-19-51-77-56-44-14-58-73-10-90-80-72-67-28-45-88-79-55-41-60-50-27-91-5-46-85,37-35-20-16-34-11-54-42-13-47-29-95-36-32-38-33-82-84-49-43-1-63-30-96-3-64-65-52-15-21-17-23-62-0-66-68-24-76-61-22-31-9-89-48-97-57-92-7-74-18,82781604,30518,23607,54125
ls-random,kroA100,51-32-75-81-1-43-49-67-84-50-90-31-14-16-5-74-62-92-29-4-36-66-91-7-53-39-72-80-60-46-9-17-23-44-34-2-28-82-11-26-97-52-87-15-69-65-64-3-55-77,19-59-22-20-71-48-18-89-83-73-58-10-76-86-94-12-95-38-68-63-88-30-79-41-96-25-37-98-35-61-85-54-33-45-42-13-70-40-99-47-24-57-27-0-21-93-78-56-8-6,54605207,29264,26621,55885
ls-random,kroA100,8-82-34-10-83-21-69-96-41-39-43-49-84-67-27-92-0-91-48-89-52-87-93-37-98-35-58-14-44-59-61-97-71-9-62-46-57-29-2-70-47-4-36-12-94-1-68-80-60-56,18-78-23-17-15-65-25-64-3-74-90-22-76-19-86-24-63-53-72-54-33-28-45-42-13-40-99-51-77-95-31-16-73-20-5-7-66-50-6-11-85-26-38-32-75-81-88-30-79-55,101538363,24108,23506,47614
ls-random,kroA100,24-50-19-26-85-59-97-46-0-92-8-33-70-40-14-16-56-6-82-45-2-95-84-76-22-31-10-71-5-18-69-93-23-98-91-30-88-39-68-57-66-64-25-79-1-94-12-32-36-72,3-65-21-15-87-52-42-99-47-29-49-43-67-80-86-54-28-13-4-75-81-63-53-7-78-17-37-35-90-44-61-34-11-60-27-62-48-55-96-74-89-20-73-58-83-9-51-77-38-41,62218039,29980,29719,59699
ls-random,kroA100,12-90-44-35-37-9-46-62-5-74-18-64-25-65-89-71-20-10-16-58-98-93-69-79-41-97-59-42-2-45-54-11-34-85-56-86-57-24-38-36-77-51-33-8-63-39-53-49-94-75,32-4-72-68-88-30-60-80-28-13-47-95-29-83-23-73-14-31-50-84-67-66-7-91-55-96-3-15-21-17-22-61-40-70-99-78-87-52-48-0-27-92-76-19-26-82-6-43-1-81,89842461,25704,32050,57754
ls-random,kroA100,13-29-22-20-71-37-93-65-25-64-3-87-78-9-90-97-92-68-49-32-4-77-95-38-84-6-11-26-89-52-18-74-30-88-39-63-66-7-41-1-47-70-40-34-61-73-58-16-14-28,80-67-72-27-0-62-46-50-86-8-56-76-35-98-23-17-83-19-33-51-36-12-75-94-81-43-53-31-10-44-59-85-54-82-42-99-2-45-60-79-55-96-5-48-15-21-69-91-57-24,75302024,30161,26958,57119
ls-random,kroA100,68-51-99-2-45-85-59-37-23-93-69-25-3-18-39-1-79-96-74-82-54-11-22-9-71-20-14-31-44-95-77-36-32-12-81-43-87-78-48-62-56-6-8-86-50-92-27-30-88-66,40-42-33-91-7-80-24-61-76-97-10-16-83-89-17-98-35-58-73-46-90-57-60-63-53-41-55-64-65-21-15-52-5-0-84-29-28-26-34-19-67-72-49-94-75-4-38-47-13-70,61109483,32199,25894,58093
ls-random,kroA100,51-77-29-55-64-65-78-83-73-58-16-10-44-22-76-19-82-33-50-88-30-81-12-36-4-95-38-7-96-74-52-21-93-17-62-0-92-80-39-43-84-86-56-11-26-34-42-70-99-47,40-13-1-53-63-97-90-31-14-35-98-37-23-89-18-87-15-69-25-3-79-41-66-57-60-24-68-72-67-49-94-75-32-8-6-54-28-45-85-61-59-46-20-71-9-48-5-91-27-2,69770779,25791,23496,49287
ls-random,kroA100,91-0-92-50-19-59-44-10-73-58-35-9-20-57-68-67-84-8-56-46-5-89-79-30-47-40-42-26-85-66-7-55-65-21-93-52-97-22-24-80-72-49-81-94-36-29-43-39-88-41,34-61-76-60-63-1-53-96-18-74-27-95-4-32-75-12-38-86-90-31-83-17-23-37-98-16-14-71-48-3-64-25-69-15-87-78-62-6-82-33-45-2-13-70-99-51-77-28-54-11,58880381,28944,24576,53520
ls-random,kroA100,10-31-46-68-32-94-1-63-53-41-91-0-60-70-99-47-38-67-86-8-54-33-95-36-51-2-42-56-57-88-79-55-52-78-35-73-20-89-74-96-25-69-21-93-87-11-26-34-44-16,65-64-30-81-12-75-4-80-24-27-92-62-71-58-14-90-97-22-76-85-82-45-28-13-40-77-29-84-72-49-43-39-66-7-18-15-17-23-37-98-83-9-59-61-19-6-50-5-48-3,87700723,28089,23859,51948
ls-random,kroA100,77-4-36-12-75-94-92-0-5-15-78-83-71-46-56-33-45-82-54-86-50-67-43-1-38-70-2-42-61-59-44-73-35-98-37-21-65-3-96-79-30-88-68-24-60-76-22-14-16-97,29-28-57-7-41-53-81-32-51-95-84-49-72-8-19-85-26-11-6-80-63-39-66-27-90-31-10-62-91-55-25-64-23-58-20-9-89-48-74-18-52-87-69-93-17-34-13-40-99-47,56204971,25781,25493,51274
ls-random,kroA100,18-52-93-17-37-60-67-84-33-86-30-55-25-65-69-15-83-9-71-56-6-54-82-42-2-70-13-85-14-58-73-0-39-1-94-32-36-51-95-49-72-63-66-92-97-22-44-31-5-48,34-26-11-45-28-40-99-47-77-4-75-12-81-43-68-27-35-98-23-78-89-62-76-61-59-90-10-16-20-46-57-24-80-74-87-21-64-53-38-29-8-50-91-96-3-79-88-41-7-19,64974102,26582,27821,54403
ls-random,kroA100,16-58-73-20-46-92-39-63-68-31-10-44-85-45-33-54-19-56-57-88-30-79-61-59-22-97-89-78-93-15-64-3-96-41-72-84-24-71-23-17-7-43-49-81-38-47-99-40-13-2,67-94-12-75-32-36-4-95-50-90-83-9-5-62-76-11-26-34-69-21-37-98-35-14-29-51-77-55-25-65-18-74-91-0-27-66-1-53-52-87-48-60-28-70-42-82-6-8-86-80,59496245,29851,32639,62490
ls-random,kroA100,52-5-91-74-3-64-65-25-55-92-60-13-70-40-99-84-72-88-79-30-53-38-47-51-95-75-12-49-43-31-20-58-14-61-19-45-28-33-8-6-26-34-59-22-90-71-93-21-15-87,97-76-11-56-86-50-24-68-63-39-1-81-94-32-36-4-77-29-67-80-57-27-66-41-96-18-69-23-37-98-35-83-85-42-2-82-54-46-9-17-78-89-48-7-0-62-73-16-10-44,103627042,25569,21458,47027
ls-random,kroA100,61-59-44-87-15-52-48-5-65-25-96-55-30-88-94-75-32-4-77-29-76-97-9-78-93-35-58-10-34-11-19-73-20-71-62-91-0-27-8-45-42-13-40-70-47-38-49-80-24-86,7-3-64-79-41-60-50-56-26-85-14-16-28-2-99-51-95-36-12-81-43-1-53-66-83-37-98-31-72-67-84-33-82-54-6-22-90-46-74-18-89-23-17-21-69-92-57-68-63-39,80665601,26310,27955,54265
ls-random,kroA100,11-56-86-84-67-66-0-62-9-71-14-10-31-22-61-76-97-90-83-17-93-21-52-74-41-1-94-12-81-49-68-48-5-92-60-38-29-28-45-2-47-51-77-79-25-65-91-19-85-26,53-75-32-43-63-39-30-55-96-87-78-58-73-20-89-18-46-16-44-59-34-6-8-24-80-57-27-88-7-35-98-37-23-72-36-4-95-33-82-54-42-40-70-99-13-50-15-69-64-3,64800073,27046,29676,56722
ls-random,kroA100,66-63-39-53-88-30-7-96-18-10-16-31-90-97-3-65-21-15-17-83-22-60-24-38-4-77-29-13-40-2-33-11-34-85-19-56-8-86-67-94-1-43-68-9-23-37-35-73-46-92,6-50-57-74-52-69-93-87-78-98-14-44-80-81-95-51-36-32-75-12-47-99-70-42-45-5-48-91-41-79-55-25-64-89-71-58-20-62-0-27-72-49-84-28-82-54-26-61-59-76,68454443,24416,25177,49593
ls-random,kroA100,83-62-81-12-75-4-84-8-56-26-85-34-61-59-22-97-14-16-58-73-20-42-40-99-13-66-27-64-65-69-78-74-41-53-39-43-72-60-50-86-95-51-47-28-54-19-46-71-35-23,36-70-2-57-92-7-55-96-17-37-98-93-21-25-3-15-87-52-76-11-82-45-33-6-24-80-68-63-49-38-77-29-67-0-5-48-18-89-9-10-31-44-90-91-79-30-88-1-94-32,93062977,26800,26201,53001
ls-random,kroA100,9-71-20-98-21-64-3-18-52-17-23-97-61-19-42-70-99-2-54-11-57-66-68-80-60-90-10-58-14-76-77-47-13-33-82-56-86-50-27-91-7-41-67-84-75-1-53-88-96-48,85-26-45-28-62-89-65-25-74-5-46-44-22-59-34-40-51-95-29-38-92-0-83-35-37-78-55-79-30-24-8-6-72-63-39-43-81-94-12-32-49-69-93-15-87-36-4-31-73-16,64943751,27900,34645,62545
ls-random,kroA100,78-89-81-94-12-32-4-47-99-13-38-84-43-39-68-74-15-93-98-58-73-20-71-83-9-5-62-46-24-80-27-92-50-86-2-42-76-64-65-69-16-14-44-59-97-31-37-23-17-87,6-72-49-67-70-40-45-33-48-52-18-96-91-0-56-8-57-7-55-3-25-21-35-10-90-22-61-34-29-36-75-1-63-53-88-30-79-41-66-60-95-77-51-28-82-54-11-26-85-19,83120591,27566,26754,54320
ls-random,kroA100,0-92-27-66-94-32-47-28-76-31-10-16-58-73-20-71-52-25-96-41-7-50-56-19-85-6-8-67-68-53-1-81-36-4-95-5-87-15-93-37-82-45-13-99-40-42-34-22-97-46,38-70-2-33-86-60-57-91-30-88-39-43-12-75-77-51-29-54-11-26-61-59-44-83-9-72-49-80-24-48-78-89-62-90-14-35-98-23-17-21-69-65-64-3-18-74-55-79-63-84,66700608,28150,26114,54264
ls-random,kroA100,88-92-46-31-56-8-82-28-4-36-12-1-39-71-37-35-58-14-10-44-34-42-13-99-47-51-38-72-68-60-50-19-85-61-59-22-97-0-5-9-83-78-74-96-18-52-87-93-21-7,32-75-94-81-95-77-29-33-54-6-86-90-20-89-17-23-98-73-16-76-26-11-84-49-43-63-53-66-91-48-62-27-57-41-79-30-24-70-40-2-45-15-69-65-25-64-3-55-80-67,96778217,23475,28159,51634
ls-random,kroA100,66-49-94-75-51-29-62-17-93-69-79-88-39-63-68-80-60-57-90-20-73-16-34-85-61-44-31-71-35-89-5-67-84-40-2-45-28-7-25-65-3-96-92-6-82-54-76-87-15-52,91-53-72-24-86-11-26-42-13-33-8-48-18-74-55-41-32-12-81-1-9-83-10-14-70-99-47-58-98-37-23-97-22-36-4-77-95-38-43-30-64-21-78-46-59-19-56-50-27-0,81046068,33509,36441,69950
ls-random,kroA100,78-87-21-17-76-8-6-54-11-59-20-35-37-80-67-39-53-79-41-91-10-16-14-44-22-97-48-18-3-64-25-55-96-74-5-62-66-60-50-33-45-42-2-70-51-77-12-94-38-89,72-84-28-13-47-95-29-86-56-26-34-85-19-49-43-1-81-75-32-36-4-99-40-82-61-90-31-58-98-23-93-15-83-9-71-73-46-92-57-24-68-27-0-7-52-69-65-30-88-63,110604457,27155,23565,50720
ls-random,kroA100,87-93-21-65-96-55-79-30-72-43-81-36-4-51-95-67-80-27-9-98-37-23-78-91-7-63-1-88-41-57-50-86-28-13-99-47-33-82-6-8-56-71-20-14-22-61-85-0-48-52,35-58-34-26-11-54-29-77-70-40-2-42-45-19-10-73-16-44-59-76-84-38-49-68-39-53-94-12-75-32-97-90-31-46-62-92-60-24-66-5-74-18-89-83-17-3-64-25-69-15,131054602,25568,25799,51367
ls-random,kroA100,36-51-47-13-42-28-82-26-34-61-62-65-25-64-3-41-94-81-72-68-31-14-16-9-83-17-93-87-78-89-48-79-30-88-6-33-38-84-24-60-27-92-76-59-22-97-90-37-23-0,32-67-50-86-8-56-19-85-11-54-45-2-57-46-73-58-98-35-5-91-55-96-69-21-15-52-18-74-7-39-63-29-70-40-99-77-95-4-1-53-66-71-20-10-44-80-49-43-12-75,74180032,27872,24125,51997
ls-random,kroA100,7-96-55-41-39-63-67-29-28-24-57-27-71-83-78-87-17-23-98-58-16-14-31-90-46-48-74-18-3-64-25-69-52-66-68-72-81-94-38-47-13-42-26-85-6-86-50-61-22-97,59-34-54-82-33-45-2-11-19-92-62-0-53-43-49-95-77-51-4-36-32-75-12-1-5-89-93-37-35-10-44-40-70-99-84-15-21-65-79-30-88-91-9-20-73-60-80-8-56-76,130613860,23431,27937,51368
ls-random,kroA100,3-96-74-89-23-37-98-34-26-59-44-16-58-73-10-22-19-45-70-13-28-60-66-27-57-50-86-29-51-4-36-6-76-31-20-71-78-87-21-15-7-63-1-94-75-68-0-5-52-65,64-69-35-14-90-97-56-8-54-82-33-49-43-39-53-81-12-32-38-84-67-80-24-92-62-17-93-18-72-95-77-47-99-40-2-42-11-85-61-46-9-83-48-91-55-41-88-30-79-25,106214178,27448,24000,51448
ls-random,kroA100,77-47-99-13-42-28-33-34-90-46-21-69-60-24-67-38-76-44-31-16-71-35-98-83-5-89-78-52-74-55-88-7-0-27-92-50-56-11-6-8-86-3-25-53-63-68-72-43-81-36,32-75-12-94-1-41-96-64-65-91-66-84-95-4-51-29-82-54-45-2-70-40-26-14-73-20-9-15-93-37-58-10-97-22-59-61-85-19-80-57-62-48-23-17-87-18-79-30-39-49,114449325,27015,25890,52905
ls-random,kroA100,93-25-64-3-96-18-52-17-23-83-50-63-39-66-7-79-55-48-62-46-34-26-47-99-70-42-11-54-82-29-77-36-32-94-81-72-97-90-31-61-19-8-86-16-58-73-20-71-35-98,56-76-44-14-10-22-60-49-12-75-1-43-68-57-74-65-69-21-15-89-5-0-92-27-91-78-87-37-9-59-85-6-33-13-40-2-45-28-84-67-80-24-41-30-88-53-4-51-95-38,118826608,24602,26213,50815
ls-random,kroA100,53-7-41-88-30-79-55-96-48-5-97-34-85-42-2-99-47-24-57-64-65-25-1-43-72-6-56-59-44-16-58-20-90-67-12-36-95-38-9-23-17-15-89-27-92-11-54-82-33-39,40-70-91-74-18-3-52-78-87-69-21-93-83-73-10-46-84-77-29-28-45-13-51-4-81-49-68-62-37-98-35-71-0-66-63-94-75-32-80-60-50-86-8-19-76-22-31-14-61-26,90445646,30318,27657,57975
ls-random,kroA100,84-6-44-10-14-58-35-62-66-63-1-53-98-37-23-93-15-69-65-25-3-52-87-83-9-48-91-7-81-12-51-47-99-38-33-82-54-11-34-61-76-22-97-90-46-92-60-24-80-49,68-88-55-96-74-50-86-0-18-64-21-78-17-59-56-8-19-85-26-42-40-70-13-2-45-28-29-95-77-4-36-39-30-79-41-5-89-71-20-73-16-31-27-57-67-32-75-94-43-72,72441346,24458,24566,49024
ls-random,kroA100,46-66-68-84-13-99-70-42-45-30-55-18-89-23-37-98-10-44-56-32-75-81-49-72-80-50-71-9-93-87-15-21-69-64-5-11-54-82-33-29-51-77-4-39-63-19-34-61-59-22,96-3-25-65-52-78-17-35-83-28-2-40-47-95-6-8-86-60-57-58-73-20-27-53-1-94-12-36-38-43-67-24-97-90-31-14-16-62-79-88-41-7-91-0-92-26-85-76-48-74,101968273,28071,25887,53958
ls-random,kroA100,77-51-94-1-88-41-30-55-89-9-35-98-58-16-48-5-62-0-27-66-47-99-70-13-2-50-60-68-38-29-45-54-85-59-22-97-76-19-8-86-31-37-17-15-69-96-74-91-63-95,84-67-72-49-43-53-39-80-57-90-44-61-34-26-11-82-42-40-4-36-10-14-73-20-71-83-23-78-87-93-21-52-18-79-81-75-32-12-28-33-46-65-25-64-3-7-92-56-6-24,125211369,26106,26167,52273
ls-random,kroA100,13-5-48-46-22-59-76-8-50-60-65-64-3-30-39-1-81-94-12-32-80-97-90-16-37-17-21-69-87-9-54-33-95-77-51-4-43-7-96-74-18-52-89-66-63-72-84-47-99-40,42-70-2-28-29-49-68-55-25-15-93-78-83-91-27-92-57-56-11-26-85-34-44-31-61-19-82-45-41-79-88-53-75-36-38-58-35-98-23-71-20-73-24-67-6-86-0-62-10-14,99288691,30382,32494,62876
ls-random,kroA100,69-65-52-89-48-5-62-67-84-24-60-50-86-56-59-22-90-3-25-30-47-99-70-42-83-9-72-43-75-32-77-28-45-33-82-54-8-57-66-27-10-73-7-41-18-78-35-17-93-21,36-4-51-95-26-34-85-11-6-94-81-1-64-15-87-23-37-98-71-20-58-44-2-40-13-29-38-49-39-53-88-79-55-96-46-16-14-31-97-92-63-68-80-19-61-76-0-74-91-12,83413537,29453,28625,58078
ls-random,kroA100,68-95-51-47-29-38-80-89-21-69-65-88-1-12-32-36-90-10-73-20-71-5-91-45-70-40-42-34-61-59-46-0-92-27-57-39-63-43-49-72-50-22-44-35-37-78-18-74-55-41,75-94-30-25-64-3-96-79-66-56-6-19-76-97-83-17-23-98-58-31-26-85-14-16-11-54-2-99-13-28-24-60-86-8-82-33-77-4-84-67-62-9-93-15-87-52-48-7-53-81,64539059,29890,29241,59131
ls-random,kroA100,39-53-1-94-12-36-40-70-13-67-88-79-55-96-64-69-15-87-84-95-51-4-49-72-68-66-46-73-83-37-52-89-0-86-28-33-54-19-61-22-10-16-44-34-85-26-11-6-8-24,21-65-25-3-18-74-90-31-14-58-20-62-91-5-48-23-98-35-71-32-75-81-30-41-78-17-9-97-59-76-92-27-57-60-80-50-56-82-45-42-2-99-47-77-29-38-43-63-7-93,93517907,25753,26453,52206
ls-random,kroA100,48-83-98-58-14-33-47-99-42-45-53-88-3-25-93-87-18-55-79-30-26-34-59-76-22-44-10-31-90-8-86-60-57-27-92-0-74-7-24-80-4-32-94-43-72-38-77-51-82-11,81-1-39-63-68-67-50-56-19-85-61-97-46-62-89-15-21-52-91-66-28-13-2-54-6-84-29-70-40-95-36-49-5-17-23-37-35-73-16-20-71-9-78-69-65-64-96-41-12-75,124018518,29863,25441,55304
ls-random,kroA100,64-3-52-83-58-71-9-89-79-30-39-81-75-94-55-96-18-74-67-84-38-4-95-29-70-40-42-45-26-85-61-76-19-6-24-80-66-92-62-5-91-7-41-63-68-90-31-93-21-25,15-87-78-48-54-82-33-28-36-32-12-43-49-72-57-27-46-97-22-59-34-11-56-8-86-50-60-0-17-23-37-98-35-20-73-16-14-10-44-2-13-99-47-51-77-1-53-88-65-69,107651427,26627,22576,49203
ls-random,kroA100,42-74-96-25-65-89-9-71-10-16-76-19-54-36-32-12-81-49-72-43-1-53-62-44-22-59-26-45-2-28-95-4-38-84-20-98-37-23-55-30-88-66-86-8-68-39-63-67-70-40,50-75-94-80-24-60-57-78-87-15-93-17-35-58-14-33-51-77-29-6-56-92-27-0-46-73-83-21-69-52-61-34-85-13-99-47-82-11-41-79-7-91-3-64-18-48-5-31-90-97,86430602,29279,28695,57974
ls-random,kroA100,45-42-2-51-36-75-1-43-72-99-70-40-11-87-15-18-79-30-68-80-33-28-77-95-21-93-31-44-97-76-26-61-10-73-83-69-25-96-7-91-89-9-62-46-57-24-50-8-54-82,17-78-60-4-32-12-94-81-49-6-85-19-56-86-63-39-53-66-27-92-0-5-48-90-22-59-88-41-74-23-37-35-34-13-47-29-38-84-67-55-3-64-65-52-71-20-14-16-58-98,90999442,30730,27176,57906
ls-random,kroA100,10-71-9-48-91-62-73-58-46-92-57-68-72-29-2-70-51-4-32-95-38-67-80-3-64-65-21-15-23-35-0-27-66-63-49-75-81-1-41-96-18-76-86-8-56-19-34-59-14-16,43-28-13-99-40-42-74-25-69-83-20-31-12-94-88-30-79-55-7-26-85-44-5-89-52-78-37-98-17-93-87-6-33-45-82-54-11-61-22-90-97-50-84-36-77-47-24-60-39-53,77551030,26516,33057,59573
ls-random,kroA100,46-67-81-75-32-84-19-61-59-76-92-27-30-79-3-96-91-62-86-56-44-10-35-37-17-78-9-71-31-90-50-24-80-1-53-64-69-21-8-70-2-45-33-82-26-85-34-16-58-73,60-66-7-15-93-87-52-55-41-88-72-95-77-51-29-28-54-6-11-14-98-23-83-20-38-4-36-12-94-49-43-39-63-68-57-22-97-74-25-65-18-89-48-5-0-13-47-99-40-42,91740434,29024,28483,57507
ls-random,kroA100,42-44-16-20-71-18-96-91-0-66-43-94-12-75-32-36-95-47-28-33-82-11-26-85-34-61-97-31-46-27-57-24-84-49-63-30-79-64-17-23-37-35-98-93-21-87-6-2-70-40,83-58-73-19-54-45-99-13-86-50-74-3-55-72-67-38-29-8-56-76-78-15-69-25-65-52-89-48-62-10-14-59-51-77-4-81-1-53-39-68-80-60-22-90-92-88-41-7-5-9,87538909,24425,27927,52352
ls-random,kroA100,84-75-94-81-43-53-63-68-67-95-77-29-60-27-66-30-55-96-3-74-91-0-15-21-93-37-73-14-59-61-26-82-45-70-99-33-46-25-65-87-78-9-10-31-44-22-50-86-56-6,85-76-97-89-17-23-98-35-83-71-54-13-47-40-2-42-11-19-92-7-41-88-79-64-69-52-18-48-5-62-57-24-38-51-28-8-80-72-49-39-1-12-32-36-4-90-20-58-16-34,115291644,25039,27186,52225
ls-random,kroA100,7-27-92-0-5-89-96-60-68-63-39-53-43-72-80-50-28-47-51-77-38-90-10-14-34-42-45-82-58-98-37-23-20-31-49-81-94-75-12-36-99-13-56-21-69-65-25-55-79-30,93-15-87-18-74-16-44-22-76-8-6-33-54-11-26-85-61-19-86-24-67-84-4-95-29-57-91-48-62-46-97-59-2-40-70-32-1-66-88-41-3-64-52-78-17-83-9-71-73-35,113285094,29638,23313,52951
ls-random,kroA100,41-7-96-79-88-68-29-47-99-70-73-20-35-83-91-66-80-77-51-44-16-14-76-56-8-92-5-89-62-28-13-54-61-59-97-17-15-69-65-64-3-18-24-84-95-4-36-32-81-39,38-12-75-94-1-25-21-93-87-58-10-31-90-22-45-2-40-42-33-82-11-26-34-85-19-6-86-50-60-57-55-30-53-63-71-98-37-23-48-0-27-72-49-43-74-52-78-9-46-67,85981070,33192,28857,62049
ls-random,kroA100,68-60-76-97-44-10-58-73-20-83-98-23-93-64-3-74-55-72-49-99-70-40-34-85-77-95-88-30-79-41-27-92-46-48-5-66-39-63-1-81-94-32-47-13-2-42-8-56-50-80,90-86-6-29-51-4-36-38-0-52-87-78-9-57-24-67-12-75-54-11-26-19-61-59-22-71-65-25-69-21-15-89-62-82-33-45-28-84-43-53-7-91-96-18-17-37-35-16-14-31,75848371,25237,27645,52882
ls-random,kroA100,6-54-82-39-53-47-99-13-2-42-26-34-10-20-35-98-23-78-52-89-31-90-97-61-85-19-76-87-21-15-18-5-66-24-60-92-0-96-30-12-75-77-29-28-33-3-64-25-50-86,73-71-46-80-32-36-4-51-45-8-56-14-16-58-37-17-93-69-65-62-70-40-11-59-22-44-27-57-68-63-88-41-79-55-74-83-9-48-91-7-1-94-81-43-49-72-67-38-95-84,156615723,30549,30059,60608
ls-random,kroA100,52-21-23-78-89-7-39-63-72-67-8-6-86-50-80-68-88-30-25-65-64-3-1-81-94-75-32-36-54-26-61-59-76-22-71-20-73-10-14-44-90-46-92-19-82-47-77-29-38-18,24-84-12-4-51-95-16-58-98-35-9-83-37-17-93-87-48-5-62-0-27-56-33-28-45-11-85-34-97-31-15-69-96-74-91-13-99-70-40-2-42-57-66-55-79-41-53-43-49-60,80702907,25710,27177,52887
ls-random,kroA100,80-16-14-59-13-47-70-2-20-58-98-35-79-30-41-39-43-77-38-68-66-0-62-89-83-37-21-25-64-3-74-7-90-22-92-27-60-50-8-6-19-34-54-82-33-28-51-32-12-81,84-67-24-78-17-23-9-36-4-95-29-86-56-26-85-93-15-87-11-42-40-99-45-96-65-69-52-18-48-5-10-31-97-76-61-44-73-71-46-57-72-49-63-91-55-88-53-1-94-75,60784816,28450,34299,62749
ls-random,kroA100,52-78-93-15-69-25-41-29-47-51-77-4-32-49-46-20-58-9-96-79-30-88-80-6-45-13-70-40-42-82-54-19-44-35-23-83-72-43-63-0-5-89-97-76-61-50-60-57-91-18,12-75-94-81-1-68-92-10-16-14-31-90-22-59-86-24-66-7-55-3-64-65-74-48-98-37-17-21-87-71-73-62-27-53-39-38-95-99-2-28-33-84-67-8-56-85-34-26-11-36,69869684,29870,22918,52788
ls-random,kroA100,16-83-23-17-78-91-68-49-29-70-2-42-46-62-93-15-87-52-18-74-3-64-25-55-7-66-63-53-88-79-30-1-32-4-77-95-84-24-50-60-27-92-76-59-61-54-6-86-31-10,51-36-12-75-94-81-39-41-5-48-9-37-98-35-58-73-14-44-34-85-22-97-90-0-96-65-69-21-89-8-56-19-11-82-33-38-43-72-67-80-57-71-20-26-40-99-47-13-45-28,93597366,25708,24914,50622
ls-random,kroA100,58-14-10-44-22-92-27-96-55-79-41-68-43-94-75-32-77-38-84-50-60-46-35-37-87-52-89-76-56-6-59-61-85-11-28-2-13-47-29-49-72-18-3-64-69-21-83-9-71-20,25-30-88-66-70-40-99-81-1-53-39-63-67-86-8-54-82-45-42-26-34-19-33-95-51-4-36-12-7-74-15-93-98-23-17-78-48-5-62-73-16-31-90-97-24-80-57-0-91-65,138799129,23641,25124,48765
ls-random,kroA100,76-97-46-83-23-17-48-0-57-60-24-50-56-6-11-26-82-80-67-49-94-36-4-51-47-68-66-41-18-89-71-73-14-31-63-39-53-30-3-69-21-87-98-35-44-61-42-2-13-28,32-75-81-1-7-91-86-54-33-45-40-70-99-77-95-29-90-10-16-58-20-5-79-88-43-72-27-92-62-93-15-65-25-64-96-55-74-52-78-37-9-22-59-34-85-19-8-84-38-12,96257296,26131,25337,51468
ls-random,kroA100,98-37-78-52-64-65-21-15-91-72-29-95-75-12-49-84-28-70-2-83-93-87-56-8-45-42-26-16-71-9-31-44-90-27-53-39-68-80-50-86-22-97-46-5-48-74-55-41-7-35,18-17-23-89-62-59-61-76-96-3-69-25-79-30-88-63-1-43-67-38-77-47-99-40-85-34-14-10-58-73-20-92-66-81-94-32-36-4-51-13-33-24-60-6-19-11-54-82-57-0,76535518,29645,25861,55506
ls-random,kroA100,24-80-68-67-29-47-99-42-45-54-76-17-21-15-52-66-43-75-94-1-3-65-64-79-30-39-63-38-36-95-8-6-11-19-57-27-92-62-5-48-55-96-89-9-20-73-16-22-50-60,44-34-26-40-70-56-86-97-0-91-7-41-74-18-87-78-83-46-4-32-12-81-53-88-25-69-93-10-59-61-85-82-33-28-77-51-13-2-84-49-72-90-31-71-23-37-98-35-58-14,70115438,26476,28868,55344
ls-random,kroA100,22-90-52-69-65-3-74-96-55-79-88-53-39-1-38-28-76-78-21-93-37-83-20-61-85-42-2-70-99-47-77-95-4-36-68-41-91-5-0-27-60-80-86-6-33-82-54-11-19-59,13-57-66-30-7-46-16-14-44-34-26-97-87-15-25-64-18-9-35-98-23-17-89-48-62-31-10-58-73-71-92-63-43-81-49-72-67-84-29-45-8-56-50-24-94-12-75-32-51-40,93736697,23966,25549,49515
ls-random,kroA100,21-15-87-98-58-14-97-50-38-51-47-70-42-33-84-67-11-19-61-22-62-5-66-63-53-1-81-94-12-75-32-36-4-80-27-31-10-73-71-9-89-74-30-79-55-96-3-64-65-69,16-44-72-49-85-34-26-45-13-99-40-2-54-46-48-23-37-35-83-20-90-8-6-82-28-29-77-95-43-39-68-24-76-59-41-88-57-60-86-56-92-0-91-7-25-18-52-78-93-17,204319963,21642,27349,48991
ls-random,kroA100,8-83-35-44-40-70-2-45-5-18-55-79-41-27-92-80-67-38-81-49-88-3-64-65-21-15-87-78-89-76-56-19-34-61-59-22-90-31-10-14-20-71-9-62-0-50-86-95-51-29,24-11-26-85-98-37-23-17-48-91-7-47-99-13-42-28-33-68-63-39-53-66-57-60-84-36-4-77-6-16-58-73-97-54-82-46-52-93-69-25-96-74-30-1-12-32-75-94-43-72,84249203,28036,29918,57954
ls-random,kroA100,45-56-76-58-73-46-63-39-41-15-69-64-30-53-1-43-38-47-70-40-42-71-83-35-98-37-17-9-3-96-62-0-27-72-12-75-32-24-60-90-16-14-61-34-11-54-95-77-51-13,36-4-29-99-2-28-33-82-8-80-68-57-50-86-6-19-26-85-59-22-97-91-89-78-23-93-21-87-52-65-25-7-67-84-94-81-49-66-92-44-31-10-20-5-48-18-74-55-79-88,93448105,30416,23335,53751
ls-random,kroA100,4-36-81-1-48-78-17-98-35-10-97-82-2-28-33-86-60-24-80-72-67-38-32-75-12-43-66-7-91-0-92-56-19-76-44-14-16-58-83-62-46-13-40-70-47-96-3-25-15-18,11-54-6-8-63-39-53-88-30-41-27-50-45-42-99-29-84-37-23-93-21-69-87-5-95-77-51-94-49-68-57-31-90-22-61-34-59-73-20-71-74-55-79-64-65-52-89-9-85-26,89275977,31644,28364,60008
ls-random,kroA100,86-92-5-48-78-17-23-37-58-73-9-83-93-21-69-3-96-55-80-2-45-76-97-10-16-14-85-13-70-47-6-90-31-71-62-91-41-88-1-94-12-36-4-51-77-95-54-26-11-56,38-49-43-72-67-84-24-60-50-22-44-89-52-18-74-7-0-8-28-32-75-81-68-46-20-35-98-87-15-65-64-25-79-30-53-39-63-66-27-57-59-61-34-19-82-33-42-40-99-29,153276730,24690,24163,48853
ls-random,kroA100,74-91-57-60-24-53-63-72-11-19-76-92-87-15-69-93-9-31-44-22-85-54-82-40-70-29-49-43-30-55-7-8-6-33-2-13-77-32-75-12-94-84-97-90-73-58-35-37-23-89,41-88-79-25-65-21-17-98-16-14-95-4-36-38-67-50-86-28-45-42-26-34-18-64-3-96-81-51-47-99-10-20-71-83-78-52-48-46-59-61-56-80-68-1-39-66-27-0-62-5,98339682,26140,30111,56251
ls-random,kroA100,1-39-18-52-96-41-7-46-90-33-29-4-36-88-3-64-65-69-17-23-89-48-91-66-63-68-80-24-86-56-11-34-61-59-10-16-73-5-0-27-2-70-51-95-49-67-8-6-75-81,72-43-53-74-87-93-37-98-35-83-9-71-20-44-19-54-77-32-12-94-38-84-97-22-76-85-26-42-45-82-57-92-62-79-30-60-50-28-13-40-99-47-55-25-21-15-78-58-14-31,67330294,28606,30227,58833
ls-random,kroA100,38-29-2-42-56-78-21-69-25-63-49-80-50-86-73-58-16-8-4-32-75-94-53-55-96-74-52-89-85-26-54-82-45-13-47-51-77-95-67-0-5-62-61-34-44-20-37-23-83-84,39-43-72-6-97-46-65-64-3-41-7-9-98-35-71-19-11-33-28-70-40-99-36-12-81-1-88-30-79-18-87-15-93-17-48-91-66-60-57-27-92-76-59-22-14-10-31-90-24-68,76807239,33768,25061,58829
ls-random,kroA100,89-78-17-9-71-46-24-80-67-84-82-54-26-34-19-33-45-2-61-76-22-14-16-58-37-93-87-52-25-96-55-48-62-6-8-86-27-91-7-41-66-39-94-36-77-47-40-38-72-68,83-5-18-65-64-3-99-70-42-56-97-90-23-98-35-73-31-92-57-60-49-95-51-29-13-28-50-0-79-30-88-53-1-43-63-74-69-21-15-81-12-75-32-4-11-85-59-44-10-20,74085500,25556,31828,57384
ls-random,kroA100,97-11-82-6-8-56-52-93-21-55-7-0-27-80-50-86-33-2-13-99-47-84-67-51-4-12-94-43-1-79-64-65-74-5-62-66-63-72-46-20-73-90-61-85-34-44-35-17-89-9,18-78-83-23-37-98-71-48-92-57-60-38-75-32-36-77-95-29-28-45-54-26-19-24-68-49-81-39-53-88-41-30-25-69-15-87-58-16-14-10-31-22-59-76-42-40-70-91-96-3,75963508,28291,24375,52666
ls-random,kroA100,72-1-94-75-84-6-8-86-50-56-34-59-76-90-44-10-71-89-74-96-55-79-30-65-52-78-93-23-37-98-45-40-51-77-4-36-95-28-33-82-57-0-83-35-16-14-46-92-66-68,60-13-70-99-47-29-18-3-64-25-69-21-15-87-17-20-73-58-22-19-54-42-2-24-88-41-7-9-31-97-38-32-12-81-67-49-43-53-39-63-80-11-26-85-61-62-5-48-91-27,97561195,24287,26635,50922
ls-random,kroA100,27-53-63-43-81-49-72-68-9-83-17-98-35-73-10-44-59-76-86-60-80-67-38-36-95-29-33-8-6-11-26-19-5-48-18-52-89-46-34-42-70-13-87-21-69-30-41-62-0-92,91-78-15-93-71-97-40-99-47-88-79-55-96-3-64-25-65-74-7-66-24-84-77-51-4-32-75-12-94-1-39-90-31-20-23-37-58-16-14-22-61-85-54-45-2-28-82-56-50-57,91972846,26670,25849,52519
ls-random,kroA100,79-55-74-64-25-15-87-57-84-38-95-77-47-70-16-73-71-52-18-48-46-90-97-61-26-11-6-8-68-63-39-1-53-62-83-23-89-5-0-27-82-33-45-12-32-75-94-81-41-30,29-51-4-36-66-88-7-92-22-76-50-60-91-96-3-65-69-21-93-10-44-59-34-85-42-40-99-13-2-54-14-58-20-35-98-37-17-78-9-31-19-56-86-24-80-72-43-49-67-28,70091821,26859,24376,51235
ls-random,kroA100,97-90-60-68-63-55-18-74-0-50-38-32-12-94-1-27-71-20-58-98-15-69-25-3-82-33-45-2-13-28-84-67-49-72-8-56-11-76-10-9-17-52-5-40-70-51-77-26-34-61,21-93-73-59-85-19-86-24-80-39-53-43-36-4-95-29-6-22-14-16-35-37-23-83-88-30-79-96-87-78-89-48-54-42-99-47-75-81-57-62-46-31-44-92-66-41-7-91-64-65,67514190,31422,27331,58753
ls-random,kroA100,71-37-17-87-69-98-35-9-60-67-4-36-81-1-53-39-66-7-64-25-30-88-74-89-5-62-97-26-82-33-42-13-70-47-95-32-75-49-86-6-11-19-76-22-31-10-20-73-16-14,72-68-80-24-56-8-29-38-94-12-51-77-84-41-79-55-96-91-46-90-44-58-83-78-52-48-0-92-57-50-99-40-2-45-28-54-85-34-61-59-18-3-65-15-21-93-23-27-63-43,85541045,24078,24237,48315
ls-nn,kroA100,0-5-9-37-35-20-31-44-22-34-26-11-19-46-15-21-17-23-16-14-10-48-18-3-25-30-41-7-27-39-1-43-49-4-36-32-12-38-29-28-42-40-47-13-2-45-33-6-8-24,99-84-67-82-56-86-50-76-97-90-73-58-98-65-64-96-55-79-88-66-57-60-80-81-94-75-51-77-95-72-68-63-53-52-69-93-87-78-83-71-59-61-92-62-89-74-91-85-54-70,84237440,22153,25601,47754
ls-nn,kroA100,0-5-9-37-35-20-31-44-22-34-26-11-19-46-15-21-17-23-16-14-10-48-18-3-25-30-41-7-27-39-1-43-49-4-36-32-12-38-29-28-42-40-47-13-2-45-33-6-8-24,99-84-67-82-56-86-50-76-97-90-73-58-98-65-64-96-55-79-88-66-57-60-80-81-94-75-51-77-95-72-68-63-53-52-69-93-87-78-83-71-59-61-92-62-89-74-91-85-54-70,86135887,22153,25601,47754
ls-nn,kroA100,0-5-9-37-35-20-31-44-22-34-26-11-19-46-15-21-17-23-16-14-10-48-18-3-25-30-41-7-27-39-1-43-49-4-36-32-12-38-29-28-42-40-47-13-2-45-33-6-8-24,99-84-67-82-56-86-50-76-97-90-73-58-98-65-64-96-55-79-88-66-57-60-80-81-94-75-51-77-95-72-68-63-53-52-69-93-87-78-83-71-59-61-92-62-89-74-91-85-54-70,97778684,22153,25601,47754
ls-nn,kroA100,0-5-9-37-35-20-31-44-22-34-26-11-19-46-15-21-17-23-16-14-10-48-18-3-25-30-41-7-27-39-1-43-49-4-36-32-12-38-29-28-42-40-47-13-2-45-33-6-8-24,99-84-67-82-56-86-50-76-97-90-73-58-98-65-64-96-55-79-88-66-57-60-80-81-94-75-51-77-95-72-68-63-53-52-69-93-87-78-83-71-59-61-92-62-89-74-91-85-54-70,90348453,22153,25601,47754
ls-nn,kroA100,0-5-9-37-35-20-31-44-22-34-26-11-19-46-15-21-17-23-16-14-10-48-18-3-25-30-41-7-27-39-1-43-49-4-36-32-12-38-29-28-42-40-47-13-2-45-33-6-8-24,99-84-67-82-56-86-50-76-97-90-73-58-98-65-64-96-55-79-88-66-57-60-80-81-94-75-51-77-95-72-68-63-53-52-69-93-87-78-83-71-59-61-92-62-89-74-91-85-54-70,83910936,22153,25601,47754
ls-nn,kroA100,0-5-9-37-35-20-31-44-22-34-26-11-19-46-15-21-17-23-16-14-10-48-18-3-25-30-41-7-27-39-1-43-49-4-36-32-12-38-29-28-42-40-47-13-2-45-33-6-8-24,99-84-67-82-56-86-50-76-97-90-73-58-98-65-64-96-55-79-88-66-57-60-80-81-94-75-51-77-95-72-68-63-53-52-69-93-87-78-83-71-59-61-92-62-89-74-91-85-54-70,91428303,22153,25601,47754
ls-nn,kroA100,0-5-9-37-35-20-31-44-22-34-26-11-19-46-15-21-17-23-16-14-10-48-18-3-25-30-41-7-27-39-1-43-49-4-36-32-12-38-29-28-42-40-47-13-2-45-33-6-8-24,99-84-67-82-56-86-50-76-97-90-73-58-98-65-64-96-55-79-88-66-57-60-80-81-94-75-51-77-95-72-68-63-53-52-69-93-87-78-83-71-59-61-92-62-89-74-91-85-54-70,86766986,22153,25601,47754
ls-nn,kroA100,0-5-9-37-35-20-31-44-22-34-26-11-19-46-15-21-17-23-16-14-10-48-18-3-25-30-41-7-27-39-1-43-49-4-36-32-12-38-29-28-42-40-47-13-2-45-33-6-8-24,99-84-67-82-56-86-50-76-97-90-73-58-98-65-64-96-55-79-88-66-57-60-80-81-94-75-51-77-95-72-68-63-53-52-69-93-87-78-83-71-59-61-92-62-89-74-91-85-54-70,86884864,22153,25601,47754
ls-nn,kroA100,0-5-9-37-35-20-31-44-22-34-26-11-19-46-15-21-17-23-16-14-10-48-18-3-25-30-41-7-27-39-1-43-49-4-36-32-12-38-29-28-42-40-47-13-2-45-33-6-8-24,99-84-67-82-56-86-50-76-97-90-73-58-98-65-64-96-55-79-88-66-57-60-80-81-94-75-51-77-95-72-68-63-53-52-69-93-87-78-83-71-59-61-92-62-89-74-91-85-54-70,92152873,22153,25601,47754
ls-nn,kroA100,0-5-9-37-35-20-31-44-22-34-26-11-19-46-15-21-17-23-16-14-10-48-18-3-25-30-41-7-27-39-1-43-49-4-36-32-12-38-29-28-42-40-47-13-2-45-33-6-8-24,99-84-67-82-56-86-50-76-97-90-73-58-98-65-64-96-55-79-88-66-57-60-80-81-94-75-51-77-95-72-68-63-53-52-69-93-87-78-83-71-59-61-92-62-89-74-91-85-54-70,88506204,22153,25601,47754
ls-nn,kroA100,0-5-9-37-35-20-31-44-22-34-26-11-19-46-15-21-17-23-16-14-10-48-18-3-25-30-41-7-27-39-1-43-49-4-36-32-12-38-29-28-42-40-47-13-2-45-33-6-8-24,99-84-67-82-56-86-50-76-97-90-73-58-98-65-64-96-55-79-88-66-57-60-80-81-94-75-51-77-95-72-68-63-53-52-69-93-87-78-83-71-59-61-92-62-89-74-91-85-54-70,83423503,22153,25601,47754
ls-nn,kroA100,0-5-9-37-35-20-31-44-22-34-26-11-19-46-15-21-17-23-16-14-10-48-18-3-25-30-41-7-27-39-1-43-49-4-36-32-12-38-29-28-42-40-47-13-2-45-33-6-8-24,99-84-67-82-56-86-50-76-97-90-73-58-98-65-64-96-55-79-88-66-57-60-80-81-94-75-51-77-95-72-68-63-53-52-69-93-87-78-83-71-59-61-92-62-89-74-91-85-54-70,129276411,22153,25601,47754
ls-nn,kroA100,0-5-9-37-35-20-31-44-22-34-26-11-19-46-15-21-17-23-16-14-10-48-18-3-25-30-41-7-27-39-1-43-49-4-36-32-12-38-29-28-42-40-47-13-2-45-33-6-8-24,99-84-67-82-56-86-50-76-97-90-73-58-98-65-64-96-55-79-88-66-57-60-80-81-94-75-51-77-95-72-68-63-53-52-69-93-87-78-83-71-59-61-92-62-89-74-91-85-54-70,141734193,22153,25601,47754
ls-nn,kroA100,0-5-9-37-35-20-31-44-22-34-26-11-19-46-15-21-17-23-16-14-10-48-18-3-25-30-41-7-27-39-1-43-49-4-36-32-12-38-29-28-42-40-47-13-2-45-33-6-8-24,99-84-67-82-56-86-50-76-97-90-73-58-98-65-64-96-55-79-88-66-57-60-80-81-94-75-51-77-95-72-68-63-53-52-69-93-87-78-83-71-59-61-92-62-89-74-91-85-54-70,88737934,22153,25601,47754
ls-nn,kroA100,0-5-9-37-35-20-31-44-22-34-26-11-19-46-15-21-17-23-16-14-10-48-18-3-25-30-41-7-27-39-1-43-49-4-36-32-12-38-29-28-42-40-47-13-2-45-33-6-8-24,99-84-67-82-56-86-50-76-97-90-73-58-98-65-64-96-55-79-88-66-57-60-80-81-94-75-51-77-95-72-68-63-53-52-69-93-87-78-83-71-59-61-92-62-89-74-91-85-54-70,90796199,22153,25601,47754
ls-nn,kroA100,0-5-9-37-35-20-31-44-22-34-26-11-19-46-15-21-17-23-16-14-10-48-18-3-25-30-41-7-27-39-1-43-49-4-36-32-12-38-29-28-42-40-47-13-2-45-33-6-8-24,99-84-67-82-56-86-50-76-97-90-73-58-98-65-64-96-55-79-88-66-57-60-80-81-94-75-51-77-95-72-68-63-53-52-69-93-87-78-83-71-59-61-92-62-89-74-91-85-54-70,86115132,22153,25601,47754
ls-nn,kroA100,0-5-9-37-35-20-31-44-22-34-26-11-19-46-15-21-17-23-16-14-10-48-18-3-25-30-41-7-27-39-1-43-49-4-36-32-12-38-29-28-42-40-47-13-2-45-33-6-8-24,99-84-67-82-56-86-50-76-97-90-73-58-98-65-64-96-55-79-88-66-57-60-80-81-94-75-51-77-95-72-68-63-53-52-69-93-87-78-83-71-59-61-92-62-89-74-91-85-54-70,92459794,22153,25601,47754
ls-nn,kroA100,0-5-9-37-35-20-31-44-22-34-26-11-19-46-15-21-17-23-16-14-10-48-18-3-25-30-41-7-27-39-1-43-49-4-36-32-12-38-29-28-42-40-47-13-2-45-33-6-8-24,99-84-67-82-56-86-50-76-97-90-73-58-98-65-64-96-55-79-88-66-57-60-80-81-94-75-51-77-95-72-68-63-53-52-69-93-87-78-83-71-59-61-92-62-89-74-91-85-54-70,93088195,22153,25601,47754
ls-nn,kroA100,0-5-9-37-35-20-31-44-22-34-26-11-19-46-15-21-17-23-16-14-10-48-18-3-25-30-41-7-27-39-1-43-49-4-36-32-12-38-29-28-42-40-47-13-2-45-33-6-8-24,99-84-67-82-56-86-50-76-97-90-73-58-98-65-64-96-55-79-88-66-57-60-80-81-94-75-51-77-95-72-68-63-53-52-69-93-87-78-83-71-59-61-92-62-89-74-91-85-54-70,93932730,22153,25601,47754
ls-nn,kroA100,0-5-9-37-35-20-31-44-22-34-26-11-19-46-15-21-17-23-16-14-10-48-18-3-25-30-41-7-27-39-1-43-49-4-36-32-12-38-29-28-42-40-47-13-2-45-33-6-8-24,99-84-67-82-56-86-50-76-97-90-73-58-98-65-64-96-55-79-88-66-57-60-80-81-94-75-51-77-95-72-68-63-53-52-69-93-87-78-83-71-59-61-92-62-89-74-91-85-54-70,130473959,22153,25601,47754
ls-nn,kroA100,0-5-9-37-35-20-31-44-22-34-26-11-19-46-15-21-17-23-16-14-10-48-18-3-25-30-41-7-27-39-1-43-49-4-36-32-12-38-29-28-42-40-47-13-2-45-33-6-8-24,99-84-67-82-56-86-50-76-97-90-73-58-98-65-64-96-55-79-88-66-57-60-80-81-94-75-51-77-95-72-68-63-53-52-69-93-87-78-83-71-59-61-92-62-89-74-91-85-54-70,123542113,22153,25601,47754
ls-nn,kroA100,0-5-9-37-35-20-31-44-22-34-26-11-19-46-15-21-17-23-16-14-10-48-18-3-25-30-41-7-27-39-1-43-49-4-36-32-12-38-29-28-42-40-47-13-2-45-33-6-8-24,99-84-67-82-56-86-50-76-97-90-73-58-98-65-64-96-55-79-88-66-57-60-80-81-94-75-51-77-95-72-68-63-53-52-69-93-87-78-83-71-59-61-92-62-89-74-91-85-54-70,93457598,22153,25601,47754
ls-nn,kroA100,0-5-9-37-35-20-31-44-22-34-26-11-19-46-15-21-17-23-16-14-10-48-18-3-25-30-41-7-27-39-1-43-49-4-36-32-12-38-29-28-42-40-47-13-2-45-33-6-8-24,99-84-67-82-56-86-50-76-97-90-73-58-98-65-64-96-55-79-88-66-57-60-80-81-94-75-51-77-95-72-68-63-53-52-69-93-87-78-83-71-59-61-92-62-89-74-91-85-54-70,95411197,22153,25601,47754
ls-nn,kroA100,0-5-9-37-35-20-31-44-22-34-26-11-19-46-15-21-17-23-16-14-10-48-18-3-25-30-41-7-27-39-1-43-49-4-36-32-12-38-29-28-42-40-47-13-2-45-33-6-8-24,99-84-67-82-56-86-50-76-97-90-73-58-98-65-64-96-55-79-88-66-57-60-80-81-94-75-51-77-95-72-68-63-53-52-69-93-87-78-83-71-59-61-92-62-89-74-91-85-54-70,133478935,22153,25601,47754
ls-nn,kroA100,0-5-9-37-35-20-31-44-22-34-26-11-19-46-15-21-17-23-16-14-10-48-18-3-25-30-41-7-27-39-1-43-49-4-36-32-12-38-29-28-42-40-47-13-2-45-33-6-8-24,99-84-67-82-56-86-50-76-97-90-73-58-98-65-64-96-55-79-88-66-57-60-80-81-94-75-51-77-95-72-68-63-53-52-69-93-87-78-83-71-59-61-92-62-89-74-91-85-54-70,89864503,22153,25601,47754
ls-nn,kroA100,0-5-9-37-35-20-31-44-22-34-26-11-19-46-15-21-17-23-16-14-10-48-18-3-25-30-41-7-27-39-1-43-49-4-36-32-12-38-29-28-42-40-47-13-2-45-33-6-8-24,99-84-67-82-56-86-50-76-97-90-73-58-98-65-64-96-55-79-88-66-57-60-80-81-94-75-51-77-95-72-68-63-53-52-69-93-87-78-83-71-59-61-92-62-89-74-91-85-54-70,87291771,22153,25601,47754
ls-nn,kroA100,0-5-9-37-35-20-31-44-22-34-26-11-19-46-15-21-17-23-16-14-10-48-18-3-25-30-41-7-27-39-1-43-49-4-36-32-12-38-29-28-42-40-47-13-2-45-33-6-8-24,99-84-67-82-56-86-50-76-97-90-73-58-98-65-64-96-55-79-88-66-57-60-80-81-94-75-51-77-95-72-68-63-53-52-69-93-87-78-83-71-59-61-92-62-89-74-91-85-54-70,89267027,22153,25601,47754
ls-nn,kroA100,0-5-9-37-35-20-31-44-22-34-26-11-19-46-15-21-17-23-16-14-10-48-18-3-25-30-41-7-27-39-1-43-49-4-36-32-12-38-29-28-42-40-47-13-2-45-33-6-8-24,99-84-67-82-56-86-50-76-97-90-73-58-98-65-64-96-55-79-88-66-57-60-80-81-94-75-51-77-95-72-68-63-53-52-69-93-87-78-83-71-59-61-92-62-89-74-91-85-54-70,87339871,22153,25601,47754
ls-nn,kroA100,0-5-9-37-35-20-31-44-22-34-26-11-19-46-15-21-17-23-16-14-10-48-18-3-25-30-41-7-27-39-1-43-49-4-36-32-12-38-29-28-42-40-47-13-2-45-33-6-8-24,99-84-67-82-56-86-50-76-97-90-73-58-98-65-64-96-55-79-88-66-57-60-80-81-94-75-51-77-95-72-68-63-53-52-69-93-87-78-83-71-59-61-92-62-89-74-91-85-54-70,91077450,22153,25601,47754
ls-nn,kroA100,0-5-9-37-35-20-31-44-22-34-26-11-19-46-15-21-17-23-16-14-10-48-18-3-25-30-41-7-27-39-1-43-49-4-36-32-12-38-29-28-42-40-47-13-2-45-33-6-8-24,99-84-67-82-56-86-50-76-97-90-73-58-98-65-64-96-55-79-88-66-57-60-80-81-94-75-51-77-95-72-68-63-53-52-69-93-87-78-83-71-59-61-92-62-89-74-91-85-54-70,95857212,22153,25601,47754
ls-nn,kroA100,0-5-9-37-35-20-31-44-22-34-26-11-19-46-15-21-17-23-16-14-10-48-18-3-25-30-41-7-27-39-1-43-49-4-36-32-12-38-29-28-42-40-47-13-2-45-33-6-8-24,99-84-67-82-56-86-50-76-97-90-73-58-98-65-64-96-55-79-88-66-57-60-80-81-94-75-51-77-95-72-68-63-53-52-69-93-87-78-83-71-59-61-92-62-89-74-91-85-54-70,95709105,22153,25601,47754
ls-nn,kroA100,0-5-9-37-35-20-31-44-22-34-26-11-19-46-15-21-17-23-16-14-10-48-18-3-25-30-41-7-27-39-1-43-49-4-36-32-12-38-29-28-42-40-47-13-2-45-33-6-8-24,99-84-67-82-56-86-50-76-97-90-73-58-98-65-64-96-55-79-88-66-57-60-80-81-94-75-51-77-95-72-68-63-53-52-69-93-87-78-83-71-59-61-92-62-89-74-91-85-54-70,96586754,22153,25601,47754
ls-nn,kroA100,0-5-9-37-35-20-31-44-22-34-26-11-19-46-15-21-17-23-16-14-10-48-18-3-25-30-41-7-27-39-1-43-49-4-36-32-12-38-29-28-42-40-47-13-2-45-33-6-8-24,99-84-67-82-56-86-50-76-97-90-73-58-98-65-64-96-55-79-88-66-57-60-80-81-94-75-51-77-95-72-68-63-53-52-69-93-87-78-83-71-59-61-92-62-89-74-91-85-54-70,88163174,22153,25601,47754
ls-nn,kroA100,0-5-9-37-35-20-31-44-22-34-26-11-19-46-15-21-17-23-16-14-10-48-18-3-25-30-41-7-27-39-1-43-49-4-36-32-12-38-29-28-42-40-47-13-2-45-33-6-8-24,99-84-67-82-56-86-50-76-97-90-73-58-98-65-64-96-55-79-88-66-57-60-80-81-94-75-51-77-95-72-68-63-53-52-69-93-87-78-83-71-59-61-92-62-89-74-91-85-54-70,86145455,22153,25601,47754
ls-nn,kroA100,0-5-9-37-35-20-31-44-22-34-26-11-19-46-15-21-17-23-16-14-10-48-18-3-25-30-41-7-27-39-1-43-49-4-36-32-12-38-29-28-42-40-47-13-2-45-33-6-8-24,99-84-67-82-56-86-50-76-97-90-73-58-98-65-64-96-55-79-88-66-57-60-80-81-94-75-51-77-95-72-68-63-53-52-69-93-87-78-83-71-59-61-92-62-89-74-91-85-54-70,89462385,22153,25601,47754
ls-nn,kroA100,0-5-9-37-35-20-31-44-22-34-26-11-19-46-15-21-17-23-16-14-10-48-18-3-25-30-41-7-27-39-1-43-49-4-36-32-12-38-29-28-42-40-47-13-2-45-33-6-8-24,99-84-67-82-56-86-50-76-97-90-73-58-98-65-64-96-55-79-88-66-57-60-80-81-94-75-51-77-95-72-68-63-53-52-69-93-87-78-83-71-59-61-92-62-89-74-91-85-54-70,104733957,22153,25601,47754
ls-nn,kroA100,0-5-9-37-35-20-31-44-22-34-26-11-19-46-15-21-17-23-16-14-10-48-18-3-25-30-41-7-27-39-1-43-49-4-36-32-12-38-29-28-42-40-47-13-2-45-33-6-8-24,99-84-67-82-56-86-50-76-97-90-73-58-98-65-64-96-55-79-88-66-57-60-80-81-94-75-51-77-95-72-68-63-53-52-69-93-87-78-83-71-59-61-92-62-89-74-91-85-54-70,91347470,22153,25601,47754
ls-nn,kroA100,0-5-9-37-35-20-31-44-22-34-26-11-19-46-15-21-17-23-16-14-10-48-18-3-25-30-41-7-27-39-1-43-49-4-36-32-12-38-29-28-42-40-47-13-2-45-33-6-8-24,99-84-67-82-56-86-50-76-97-90-73-58-98-65-64-96-55-79-88-66-57-60-80-81-94-75-51-77-95-72-68-63-53-52-69-93-87-78-83-71-59-61-92-62-89-74-91-85-54-70,87426516,22153,25601,47754
ls-nn,kroA100,0-5-9-37-35-20-31-44-22-34-26-11-19-46-15-21-17-23-16-14-10-48-18-3-25-30-41-7-27-39-1-43-49-4-36-32-12-38-29-28-42-40-47-13-2-45-33-6-8-24,99-84-67-82-56-86-50-76-97-90-73-58-98-65-64-96-55-79-88-66-57-60-80-81-94-75-51-77-95-72-68-63-53-52-69-93-87-78-83-71-59-61-92-62-89-74-91-85-54-70,96026865,22153,25601,47754
ls-nn,kroA100,0-5-9-37-35-20-31-44-22-34-26-11-19-46-15-21-17-23-16-14-10-48-18-3-25-30-41-7-27-39-1-43-49-4-36-32-12-38-29-28-42-40-47-13-2-45-33-6-8-24,99-84-67-82-56-86-50-76-97-90-73-58-98-65-64-96-55-79-88-66-57-60-80-81-94-75-51-77-95-72-68-63-53-52-69-93-87-78-83-71-59-61-92-62-89-74-91-85-54-70,86278941,22153,25601,47754
ls-nn,kroA100,0-5-9-37-35-20-31-44-22-34-26-11-19-46-15-21-17-23-16-14-10-48-18-3-25-30-41-7-27-39-1-43-49-4-36-32-12-38-29-28-42-40-47-13-2-45-33-6-8-24,99-84-67-82-56-86-50-76-97-90-73-58-98-65-64-96-55-79-88-66-57-60-80-81-94-75-51-77-95-72-68-63-53-52-69-93-87-78-83-71-59-61-92-62-89-74-91-85-54-70,83101902,22153,25601,47754
ls-nn,kroA100,0-5-9-37-35-20-31-44-22-34-26-11-19-46-15-21-17-23-16-14-10-48-18-3-25-30-41-7-27-39-1-43-49-4-36-32-12-38-29-28-42-40-47-13-2-45-33-6-8-24,99-84-67-82-56-86-50-76-97-90-73-58-98-65-64-96-55-79-88-66-57-60-80-81-94-75-51-77-95-72-68-63-53-52-69-93-87-78-83-71-59-61-92-62-89-74-91-85-54-70,90903141,22153,25601,47754
ls-nn,kroA100,0-5-9-37-35-20-31-44-22-34-26-11-19-46-15-21-17-23-16-14-10-48-18-3-25-30-41-7-27-39-1-43-49-4-36-32-12-38-29-28-42-40-47-13-2-45-33-6-8-24,99-84-67-82-56-86-50-76-97-90-73-58-98-65-64-96-55-79-88-66-57-60-80-81-94-75-51-77-95-72-68-63-53-52-69-93-87-78-83-71-59-61-92-62-89-74-91-85-54-70,86318013,22153,25601,47754
ls-nn,kroA100,0-5-9-37-35-20-31-44-22-34-26-11-19-46-15-21-17-23-16-14-10-48-18-3-25-30-41-7-27-39-1-43-49-4-36-32-12-38-29-28-42-40-47-13-2-45-33-6-8-24,99-84-67-82-56-86-50-76-97-90-73-58-98-65-64-96-55-79-88-66-57-60-80-81-94-75-51-77-95-72-68-63-53-52-69-93-87-78-83-71-59-61-92-62-89-74-91-85-54-70,83294890,22153,25601,47754
ls-nn,kroA100,0-5-9-37-35-20-31-44-22-34-26-11-19-46-15-21-17-23-16-14-10-48-18-3-25-30-41-7-27-39-1-43-49-4-36-32-12-38-29-28-42-40-47-13-2-45-33-6-8-24,99-84-67-82-56-86-50-76-97-90-73-58-98-65-64-96-55-79-88-66-57-60-80-81-94-75-51-77-95-72-68-63-53-52-69-93-87-78-83-71-59-61-92-62-89-74-91-85-54-70,84470118,22153,25601,47754
ls-nn,kroA100,0-5-9-37-35-20-31-44-22-34-26-11-19-46-15-21-17-23-16-14-10-48-18-3-25-30-41-7-27-39-1-43-49-4-36-32-12-38-29-28-42-40-47-13-2-45-33-6-8-24,99-84-67-82-56-86-50-76-97-90-73-58-98-65-64-96-55-79-88-66-57-60-80-81-94-75-51-77-95-72-68-63-53-52-69-93-87-78-83-71-59-61-92-62-89-74-91-85-54-70,84091014,22153,25601,47754
ls-nn,kroA100,0-5-9-37-35-20-31-44-22-34-26-11-19-46-15-21-17-23-16-14-10-48-18-3-25-30-41-7-27-39-1-43-49-4-36-32-12-38-29-28-42-40-47-13-2-45-33-6-8-24,99-84-67-82-56-86-50-76-97-90-73-58-98-65-64-96-55-79-88-66-57-60-80-81-94-75-51-77-95-72-68-63-53-52-69-93-87-78-83-71-59-61-92-62-89-74-91-85-54-70,82505664,22153,25601,47754
ls-nn,kroA100,0-5-9-37-35-20-31-44-22-34-26-11-19-46-15-21-17-23-16-14-10-48-18-3-25-30-41-7-27-39-1-43-49-4-36-32-12-38-29-28-42-40-47-13-2-45-33-6-8-24,99-84-67-82-56-86-50-76-97-90-73-58-98-65-64-96-55-79-88-66-57-60-80-81-94-75-51-77-95-72-68-63-53-52-69-93-87-78-83-71-59-61-92-62-89-74-91-85-54-70,89333944,22153,25601,47754
ls-nn,kroA100,0-5-9-37-35-20-31-44-22-34-26-11-19-46-15-21-17-23-16-14-10-48-18-3-25-30-41-7-27-39-1-43-49-4-36-32-12-38-29-28-42-40-47-13-2-45-33-6-8-24,99-84-67-82-56-86-50-76-97-90-73-58-98-65-64-96-55-79-88-66-57-60-80-81-94-75-51-77-95-72-68-63-53-52-69-93-87-78-83-71-59-61-92-62-89-74-91-85-54-70,82853284,22153,25601,47754
ls-nn,kroA100,0-5-9-37-35-20-31-44-22-34-26-11-19-46-15-21-17-23-16-14-10-48-18-3-25-30-41-7-27-39-1-43-49-4-36-32-12-38-29-28-42-40-47-13-2-45-33-6-8-24,99-84-67-82-56-86-50-76-97-90-73-58-98-65-64-96-55-79-88-66-57-60-80-81-94-75-51-77-95-72-68-63-53-52-69-93-87-78-83-71-59-61-92-62-89-74-91-85-54-70,84454038,22153,25601,47754
ls-nn,kroA100,0-5-9-37-35-20-31-44-22-34-26-11-19-46-15-21-17-23-16-14-10-48-18-3-25-30-41-7-27-39-1-43-49-4-36-32-12-38-29-28-42-40-47-13-2-45-33-6-8-24,99-84-67-82-56-86-50-76-97-90-73-58-98-65-64-96-55-79-88-66-57-60-80-81-94-75-51-77-95-72-68-63-53-52-69-93-87-78-83-71-59-61-92-62-89-74-91-85-54-70,88492779,22153,25601,47754
ls-nn,kroA100,0-5-9-37-35-20-31-44-22-34-26-11-19-46-15-21-17-23-16-14-10-48-18-3-25-30-41-7-27-39-1-43-49-4-36-32-12-38-29-28-42-40-47-13-2-45-33-6-8-24,99-84-67-82-56-86-50-76-97-90-73-58-98-65-64-96-55-79-88-66-57-60-80-81-94-75-51-77-95-72-68-63-53-52-69-93-87-78-83-71-59-61-92-62-89-74-91-85-54-70,84745998,22153,25601,47754
ls-nn,kroA100,0-5-9-37-35-20-31-44-22-34-26-11-19-46-15-21-17-23-16-14-10-48-18-3-25-30-41-7-27-39-1-43-49-4-36-32-12-38-29-28-42-40-47-13-2-45-33-6-8-24,99-84-67-82-56-86-50-76-97-90-73-58-98-65-64-96-55-79-88-66-57-60-80-81-94-75-51-77-95-72-68-63-53-52-69-93-87-78-83-71-59-61-92-62-89-74-91-85-54-70,82578325,22153,25601,47754
ls-nn,kroA100,0-5-9-37-35-20-31-44-22-34-26-11-19-46-15-21-17-23-16-14-10-48-18-3-25-30-41-7-27-39-1-43-49-4-36-32-12-38-29-28-42-40-47-13-2-45-33-6-8-24,99-84-67-82-56-86-50-76-97-90-73-58-98-65-64-96-55-79-88-66-57-60-80-81-94-75-51-77-95-72-68-63-53-52-69-93-87-78-83-71-59-61-92-62-89-74-91-85-54-70,86079975,22153,25601,47754
ls-nn,kroA100,0-5-9-37-35-20-31-44-22-34-26-11-19-46-15-21-17-23-16-14-10-48-18-3-25-30-41-7-27-39-1-43-49-4-36-32-12-38-29-28-42-40-47-13-2-45-33-6-8-24,99-84-67-82-56-86-50-76-97-90-73-58-98-65-64-96-55-79-88-66-57-60-80-81-94-75-51-77-95-72-68-63-53-52-69-93-87-78-83-71-59-61-92-62-89-74-91-85-54-70,81763279,22153,25601,47754
ls-nn,kroA100,0-5-9-37-35-20-31-44-22-34-26-11-19-46-15-21-17-23-16-14-10-48-18-3-25-30-41-7-27-39-1-43-49-4-36-32-12-38-29-28-42-40-47-13-2-45-33-6-8-24,99-84-67-82-56-86-50-76-97-90-73-58-98-65-64-96-55-79-88-66-57-60-80-81-94-75-51-77-95-72-68-63-53-52-69-93-87-78-83-71-59-61-92-62-89-74-91-85-54-70,82921320,22153,25601,47754
ls-nn,kroA100,0-5-9-37-35-20-31-44-22-34-26-11-19-46-15-21-17-23-16-14-10-48-18-3-25-30-41-7-27-39-1-43-49-4-36-32-12-38-29-28-42-40-47-13-2-45-33-6-8-24,99-84-67-82-56-86-50-76-97-90-73-58-98-65-64-96-55-79-88-66-57-60-80-81-94-75-51-77-95-72-68-63-53-52-69-93-87-78-83-71-59-61-92-62-89-74-91-85-54-70,83864228,22153,25601,47754
ls-nn,kroA100,0-5-9-37-35-20-31-44-22-34-26-11-19-46-15-21-17-23-16-14-10-48-18-3-25-30-41-7-27-39-1-43-49-4-36-32-12-38-29-28-42-40-47-13-2-45-33-6-8-24,99-84-67-82-56-86-50-76-97-90-73-58-98-65-64-96-55-79-88-66-57-60-80-81-94-75-51-77-95-72-68-63-53-52-69-93-87-78-83-71-59-61-92-62-89-74-91-85-54-70,84894169,22153,25601,47754
ls-nn,kroA100,0-5-9-37-35-20-31-44-22-34-26-11-19-46-15-21-17-23-16-14-10-48-18-3-25-30-41-7-27-39-1-43-49-4-36-32-12-38-29-28-42-40-47-13-2-45-33-6-8-24,99-84-67-82-56-86-50-76-97-90-73-58-98-65-64-96-55-79-88-66-57-60-80-81-94-75-51-77-95-72-68-63-53-52-69-93-87-78-83-71-59-61-92-62-89-74-91-85-54-70,86864081,22153,25601,47754
ls-nn,kroA100,0-5-9-37-35-20-31-44-22-34-26-11-19-46-15-21-17-23-16-14-10-48-18-3-25-30-41-7-27-39-1-43-49-4-36-32-12-38-29-28-42-40-47-13-2-45-33-6-8-24,99-84-67-82-56-86-50-76-97-90-73-58-98-65-64-96-55-79-88-66-57-60-80-81-94-75-51-77-95-72-68-63-53-52-69-93-87-78-83-71-59-61-92-62-89-74-91-85-54-70,84270478,22153,25601,47754
ls-nn,kroA100,0-5-9-37-35-20-31-44-22-34-26-11-19-46-15-21-17-23-16-14-10-48-18-3-25-30-41-7-27-39-1-43-49-4-36-32-12-38-29-28-42-40-47-13-2-45-33-6-8-24,99-84-67-82-56-86-50-76-97-90-73-58-98-65-64-96-55-79-88-66-57-60-80-81-94-75-51-77-95-72-68-63-53-52-69-93-87-78-83-71-59-61-92-62-89-74-91-85-54-70,85429556,22153,25601,47754
ls-nn,kroA100,0-5-9-37-35-20-31-44-22-34-26-11-19-46-15-21-17-23-16-14-10-48-18-3-25-30-41-7-27-39-1-43-49-4-36-32-12-38-29-28-42-40-47-13-2-45-33-6-8-24,99-84-67-82-56-86-50-76-97-90-73-58-98-65-64-96-55-79-88-66-57-60-80-81-94-75-51-77-95-72-68-63-53-52-69-93-87-78-83-71-59-61-92-62-89-74-91-85-54-70,82430726,22153,25601,47754
ls-nn,kroA100,0-5-9-37-35-20-31-44-22-34-26-11-19-46-15-21-17-23-16-14-10-48-18-3-25-30-41-7-27-39-1-43-49-4-36-32-12-38-29-28-42-40-47-13-2-45-33-6-8-24,99-84-67-82-56-86-50-76-97-90-73-58-98-65-64-96-55-79-88-66-57-60-80-81-94-75-51-77-95-72-68-63-53-52-69-93-87-78-83-71-59-61-92-62-89-74-91-85-54-70,84801631,22153,25601,47754
ls-nn,kroA100,0-5-9-37-35-20-31-44-22-34-26-11-19-46-15-21-17-23-16-14-10-48-18-3-25-30-41-7-27-39-1-43-49-4-36-32-12-38-29-28-42-40-47-13-2-45-33-6-8-24,99-84-67-82-56-86-50-76-97-90-73-58-98-65-64-96-55-79-88-66-57-60-80-81-94-75-51-77-95-72-68-63-53-52-69-93-87-78-83-71-59-61-92-62-89-74-91-85-54-70,82875701,22153,25601,47754
ls-nn,kroA100,0-5-9-37-35-20-31-44-22-34-26-11-19-46-15-21-17-23-16-14-10-48-18-3-25-30-41-7-27-39-1-43-49-4-36-32-12-38-29-28-42-40-47-13-2-45-33-6-8-24,99-84-67-82-56-86-50-76-97-90-73-58-98-65-64-96-55-79-88-66-57-60-80-81-94-75-51-77-95-72-68-63-53-52-69-93-87-78-83-71-59-61-92-62-89-74-91-85-54-70,82197852,22153,25601,47754
ls-nn,kroA100,0-5-9-37-35-20-31-44-22-34-26-11-19-46-15-21-17-23-16-14-10-48-18-3-25-30-41-7-27-39-1-43-49-4-36-32-12-38-29-28-42-40-47-13-2-45-33-6-8-24,99-84-67-82-56-86-50-76-97-90-73-58-98-65-64-96-55-79-88-66-57-60-80-81-94-75-51-77-95-72-68-63-53-52-69-93-87-78-83-71-59-61-92-62-89-74-91-85-54-70,83842655,22153,25601,47754
ls-nn,kroA100,0-5-9-37-35-20-31-44-22-34-26-11-19-46-15-21-17-23-16-14-10-48-18-3-25-30-41-7-27-39-1-43-49-4-36-32-12-38-29-28-42-40-47-13-2-45-33-6-8-24,99-84-67-82-56-86-50-76-97-90-73-58-98-65-64-96-55-79-88-66-57-60-80-81-94-75-51-77-95-72-68-63-53-52-69-93-87-78-83-71-59-61-92-62-89-74-91-85-54-70,84582733,22153,25601,47754
ls-nn,kroA100,0-5-9-37-35-20-31-44-22-34-26-11-19-46-15-21-17-23-16-14-10-48-18-3-25-30-41-7-27-39-1-43-49-4-36-32-12-38-29-28-42-40-47-13-2-45-33-6-8-24,99-84-67-82-56-86-50-76-97-90-73-58-98-65-64-96-55-79-88-66-57-60-80-81-94-75-51-77-95-72-68-63-53-52-69-93-87-78-83-71-59-61-92-62-89-74-91-85-54-70,82460549,22153,25601,47754
ls-nn,kroA100,0-5-9-37-35-20-31-44-22-34-26-11-19-46-15-21-17-23-16-14-10-48-18-3-25-30-41-7-27-39-1-43-49-4-36-32-12-38-29-28-42-40-47-13-2-45-33-6-8-24,99-84-67-82-56-86-50-76-97-90-73-58-98-65-64-96-55-79-88-66-57-60-80-81-94-75-51-77-95-72-68-63-53-52-69-93-87-78-83-71-59-61-92-62-89-74-91-85-54-70,87203239,22153,25601,47754
ls-nn,kroA100,0-5-9-37-35-20-31-44-22-34-26-11-19-46-15-21-17-23-16-14-10-48-18-3-25-30-41-7-27-39-1-43-49-4-36-32-12-38-29-28-42-40-47-13-2-45-33-6-8-24,99-84-67-82-56-86-50-76-97-90-73-58-98-65-64-96-55-79-88-66-57-60-80-81-94-75-51-77-95-72-68-63-53-52-69-93-87-78-83-71-59-61-92-62-89-74-91-85-54-70,88851485,22153,25601,47754
ls-nn,kroA100,0-5-9-37-35-20-31-44-22-34-26-11-19-46-15-21-17-23-16-14-10-48-18-3-25-30-41-7-27-39-1-43-49-4-36-32-12-38-29-28-42-40-47-13-2-45-33-6-8-24,99-84-67-82-56-86-50-76-97-90-73-58-98-65-64-96-55-79-88-66-57-60-80-81-94-75-51-77-95-72-68-63-53-52-69-93-87-78-83-71-59-61-92-62-89-74-91-85-54-70,88420242,22153,25601,47754
ls-nn,kroA100,0-5-9-37-35-20-31-44-22-34-26-11-19-46-15-21-17-23-16-14-10-48-18-3-25-30-41-7-27-39-1-43-49-4-36-32-12-38-29-28-42-40-47-13-2-45-33-6-8-24,99-84-67-82-56-86-50-76-97-90-73-58-98-65-64-96-55-79-88-66-57-60-80-81-94-75-51-77-95-72-68-63-53-52-69-93-87-78-83-71-59-61-92-62-89-74-91-85-54-70,83817008,22153,25601,47754
ls-nn,kroA100,0-5-9-37-35-20-31-44-22-34-26-11-19-46-15-21-17-23-16-14-10-48-18-3-25-30-41-7-27-39-1-43-49-4-36-32-12-38-29-28-42-40-47-13-2-45-33-6-8-24,99-84-67-82-56-86-50-76-97-90-73-58-98-65-64-96-55-79-88-66-57-60-80-81-94-75-51-77-95-72-68-63-53-52-69-93-87-78-83-71-59-61-92-62-89-74-91-85-54-70,83111672,22153,25601,47754
ls-nn,kroA100,0-5-9-37-35-20-31-44-22-34-26-11-19-46-15-21-17-23-16-14-10-48-18-3-25-30-41-7-27-39-1-43-49-4-36-32-12-38-29-28-42-40-47-13-2-45-33-6-8-24,99-84-67-82-56-86-50-76-97-90-73-58-98-65-64-96-55-79-88-66-57-60-80-81-94-75-51-77-95-72-68-63-53-52-69-93-87-78-83-71-59-61-92-62-89-74-91-85-54-70,82306949,22153,25601,47754
ls-nn,kroA100,0-5-9-37-35-20-31-44-22-34-26-11-19-46-15-21-17-23-16-14-10-48-18-3-25-30-41-7-27-39-1-43-49-4-36-32-12-38-29-28-42-40-47-13-2-45-33-6-8-24,99-84-67-82-56-86-50-76-97-90-73-58-98-65-64-96-55-79-88-66-57-60-80-81-94-75-51-77-95-72-68-63-53-52-69-93-87-78-83-71-59-61-92-62-89-74-91-85-54-70,83754812,22153,25601,47754
ls-nn,kroA100,0-5-9-37-35-20-31-44-22-34-26-11-19-46-15-21-17-23-16-14-10-48-18-3-25-30-41-7-27-39-1-43-49-4-36-32-12-38-29-28-42-40-47-13-2-45-33-6-8-24,99-84-67-82-56-86-50-76-97-90-73-58-98-65-64-96-55-79-88-66-57-60-80-81-94-75-51-77-95-72-68-63-53-52-69-93-87-78-83-71-59-61-92-62-89-74-91-85-54-70,87706331,22153,25601,47754
ls-nn,kroA100,0-5-9-37-35-20-31-44-22-34-26-11-19-46-15-21-17-23-16-14-10-48-18-3-25-30-41-7-27-39-1-43-49-4-36-32-12-38-29-28-42-40-47-13-2-45-33-6-8-24,99-84-67-82-56-86-50-76-97-90-73-58-98-65-64-96-55-79-88-66-57-60-80-81-94-75-51-77-95-72-68-63-53-52-69-93-87-78-83-71-59-61-92-62-89-74-91-85-54-70,84800635,22153,25601,47754
ls-nn,kroA100,0-5-9-37-35-20-31-44-22-34-26-11-19-46-15-21-17-23-16-14-10-48-18-3-25-30-41-7-27-39-1-43-49-4-36-32-12-38-29-28-42-40-47-13-2-45-33-6-8-24,99-84-67-82-56-86-50-76-97-90-73-58-98-65-64-96-55-79-88-66-57-60-80-81-94-75-51-77-95-72-68-63-53-52-69-93-87-78-83-71-59-61-92-62-89-74-91-85-54-70,84740354,22153,25601,47754
ls-nn,kroA100,0-5-9-37-35-20-31-44-22-34-26-11-19-46-15-21-17-23-16-14-10-48-18-3-25-30-41-7-27-39-1-43-49-4-36-32-12-38-29-28-42-40-47-13-2-45-33-6-8-24,99-84-67-82-56-86-50-76-97-90-73-58-98-65-64-96-55-79-88-66-57-60-80-81-94-75-51-77-95-72-68-63-53-52-69-93-87-78-83-71-59-61-92-62-89-74-91-85-54-70,82931925,22153,25601,47754
ls-nn,kroA100,0-5-9-37-35-20-31-44-22-34-26-11-19-46-15-21-17-23-16-14-10-48-18-3-25-30-41-7-27-39-1-43-49-4-36-32-12-38-29-28-42-40-47-13-2-45-33-6-8-24,99-84-67-82-56-86-50-76-97-90-73-58-98-65-64-96-55-79-88-66-57-60-80-81-94-75-51-77-95-72-68-63-53-52-69-93-87-78-83-71-59-61-92-62-89-74-91-85-54-70,97404388,22153,25601,47754
ls-nn,kroA100,0-5-9-37-35-20-31-44-22-34-26-11-19-46-15-21-17-23-16-14-10-48-18-3-25-30-41-7-27-39-1-43-49-4-36-32-12-38-29-28-42-40-47-13-2-45-33-6-8-24,99-84-67-82-56-86-50-76-97-90-73-58-98-65-64-96-55-79-88-66-57-60-80-81-94-75-51-77-95-72-68-63-53-52-69-93-87-78-83-71-59-61-92-62-89-74-91-85-54-70,94894318,22153,25601,47754
ls-nn,kroA100,0-5-9-37-35-20-31-44-22-34-26-11-19-46-15-21-17-23-16-14-10-48-18-3-25-30-41-7-27-39-1-43-49-4-36-32-12-38-29-28-42-40-47-13-2-45-33-6-8-24,99-84-67-82-56-86-50-76-97-90-73-58-98-65-64-96-55-79-88-66-57-60-80-81-94-75-51-77-95-72-68-63-53-52-69-93-87-78-83-71-59-61-92-62-89-74-91-85-54-70,83671400,22153,25601,47754
ls-nn,kroA100,0-5-9-37-35-20-31-44-22-34-26-11-19-46-15-21-17-23-16-14-10-48-18-3-25-30-41-7-27-39-1-43-49-4-36-32-12-38-29-28-42-40-47-13-2-45-33-6-8-24,99-84-67-82-56-86-50-76-97-90-73-58-98-65-64-96-55-79-88-66-57-60-80-81-94-75-51-77-95-72-68-63-53-52-69-93-87-78-83-71-59-61-92-62-89-74-91-85-54-70,87032515,22153,25601,47754
ls-nn,kroA100,0-5-9-37-35-20-31-44-22-34-26-11-19-46-15-21-17-23-16-14-10-48-18-3-25-30-41-7-27-39-1-43-49-4-36-32-12-38-29-28-42-40-47-13-2-45-33-6-8-24,99-84-67-82-56-86-50-76-97-90-73-58-98-65-64-96-55-79-88-66-57-60-80-81-94-75-51-77-95-72-68-63-53-52-69-93-87-78-83-71-59-61-92-62-89-74-91-85-54-70,84224303,22153,25601,47754
ls-nn,kroA100,0-5-9-37-35-20-31-44-22-34-26-11-19-46-15-21-17-23-16-14-10-48-18-3-25-30-41-7-27-39-1-43-49-4-36-32-12-38-29-28-42-40-47-13-2-45-33-6-8-24,99-84-67-82-56-86-50-76-97-90-73-58-98-65-64-96-55-79-88-66-57-60-80-81-94-75-51-77-95-72-68-63-53-52-69-93-87-78-83-71-59-61-92-62-89-74-91-85-54-70,82458115,22153,25601,47754
ls-nn,kroA100,0-5-9-37-35-20-31-44-22-34-26-11-19-46-15-21-17-23-16-14-10-48-18-3-25-30-41-7-27-39-1-43-49-4-36-32-12-38-29-28-42-40-47-13-2-45-33-6-8-24,99-84-67-82-56-86-50-76-97-90-73-58-98-65-64-96-55-79-88-66-57-60-80-81-94-75-51-77-95-72-68-63-53-52-69-93-87-78-83-71-59-61-92-62-89-74-91-85-54-70,83019218,22153,25601,47754
ls-nn,kroA100,0-5-9-37-35-20-31-44-22-34-26-11-19-46-15-21-17-23-16-14-10-48-18-3-25-30-41-7-27-39-1-43-49-4-36-32-12-38-29-28-42-40-47-13-2-45-33-6-8-24,99-84-67-82-56-86-50-76-97-90-73-58-98-65-64-96-55-79-88-66-57-60-80-81-94-75-51-77-95-72-68-63-53-52-69-93-87-78-83-71-59-61-92-62-89-74-91-85-54-70,87763694,22153,25601,47754
ls-nn,kroA100,0-5-9-37-35-20-31-44-22-34-26-11-19-46-15-21-17-23-16-14-10-48-18-3-25-30-41-7-27-39-1-43-49-4-36-32-12-38-29-28-42-40-47-13-2-45-33-6-8-24,99-84-67-82-56-86-50-76-97-90-73-58-98-65-64-96-55-79-88-66-57-60-80-81-94-75-51-77-95-72-68-63-53-52-69-93-87-78-83-71-59-61-92-62-89-74-91-85-54-70,83046517,22153,25601,47754
ls-nn,kroA100,0-5-9-37-35-20-31-44-22-34-26-11-19-46-15-21-17-23-16-14-10-48-18-3-25-30-41-7-27-39-1-43-49-4-36-32-12-38-29-28-42-40-47-13-2-45-33-6-8-24,99-84-67-82-56-86-50-76-97-90-73-58-98-65-64-96-55-79-88-66-57-60-80-81-94-75-51-77-95-72-68-63-53-52-69-93-87-78-83-71-59-61-92-62-89-74-91-85-54-70,83143373,22153,25601,47754
ls-nn,kroA100,0-5-9-37-35-20-31-44-22-34-26-11-19-46-15-21-17-23-16-14-10-48-18-3-25-30-41-7-27-39-1-43-49-4-36-32-12-38-29-28-42-40-47-13-2-45-33-6-8-24,99-84-67-82-56-86-50-76-97-90-73-58-98-65-64-96-55-79-88-66-57-60-80-81-94-75-51-77-95-72-68-63-53-52-69-93-87-78-83-71-59-61-92-62-89-74-91-85-54-70,85860151,22153,25601,47754
ls-nn,kroA100,0-5-9-37-35-20-31-44-22-34-26-11-19-46-15-21-17-23-16-14-10-48-18-3-25-30-41-7-27-39-1-43-49-4-36-32-12-38-29-28-42-40-47-13-2-45-33-6-8-24,99-84-67-82-56-86-50-76-97-90-73-58-98-65-64-96-55-79-88-66-57-60-80-81-94-75-51-77-95-72-68-63-53-52-69-93-87-78-83-71-59-61-92-62-89-74-91-85-54-70,85207448,22153,25601,47754
ls-nn,kroA100,0-5-9-37-35-20-31-44-22-34-26-11-19-46-15-21-17-23-16-14-10-48-18-3-25-30-41-7-27-39-1-43-49-4-36-32-12-38-29-28-42-40-47-13-2-45-33-6-8-24,99-84-67-82-56-86-50-76-97-90-73-58-98-65-64-96-55-79-88-66-57-60-80-81-94-75-51-77-95-72-68-63-53-52-69-93-87-78-83-71-59-61-92-62-89-74-91-85-54-70,92987876,22153,25601,47754
ls-nn,kroA100,0-5-9-37-35-20-31-44-22-34-26-11-19-46-15-21-17-23-16-14-10-48-18-3-25-30-41-7-27-39-1-43-49-4-36-32-12-38-29-28-42-40-47-13-2-45-33-6-8-24,99-84-67-82-56-86-50-76-97-90-73-58-98-65-64-96-55-79-88-66-57-60-80-81-94-75-51-77-95-72-68-63-53-52-69-93-87-78-83-71-59-61-92-62-89-74-91-85-54-70,85010067,22153,25601,47754
ls-nn,kroA100,0-5-9-37-35-20-31-44-22-34-26-11-19-46-15-21-17-23-16-14-10-48-18-3-25-30-41-7-27-39-1-43-49-4-36-32-12-38-29-28-42-40-47-13-2-45-33-6-8-24,99-84-67-82-56-86-50-76-97-90-73-58-98-65-64-96-55-79-88-66-57-60-80-81-94-75-51-77-95-72-68-63-53-52-69-93-87-78-83-71-59-61-92-62-89-74-91-85-54-70,82930554,22153,25601,47754
ls-nn,kroA100,0-5-9-37-35-20-31-44-22-34-26-11-19-46-15-21-17-23-16-14-10-48-18-3-25-30-41-7-27-39-1-43-49-4-36-32-12-38-29-28-42-40-47-13-2-45-33-6-8-24,99-84-67-82-56-86-50-76-97-90-73-58-98-65-64-96-55-79-88-66-57-60-80-81-94-75-51-77-95-72-68-63-53-52-69-93-87-78-83-71-59-61-92-62-89-74-91-85-54-70,82925056,22153,25601,47754
ls-nn,kroA100,0-5-9-37-35-20-31-44-22-34-26-11-19-46-15-21-17-23-16-14-10-48-18-3-25-30-41-7-27-39-1-43-49-4-36-32-12-38-29-28-42-40-47-13-2-45-33-6-8-24,99-84-67-82-56-86-50-76-97-90-73-58-98-65-64-96-55-79-88-66-57-60-80-81-94-75-51-77-95-72-68-63-53-52-69-93-87-78-83-71-59-61-92-62-89-74-91-85-54-70,88002182,22153,25601,47754
ls-nn,kroA100,0-5-9-37-35-20-31-44-22-34-26-11-19-46-15-21-17-23-16-14-10-48-18-3-25-30-41-7-27-39-1-43-49-4-36-32-12-38-29-28-42-40-47-13-2-45-33-6-8-24,99-84-67-82-56-86-50-76-97-90-73-58-98-65-64-96-55-79-88-66-57-60-80-81-94-75-51-77-95-72-68-63-53-52-69-93-87-78-83-71-59-61-92-62-89-74-91-85-54-70,82393092,22153,25601,47754
ls-nn,kroA100,0-5-9-37-35-20-31-44-22-34-26-11-19-46-15-21-17-23-16-14-10-48-18-3-25-30-41-7-27-39-1-43-49-4-36-32-12-38-29-28-42-40-47-13-2-45-33-6-8-24,99-84-67-82-56-86-50-76-97-90-73-58-98-65-64-96-55-79-88-66-57-60-80-81-94-75-51-77-95-72-68-63-53-52-69-93-87-78-83-71-59-61-92-62-89-74-91-85-54-70,82737186,22153,25601,47754
ls-nn,kroA100,0-5-9-37-35-20-31-44-22-34-26-11-19-46-15-21-17-23-16-14-10-48-18-3-25-30-41-7-27-39-1-43-49-4-36-32-12-38-29-28-42-40-47-13-2-45-33-6-8-24,99-84-67-82-56-86-50-76-97-90-73-58-98-65-64-96-55-79-88-66-57-60-80-81-94-75-51-77-95-72-68-63-53-52-69-93-87-78-83-71-59-61-92-62-89-74-91-85-54-70,84298032,22153,25601,47754
ls-nn,kroA100,0-5-9-37-35-20-31-44-22-34-26-11-19-46-15-21-17-23-16-14-10-48-18-3-25-30-41-7-27-39-1-43-49-4-36-32-12-38-29-28-42-40-47-13-2-45-33-6-8-24,99-84-67-82-56-86-50-76-97-90-73-58-98-65-64-96-55-79-88-66-57-60-80-81-94-75-51-77-95-72-68-63-53-52-69-93-87-78-83-71-59-61-92-62-89-74-91-85-54-70,95814620,22153,25601,47754
ils,kroA100,99-84-67-82-56-86-50-76-97-90-73-58-98-65-64-96-55-79-88-66-57-60-80-81-94-75-51-77-95-72-68-63-53-52-69-93-87-78-83-71-59-61-92-62-89-74-91-85-54-70,0-5-9-37-35-20-31-44-22-34-26-11-19-46-15-21-17-23-16-14-10-48-18-3-25-30-41-7-27-39-1-43-49-4-36-32-12-38-29-28-42-40-47-13-2-45-33-6-8-24,7439236239,25601,22153,47754
ils,kroA100,99-84-67-82-56-86-50-76-97-90-73-58-98-65-64-96-55-79-88-66-57-60-80-81-94-75-51-77-95-72-68-63-53-52-69-93-87-78-83-71-59-61-92-62-89-74-91-85-54-70,0-5-9-37-35-20-31-44-22-34-26-11-19-46-15-21-17-23-16-14-10-48-18-3-25-30-41-7-27-39-1-43-49-4-36-32-12-38-29-28-42-40-47-13-2-45-33-6-8-24,7159941926,25601,22153,47754
ils,kroA100,0-5-9-37-35-20-31-44-22-34-26-11-19-46-15-21-17-23-16-14-10-48-18-3-25-30-41-7-27-39-1-43-49-4-36-32-12-38-29-28-42-40-47-13-2-45-33-6-8-24,99-84-67-82-56-86-50-76-97-90-73-58-98-65-64-96-55-79-88-66-57-60-80-81-94-75-51-77-95-72-68-63-53-52-69-93-87-78-83-71-59-61-92-62-89-74-91-85-54-70,7362546520,22153,25601,47754
ils,kroA100,0-5-9-37-35-20-31-44-22-34-26-11-19-46-15-21-17-23-16-14-10-48-18-3-25-30-41-7-27-39-1-43-49-4-36-32-12-38-29-28-42-40-47-13-2-45-33-6-8-24,99-84-67-82-56-86-50-76-97-90-73-58-98-65-64-96-55-79-88-66-57-60-80-81-94-75-51-77-95-72-68-63-53-52-69-93-87-78-83-71-59-61-92-62-89-74-91-85-54-70,7777121788,22153,25601,47754
ils,kroA100,99-84-67-82-56-86-50-76-97-90-73-58-98-65-64-96-55-79-88-66-57-60-80-81-94-75-51-77-95-72-68-63-53-52-69-93-87-78-83-71-59-61-92-62-89-74-91-85-54-70,0-5-9-37-35-20-31-44-22-34-26-11-19-46-15-21-17-23-16-14-10-48-18-3-25-30-41-7-27-39-1-43-49-4-36-32-12-38-29-28-42-40-47-13-2-45-33-6-8-24,7686594079,25601,22153,47754
ils,kroA100,0-5-9-37-35-20-31-44-22-34-26-11-19-46-15-21-17-23-16-14-10-48-18-3-25-30-41-7-27-39-1-43-49-4-36-32-12-38-29-28-42-40-47-13-2-45-33-6-8-24,99-84-67-82-56-86-50-76-97-90-73-58-98-65-64-96-55-79-88-66-57-60-80-81-94-75-51-77-95-72-68-63-53-52-69-93-87-78-83-71-59-61-92-62-89-74-91-85-54-70,7278165369,22153,25601,47754
ils,kroA100,99-84-67-82-56-86-50-76-97-90-73-58-98-65-64-96-55-79-88-66-57-60-80-81-94-75-51-77-95-72-68-63-53-52-69-93-87-78-83-71-59-61-92-62-89-74-91-85-54-70,0-5-9-37-35-20-31-44-22-34-26-11-19-46-15-21-17-23-16-14-10-48-18-3-25-30-41-7-27-39-1-43-49-4-36-32-12-38-29-28-42-40-47-13-2-45-33-6-8-24,8050561872,25601,22153,47754
ils,kroA100,99-84-67-82-56-86-50-76-97-90-73-58-98-65-64-96-55-79-88-66-57-60-80-81-94-75-51-77-95-72-68-63-53-52-69-93-87-78-83-71-59-61-92-62-89-74-91-85-54-70,0-5-9-37-35-20-31-44-22-34-26-11-19-46-15-21-17-23-16-14-10-48-18-3-25-30-41-7-27-39-1-43-49-4-36-32-12-38-29-28-42-40-47-13-2-45-33-6-8-24,7501164757,25601,22153,47754
ils,kroA100,0-5-9-37-35-20-31-44-22-34-26-11-19-46-15-21-17-23-16-14-10-48-18-3-25-30-41-7-27-39-1-43-49-4-36-32-12-38-29-28-42-40-47-13-2-45-33-6-8-24,99-84-67-82-56-86-50-76-97-90-73-58-98-65-64-96-55-79-88-66-57-60-80-81-94-75-51-77-95-72-68-63-53-52-69-93-87-78-83-71-59-61-92-62-89-74-91-85-54-70,7892610079,22153,25601,47754
ils,kroA100,0-5-9-37-35-20-31-44-22-34-26-11-19-46-15-21-17-23-16-14-10-48-18-3-25-30-41-7-27-39-1-43-49-4-36-32-12-38-29-28-42-40-47-13-2-45-33-6-8-24,99-84-67-82-56-86-50-76-97-90-73-58-98-65-64-96-55-79-88-66-57-60-80-81-94-75-51-77-95-72-68-63-53-52-69-93-87-78-83-71-59-61-92-62-89-74-91-85-54-70,7778273329,22153,25601,47754
ils,kroA100,99-84-67-82-56-86-50-76-97-90-73-58-98-65-64-96-55-79-88-66-57-60-80-81-94-75-51-77-95-72-68-63-53-52-69-93-87-78-83-71-59-61-92-62-89-74-91-85-54-70,0-5-9-37-35-20-31-44-22-34-26-11-19-46-15-21-17-23-16-14-10-48-18-3-25-30-41-7-27-39-1-43-49-4-36-32-12-38-29-28-42-40-47-13-2-45-33-6-8-24,7183324509,25601,22153,47754
ils,kroA100,99-84-67-82-56-86-50-76-97-90-73-58-98-65-64-96-55-79-88-66-57-60-80-81-94-75-51-77-95-72-68-63-53-52-69-93-87-78-83-71-59-61-92-62-89-74-91-85-54-70,0-5-9-37-35-20-31-44-22-34-26-11-19-46-15-21-17-23-16-14-10-48-18-3-25-30-41-7-27-39-1-43-49-4-36-32-12-38-29-28-42-40-47-13-2-45-33-6-8-24,7478339762,25601,22153,47754
ils,kroA100,99-84-67-82-56-86-50-76-97-90-73-58-98-65-64-96-55-79-88-66-57-60-80-81-94-75-51-77-95-72-68-63-53-52-69-93-87-78-83-71-59-61-92-62-89-74-91-85-54-70,0-5-9-37-35-20-31-44-22-34-26-11-19-46-15-21-17-23-16-14-10-48-18-3-25-30-41-7-27-39-1-43-49-4-36-32-12-38-29-28-42-40-47-13-2-45-33-6-8-24,7331368917,25601,22153,47754
ils,kroA100,99-84-67-82-56-86-50-76-97-90-73-58-98-65-64-96-55-79-88-66-57-60-80-81-94-75-51-77-95-72-68-63-53-52-69-93-87-78-83-71-59-61-92-62-89-74-91-85-54-70,0-5-9-37-35-20-31-44-22-34-26-11-19-46-15-21-17-23-16-14-10-48-18-3-25-30-41-7-27-39-1-43-49-4-36-32-12-38-29-28-42-40-47-13-2-45-33-6-8-24,8213500114,25601,22153,47754
ils,kroA100,0-5-9-37-35-20-31-44-22-34-26-11-19-46-15-21-17-23-16-14-10-48-18-3-25-30-41-7-27-39-1-43-49-4-36-32-12-38-29-28-42-40-47-13-2-45-33-6-8-24,99-84-67-82-56-86-50-76-97-90-73-58-98-65-64-96-55-79-88-66-57-60-80-81-94-75-51-77-95-72-68-63-53-52-69-93-87-78-83-71-59-61-92-62-89-74-91-85-54-70,7788194953,22153,25601,47754
ils,kroA100,99-84-67-82-56-86-50-76-97-90-73-58-98-65-64-96-55-79-88-66-57-60-80-81-94-75-51-77-95-72-68-63-53-52-69-93-87-78-83-71-59-61-92-62-89-74-91-85-54-70,0-5-9-37-35-20-31-44-22-34-26-11-19-46-15-21-17-23-16-14-10-48-18-3-25-30-41-7-27-39-1-43-49-4-36-32-12-38-29-28-42-40-47-13-2-45-33-6-8-24,7567406618,25601,22153,47754
ils,kroA100,0-5-9-37-35-20-31-44-22-34-26-11-19-46-15-21-17-23-16-14-10-48-18-3-25-30-41-7-27-39-1-43-49-4-36-32-12-38-29-28-42-40-47-13-2-45-33-6-8-24,99-84-67-82-56-86-50-76-97-90-73-58-98-65-64-96-55-79-88-66-57-60-80-81-94-75-51-77-95-72-68-63-53-52-69-93-87-78-83-71-59-61-92-62-89-74-91-85-54-70,8206572633,22153,25601,47754
ils,kroA100,99-84-67-82-56-86-50-76-97-90-73-58-98-65-64-96-55-79-88-66-57-60-80-81-94-75-51-77-95-72-68-63-53-52-69-93-87-78-83-71-59-61-92-62-89-74-91-85-54-70,0-5-9-37-35-20-31-44-22-34-26-11-19-46-15-21-17-23-16-14-10-48-18-3-25-30-41-7-27-39-1-43-49-4-36-32-12-38-29-28-42-40-47-13-2-45-33-6-8-24,8444314715,25601,22153,47754
ils,kroA100,99-84-67-82-56-86-50-76-97-90-73-58-98-65-64-96-55-79-88-66-57-60-80-81-94-75-51-77-95-72-68-63-53-52-69-93-87-78-83-71-59-61-92-62-89-74-91-85-54-70,0-5-9-37-35-20-31-44-22-34-26-11-19-46-15-21-17-23-16-14-10-48-18-3-25-30-41-7-27-39-1-43-49-4-36-32-12-38-29-28-42-40-47-13-2-45-33-6-8-24,8029029546,25601,22153,47754
ils,kroA100,0-5-9-37-35-20-31-44-22-34-26-11-19-46-15-21-17-23-16-14-10-48-18-3-25-30-41-7-27-39-1-43-49-4-36-32-12-38-29-28-42-40-47-13-2-45-33-6-8-24,99-84-67-82-56-86-50-76-97-90-73-58-98-65-64-96-55-79-88-66-57-60-80-81-94-75-51-77-95-72-68-63-53-52-69-93-87-78-83-71-59-61-92-62-89-74-91-85-54-70,7335381975,22153,25601,47754
ils,kroA100,22-61-56-6-8-86-24-27-62-74-96-3-64-18-93-98-35-20-39-43-72-49-81-94-4-95-29-13-2-45-28-68-88-30-79-41-48-89-9-46-67-12-32-77-99-70-40-34-44-10,73-58-37-23-69-65-25-55-7-53-1-63-80-66-92-57-33-42-47-51-36-75-38-84-0-91-5-16-14-97-76-60-50-19-11-82-54-26-85-59-90-31-71-83-78-52-87-15-21-17,7428162510,25697,23206,48903
ils,kroA100,99-84-67-82-56-86-50-76-97-90-73-58-98-65-64-96-55-79-88-66-57-60-80-81-94-75-51-77-95-72-68-63-53-52-69-93-87-78-83-71-59-61-92-62-89-74-91-85-54-70,0-5-9-37-35-20-31-44-22-34-26-11-19-46-15-21-17-23-16-14-10-48-18-3-25-30-41-7-27-39-1-43-49-4-36-32-12-38-29-28-42-40-47-13-2-45-33-6-8-24,7668405641,25601,22153,47754
ils,kroA100,63-84-60-66-55-3-64-25-65-52-78-9-90-6-33-13-45-82-54-11-85-76-57-92-91-7-88-30-79-48-62-20-31-10-14-16-98-37-23-22-59-61-47-77-75-12-81-49-1-53,43-39-68-80-24-28-2-29-38-67-8-56-86-46-5-74-18-69-21-93-35-58-73-71-89-0-27-19-34-26-42-40-70-99-51-95-4-36-32-94-41-96-15-87-17-83-44-97-50-72,8052455127,23688,23593,47281
ils,kroA100,99-84-67-82-56-86-50-76-97-90-73-58-98-65-64-96-55-79-88-66-57-60-80-81-94-75-51-77-95-72-68-63-53-52-69-93-87-78-83-71-59-61-92-62-89-74-91-85-54-70,0-5-9-37-35-20-31-44-22-34-26-11-19-46-15-21-17-23-16-14-10-48-18-3-25-30-41-7-27-39-1-43-49-4-36-32-12-38-29-28-42-40-47-13-2-45-33-6-8-24,10788106360,25601,22153,47754
ils,kroA100,0-5-9-37-35-20-31-44-22-34-26-11-19-46-15-21-17-23-16-14-10-48-18-3-25-30-41-7-27-39-1-43-49-4-36-32-12-38-29-28-42-40-47-13-2-45-33-6-8-24,99-84-67-82-56-86-50-76-97-90-73-58-98-65-64-96-55-79-88-66-57-60-80-81-94-75-51-77-95-72-68-63-53-52-69-93-87-78-83-71-59-61-92-62-89-74-91-85-54-70,7382156686,22153,25601,47754
ils,kroA100,99-84-67-82-56-86-50-76-97-90-73-58-98-65-64-96-55-79-88-66-57-60-80-81-94-75-51-77-95-72-68-63-53-52-69-93-87-78-83-71-59-61-92-62-89-74-91-85-54-70,0-5-9-37-35-20-31-44-22-34-26-11-19-46-15-21-17-23-16-14-10-48-18-3-25-30-41-7-27-39-1-43-49-4-36-32-12-38-29-28-42-40-47-13-2-45-33-6-8-24,8788017260,25601,22153,47754
ils,kroA100,0-5-9-37-35-20-31-44-22-34-26-11-19-46-15-21-17-23-16-14-10-48-18-3-25-30-41-7-27-39-1-43-49-4-36-32-12-38-29-28-42-40-47-13-2-45-33-6-8-24,99-84-67-82-56-86-50-76-97-90-73-58-98-65-64-96-55-79-88-66-57-60-80-81-94-75-51-77-95-72-68-63-53-52-69-93-87-78-83-71-59-61-92-62-89-74-91-85-54-70,7702912020,22153,25601,47754
ils,kroA100,0-5-9-37-35-20-31-44-22-34-26-11-19-46-15-21-17-23-16-14-10-48-18-3-25-30-41-7-27-39-1-43-49-4-36-32-12-38-29-28-42-40-47-13-2-45-33-6-8-24,99-84-67-82-56-86-50-76-97-90-73-58-98-65-64-96-55-79-88-66-57-60-80-81-94-75-51-77-95-72-68-63-53-52-69-93-87-78-83-71-59-61-92-62-89-74-91-85-54-70,11180122152,22153,25601,47754
ils,kroA100,99-84-67-82-56-86-50-76-97-90-73-58-98-65-64-96-55-79-88-66-57-60-80-81-94-75-51-77-95-72-68-63-53-52-69-93-87-78-83-71-59-61-92-62-89-74-91-85-54-70,0-5-9-37-35-20-31-44-22-34-26-11-19-46-15-21-17-23-16-14-10-48-18-3-25-30-41-7-27-39-1-43-49-4-36-32-12-38-29-28-42-40-47-13-2-45-33-6-8-24,7848342123,25601,22153,47754
ils,kroA100,99-84-67-82-56-86-50-76-97-90-73-58-98-65-64-96-55-79-88-66-57-60-80-81-94-75-51-77-95-72-68-63-53-52-69-93-87-78-83-71-59-61-92-62-89-74-91-85-54-70,0-5-9-37-35-20-31-44-22-34-26-11-19-46-15-21-17-23-16-14-10-48-18-3-25-30-41-7-27-39-1-43-49-4-36-32-12-38-29-28-42-40-47-13-2-45-33-6-8-24,7588813429,25601,22153,47754
ils,kroA100,65-69-93-71-20-16-14-10-31-59-34-85-11-54-8-62-48-15-18-91-7-41-30-66-53-39-67-75-36-95-51-99-2-28-46-83-17-37-58-73-90-86-50-24-80-60-96-3-64-25,88-81-94-12-32-4-77-82-26-19-61-76-57-68-63-1-43-49-72-27-92-6-33-45-42-40-70-13-47-29-38-84-56-22-97-44-35-98-23-78-87-21-52-89-9-5-0-74-55-79,7662099869,24434,21242,45676
ils,kroA100,0-5-9-37-35-20-31-44-22-34-26-11-19-46-15-21-17-23-16-14-10-48-18-3-25-30-41-7-27-39-1-43-49-4-36-32-12-38-29-28-42-40-47-13-2-45-33-6-8-24,99-84-67-82-56-86-50-76-97-90-73-58-98-65-64-96-55-79-88-66-57-60-80-81-94-75-51-77-95-72-68-63-53-52-69-93-87-78-83-71-59-61-92-62-89-74-91-85-54-70,7900886929,22153,25601,47754
ils,kroA100,0-5-9-37-35-20-31-44-22-34-26-11-19-46-15-21-17-23-16-14-10-48-18-3-25-30-41-7-27-39-1-43-49-4-36-32-12-38-29-28-42-40-47-13-2-45-33-6-8-24,99-84-67-82-56-86-50-76-97-90-73-58-98-65-64-96-55-79-88-66-57-60-80-81-94-75-51-77-95-72-68-63-53-52-69-93-87-78-83-71-59-61-92-62-89-74-91-85-54-70,7394113102,22153,25601,47754
ils,kroA100,0-5-9-37-35-20-31-44-22-34-26-11-19-46-15-21-17-23-16-14-10-48-18-3-25-30-41-7-27-39-1-43-49-4-36-32-12-38-29-28-42-40-47-13-2-45-33-6-8-24,99-84-67-82-56-86-50-76-97-90-73-58-98-65-64-96-55-79-88-66-57-60-80-81-94-75-51-77-95-72-68-63-53-52-69-93-87-78-83-71-59-61-92-62-89-74-91-85-54-70,7598806442,22153,25601,47754
ils,kroA100,0-5-9-37-35-20-31-44-22-34-26-11-19-46-15-21-17-23-16-14-10-48-18-3-25-30-41-7-27-39-1-43-49-4-36-32-12-38-29-28-42-40-47-13-2-45-33-6-8-24,99-84-67-82-56-86-50-76-97-90-73-58-98-65-64-96-55-79-88-66-57-60-80-81-94-75-51-77-95-72-68-63-53-52-69-93-87-78-83-71-59-61-92-62-89-74-91-85-54-70,7747506783,22153,25601,47754
ils,kroA100,99-84-67-82-56-86-50-76-97-90-73-58-98-65-64-96-55-79-88-66-57-60-80-81-94-75-51-77-95-72-68-63-53-52-69-93-87-78-83-71-59-61-92-62-89-74-91-85-54-70,0-5-9-37-35-20-31-44-22-34-26-11-19-46-15-21-17-23-16-14-10-48-18-3-25-30-41-7-27-39-1-43-49-4-36-32-12-38-29-28-42-40-47-13-2-45-33-6-8-24,7715719336,25601,22153,47754
ils,kroA100,99-84-67-82-56-86-50-76-97-90-73-58-98-65-64-96-55-79-88-66-57-60-80-81-94-75-51-77-95-72-68-63-53-52-69-93-87-78-83-71-59-61-92-62-89-74-91-85-54-70,0-5-9-37-35-20-31-44-22-34-26-11-19-46-15-21-17-23-16-14-10-48-18-3-25-30-41-7-27-39-1-43-49-4-36-32-12-38-29-28-42-40-47-13-2-45-33-6-8-24,7397388538,25601,22153,47754
ils,kroA100,99-84-67-82-56-86-50-76-97-90-73-58-98-65-64-96-55-79-88-66-57-60-80-81-94-75-51-77-95-72-68-63-53-52-69-93-87-78-83-71-59-61-92-62-89-74-91-85-54-70,0-5-9-37-35-20-31-44-22-34-26-11-19-46-15-21-17-23-16-14-10-48-18-3-25-30-41-7-27-39-1-43-49-4-36-32-12-38-29-28-42-40-47-13-2-45-33-6-8-24,7320546669,25601,22153,47754
ils,kroA100,99-84-67-82-56-86-50-76-97-90-73-58-98-65-64-96-55-79-88-66-57-60-80-81-94-75-51-77-95-72-68-63-53-52-69-93-87-78-83-71-59-61-92-62-89-74-91-85-54-70,0-5-9-37-35-20-31-44-22-34-26-11-19-46-15-21-17-23-16-14-10-48-18-3-25-30-41-7-27-39-1-43-49-4-36-32-12-38-29-28-42-40-47-13-2-45-33-6-8-24,7489705406,25601,22153,47754
ils,kroA100,0-5-9-37-35-20-31-44-22-34-26-11-19-46-15-21-17-23-16-14-10-48-18-3-25-30-41-7-27-39-1-43-49-4-36-32-12-38-29-28-42-40-47-13-2-45-33-6-8-24,99-84-67-82-56-86-50-76-97-90-73-58-98-65-64-96-55-79-88-66-57-60-80-81-94-75-51-77-95-72-68-63-53-52-69-93-87-78-83-71-59-61-92-62-89-74-91-85-54-70,7476331168,22153,25601,47754
ils,kroA100,99-84-67-82-56-86-50-76-97-90-73-58-98-65-64-96-55-79-88-66-57-60-80-81-94-75-51-77-95-72-68-63-53-52-69-93-87-78-83-71-59-61-92-62-89-74-91-85-54-70,0-5-9-37-35-20-31-44-22-34-26-11-19-46-15-21-17-23-16-14-10-48-18-3-25-30-41-7-27-39-1-43-49-4-36-32-12-38-29-28-42-40-47-13-2-45-33-6-8-24,7522521221,25601,22153,47754
ils,kroA100,60-92-61-59-44-31-35-37-93-21-87-78-9-89-48-18-65-25-96-79-88-7-0-43-67-84-95-2-40-70-77-32-75-12-94-81-20-73-58-14-34-85-26-6-8-56-86-50-24-68,38-63-39-41-30-53-1-49-72-80-76-22-46-71-62-5-91-74-55-66-54-82-33-45-42-13-99-47-29-57-27-97-90-10-16-98-23-17-52-3-64-69-15-83-19-11-28-51-4-36,7689794287,22590,25250,47840
ils,kroA100,0-5-9-37-35-20-31-44-22-34-26-11-19-46-15-21-17-23-16-14-10-48-18-3-25-30-41-7-27-39-1-43-49-4-36-32-12-38-29-28-42-40-47-13-2-45-33-6-8-24,99-84-67-82-56-86-50-76-97-90-73-58-98-65-64-96-55-79-88-66-57-60-80-81-94-75-51-77-95-72-68-63-53-52-69-93-87-78-83-71-59-61-92-62-89-74-91-85-54-70,7350481983,22153,25601,47754
ils,kroA100,0-5-9-37-35-20-31-44-22-34-26-11-19-46-15-21-17-23-16-14-10-48-18-3-25-30-41-7-27-39-1-43-49-4-36-32-12-38-29-28-42-40-47-13-2-45-33-6-8-24,99-84-67-82-56-86-50-76-97-90-73-58-98-65-64-96-55-79-88-66-57-60-80-81-94-75-51-77-95-72-68-63-53-52-69-93-87-78-83-71-59-61-92-62-89-74-91-85-54-70,7464964218,22153,25601,47754
ils,kroA100,19-54-45-33-8-86-66-88-30-79-7-0-63-43-57-92-97-61-26-42-2-13-40-99-47-32-75-81-38-84-24-18-69-21-87-93-23-83-9-71-16-10-5-48-65-25-64-96-46-44,80-50-95-77-51-4-36-12-94-49-6-56-11-85-76-90-58-35-98-37-17-15-78-89-27-60-1-39-53-41-55-3-52-74-91-62-20-73-14-31-22-59-34-82-28-70-29-67-72-68,7440830959,24926,22435,47361
ils,kroA100,99-84-67-82-56-86-50-76-97-90-73-58-98-65-64-96-55-79-88-66-57-60-80-81-94-75-51-77-95-72-68-63-53-52-69-93-87-78-83-71-59-61-92-62-89-74-91-85-54-70,0-5-9-37-35-20-31-44-22-34-26-11-19-46-15-21-17-23-16-14-10-48-18-3-25-30-41-7-27-39-1-43-49-4-36-32-12-38-29-28-42-40-47-13-2-45-33-6-8-24,7409348643,25601,22153,47754
ils,kroA100,99-84-67-82-56-86-50-76-97-90-73-58-98-65-64-96-55-79-88-66-57-60-80-81-94-75-51-77-95-72-68-63-53-52-69-93-87-78-83-71-59-61-92-62-89-74-91-85-54-70,0-5-9-37-35-20-31-44-22-34-26-11-19-46-15-21-17-23-16-14-10-48-18-3-25-30-41-7-27-39-1-43-49-4-36-32-12-38-29-28-42-40-47-13-2-45-33-6-8-24,7386596126,25601,22153,47754
ils,kroA100,99-84-67-82-56-86-50-76-97-90-73-58-98-65-64-96-55-79-88-66-57-60-80-81-94-75-51-77-95-72-68-63-53-52-69-93-87-78-83-71-59-61-92-62-89-74-91-85-54-70,0-5-9-37-35-20-31-44-22-34-26-11-19-46-15-21-17-23-16-14-10-48-18-3-25-30-41-7-27-39-1-43-49-4-36-32-12-38-29-28-42-40-47-13-2-45-33-6-8-24,7277607945,25601,22153,47754
ils,kroA100,0-5-9-37-35-20-31-44-22-34-26-11-19-46-15-21-17-23-16-14-10-48-18-3-25-30-41-7-27-39-1-43-49-4-36-32-12-38-29-28-42-40-47-13-2-45-33-6-8-24,99-84-67-82-56-86-50-76-97-90-73-58-98-65-64-96-55-79-88-66-57-60-80-81-94-75-51-77-95-72-68-63-53-52-69-93-87-78-83-71-59-61-92-62-89-74-91-85-54-70,7286723329,22153,25601,47754
ils,kroA100,11-19-26-85-34-59-9-89-3-65-64-79-30-88-27-92-90-22-68-94-32-36-4-95-77-47-70-40-42-76-20-35-98-23-17-78-87-15-21-69-52-18-66-80-50-86-56-6-82-54,58-73-71-83-62-12-75-81-1-53-48-5-46-31-97-60-57-0-91-74-96-7-72-38-51-99-13-29-49-43-63-39-41-55-25-93-37-16-14-10-44-61-8-33-45-2-28-84-67-24,7243668694,20508,28397,48905
ils,kroA100,0-5-9-37-35-20-31-44-22-34-26-11-19-46-15-21-17-23-16-14-10-48-18-3-25-30-41-7-27-39-1-43-49-4-36-32-12-38-29-28-42-40-47-13-2-45-33-6-8-24,99-84-67-82-56-86-50-76-97-90-73-58-98-65-64-96-55-79-88-66-57-60-80-81-94-75-51-77-95-72-68-63-53-52-69-93-87-78-83-71-59-61-92-62-89-74-91-85-54-70,7295604270,22153,25601,47754
ils,kroA100,99-84-67-82-56-86-50-76-97-90-73-58-98-65-64-96-55-79-88-66-57-60-80-81-94-75-51-77-95-72-68-63-53-52-69-93-87-78-83-71-59-61-92-62-89-74-91-85-54-70,0-5-9-37-35-20-31-44-22-34-26-11-19-46-15-21-17-23-16-14-10-48-18-3-25-30-41-7-27-39-1-43-49-4-36-32-12-38-29-28-42-40-47-13-2-45-33-6-8-24,7408148257,25601,22153,47754
ils,kroA100,0-5-9-37-35-20-31-44-22-34-26-11-19-46-15-21-17-23-16-14-10-48-18-3-25-30-41-7-27-39-1-43-49-4-36-32-12-38-29-28-42-40-47-13-2-45-33-6-8-24,99-84-67-82-56-86-50-76-97-90-73-58-98-65-64-96-55-79-88-66-57-60-80-81-94-75-51-77-95-72-68-63-53-52-69-93-87-78-83-71-59-61-92-62-89-74-91-85-54-70,7675249183,22153,25601,47754
ils,kroA100,0-5-9-37-35-20-31-44-22-34-26-11-19-46-15-21-17-23-16-14-10-48-18-3-25-30-41-7-27-39-1-43-49-4-36-32-12-38-29-28-42-40-47-13-2-45-33-6-8-24,99-84-67-82-56-86-50-76-97-90-73-58-98-65-64-96-55-79-88-66-57-60-80-81-94-75-51-77-95-72-68-63-53-52-69-93-87-78-83-71-59-61-92-62-89-74-91-85-54-70,7313801545,22153,25601,47754
ils,kroA100,0-5-9-37-35-20-31-44-22-34-26-11-19-46-15-21-17-23-16-14-10-48-18-3-25-30-41-7-27-39-1-43-49-4-36-32-12-38-29-28-42-40-47-13-2-45-33-6-8-24,99-84-67-82-56-86-50-76-97-90-73-58-98-65-64-96-55-79-88-66-57-60-80-81-94-75-51-77-95-72-68-63-53-52-69-93-87-78-83-71-59-61-92-62-89-74-91-85-54-70,7420235616,22153,25601,47754
ils,kroA100,99-84-67-82-56-86-50-76-97-90-73-58-98-65-64-96-55-79-88-66-57-60-80-81-94-75-51-77-95-72-68-63-53-52-69-93-87-78-83-71-59-61-92-62-89-74-91-85-54-70,0-5-9-37-35-20-31-44-22-34-26-11-19-46-15-21-17-23-16-14-10-48-18-3-25-30-41-7-27-39-1-43-49-4-36-32-12-38-29-28-42-40-47-13-2-45-33-6-8-24,7465222774,25601,22153,47754
ils,kroA100,0-5-9-37-35-20-31-44-22-34-26-11-19-46-15-21-17-23-16-14-10-48-18-3-25-30-41-7-27-39-1-43-49-4-36-32-12-38-29-28-42-40-47-13-2-45-33-6-8-24,99-84-67-82-56-86-50-76-97-90-73-58-98-65-64-96-55-79-88-66-57-60-80-81-94-75-51-77-95-72-68-63-53-52-69-93-87-78-83-71-59-61-92-62-89-74-91-85-54-70,8006972145,22153,25601,47754
ils,kroA100,92-0-15-87-17-98-58-20-89-48-91-74-96-55-7-27-57-60-86-56-54-26-59-22-44-14-78-52-64-30-41-88-63-49-84-77-29-28-33-82-45-99-4-12-75-94-81-1-68-80,25-69-21-93-23-37-35-16-34-42-40-70-47-38-43-72-67-24-50-62-46-90-97-76-61-85-19-11-6-8-31-10-73-71-83-9-5-18-65-3-66-32-36-95-51-13-2-39-53-79,7887240714,22654,25753,48407
ils,kroA100,17-98-35-16-14-31-74-55-7-66-63-67-29-47-2-82-6-8-86-80-72-43-12-32-75-53-3-64-25-69-87-78-44-97-76-34-85-11-54-51-4-36-57-27-92-62-89-73-58-83,91-5-48-18-96-79-30-41-88-1-49-81-94-99-40-70-13-42-45-26-61-59-19-56-50-33-28-77-95-38-84-0-9-93-21-15-65-52-23-37-71-20-10-46-90-22-60-24-68-39,7817712553,25602,22670,48272
ils,kroA100,99-84-67-82-56-86-50-76-97-90-73-58-98-65-64-96-55-79-88-66-57-60-80-81-94-75-51-77-95-72-68-63-53-52-69-93-87-78-83-71-59-61-92-62-89-74-91-85-54-70,0-5-9-37-35-20-31-44-22-34-26-11-19-46-15-21-17-23-16-14-10-48-18-3-25-30-41-7-27-39-1-43-49-4-36-32-12-38-29-28-42-40-47-13-2-45-33-6-8-24,7134892927,25601,22153,47754
ils,kroA100,99-84-67-82-56-86-50-76-97-90-73-58-98-65-64-96-55-79-88-66-57-60-80-81-94-75-51-77-95-72-68-63-53-52-69-93-87-78-83-71-59-61-92-62-89-74-91-85-54-70,0-5-9-37-35-20-31-44-22-34-26-11-19-46-15-21-17-23-16-14-10-48-18-3-25-30-41-7-27-39-1-43-49-4-36-32-12-38-29-28-42-40-47-13-2-45-33-6-8-24,7692081022,25601,22153,47754
ils,kroA100,99-84-67-82-56-86-50-76-97-90-73-58-98-65-64-96-55-79-88-66-57-60-80-81-94-75-51-77-95-72-68-63-53-52-69-93-87-78-83-71-59-61-92-62-89-74-91-85-54-70,0-5-9-37-35-20-31-44-22-34-26-11-19-46-15-21-17-23-16-14-10-48-18-3-25-30-41-7-27-39-1-43-49-4-36-32-12-38-29-28-42-40-47-13-2-45-33-6-8-24,7368175548,25601,22153,47754
ils,kroA100,0-5-9-37-35-20-31-44-22-34-26-11-19-46-15-21-17-23-16-14-10-48-18-3-25-30-41-7-27-39-1-43-49-4-36-32-12-38-29-28-42-40-47-13-2-45-33-6-8-24,99-84-67-82-56-86-50-76-97-90-73-58-98-65-64-96-55-79-88-66-57-60-80-81-94-75-51-77-95-72-68-63-53-52-69-93-87-78-83-71-59-61-92-62-89-74-91-85-54-70,8312414653,22153,25601,47754
ils,kroA100,20-11-54-82-45-42-2-70-47-51-36-75-49-39-53-0-5-89-71-35-98-23-17-78-93-21-87-18-96-79-30-88-27-86-6-8-67-72-80-50-44-31-46-65-25-19-26-59-14-73,84-38-4-77-95-29-28-13-99-40-33-56-92-62-83-37-52-15-69-64-3-55-74-91-7-41-63-1-81-94-12-32-43-68-66-48-9-58-16-10-61-34-85-76-22-97-90-57-60-24,7734214653,24982,21754,46736
ils,kroA100,0-5-9-37-35-20-31-44-22-34-26-11-19-46-15-21-17-23-16-14-10-48-18-3-25-30-41-7-27-39-1-43-49-4-36-32-12-38-29-28-42-40-47-13-2-45-33-6-8-24,99-84-67-82-56-86-50-76-97-90-73-58-98-65-64-96-55-79-88-66-57-60-80-81-94-75-51-77-95-72-68-63-53-52-69-93-87-78-83-71-59-61-92-62-89-74-91-85-54-70,7897941878,22153,25601,47754
ils,kroA100,0-5-9-37-35-20-31-44-22-34-26-11-19-46-15-21-17-23-16-14-10-48-18-3-25-30-41-7-27-39-1-43-49-4-36-32-12-38-29-28-42-40-47-13-2-45-33-6-8-24,99-84-67-82-56-86-50-76-97-90-73-58-98-65-64-96-55-79-88-66-57-60-80-81-94-75-51-77-95-72-68-63-53-52-69-93-87-78-83-71-59-61-92-62-89-74-91-85-54-70,7504241593,22153,25601,47754
ils,kroA100,0-5-9-37-35-20-31-44-22-34-26-11-19-46-15-21-17-23-16-14-10-48-18-3-25-30-41-7-27-39-1-43-49-4-36-32-12-38-29-28-42-40-47-13-2-45-33-6-8-24,99-84-67-82-56-86-50-76-97-90-73-58-98-65-64-96-55-79-88-66-57-60-80-81-94-75-51-77-95-72-68-63-53-52-69-93-87-78-83-71-59-61-92-62-89-74-91-85-54-70,7332098619,22153,25601,47754
ils,kroA100,24-60-50-8-56-97-90-20-35-98-37-9-0-19-11-6-68-63-53-88-55-25-69-93-87-89-5-62-91-74-3-52-78-83-71-16-14-22-26-82-33-45-70-99-77-32-75-94-43-72,21-15-18-7-41-66-39-1-67-84-38-95-51-47-40-13-2-42-54-86-92-27-57-80-49-81-12-36-4-29-28-85-34-61-76-59-44-31-10-46-30-79-96-64-65-48-73-58-23-17,7456969217,21855,21134,42989
ils,kroA100,0-5-9-37-35-20-31-44-22-34-26-11-19-46-15-21-17-23-16-14-10-48-18-3-25-30-41-7-27-39-1-43-49-4-36-32-12-38-29-28-42-40-47-13-2-45-33-6-8-24,99-84-67-82-56-86-50-76-97-90-73-58-98-65-64-96-55-79-88-66-57-60-80-81-94-75-51-77-95-72-68-63-53-52-69-93-87-78-83-71-59-61-92-62-89-74-91-85-54-70,7339379604,22153,25601,47754
ils,kroA100,99-84-67-82-56-86-50-76-97-90-73-58-98-65-64-96-55-79-88-66-57-60-80-81-94-75-51-77-95-72-68-63-53-52-69-93-87-78-83-71-59-61-92-62-89-74-91-85-54-70,0-5-9-37-35-20-31-44-22-34-26-11-19-46-15-21-17-23-16-14-10-48-18-3-25-30-41-7-27-39-1-43-49-4-36-32-12-38-29-28-42-40-47-13-2-45-33-6-8-24,9289315578,25601,22153,47754
ils,kroA100,99-84-67-82-56-86-50-76-97-90-73-58-98-65-64-96-55-79-88-66-57-60-80-81-94-75-51-77-95-72-68-63-53-52-69-93-87-78-83-71-59-61-92-62-89-74-91-85-54-70,0-5-9-37-35-20-31-44-22-34-26-11-19-46-15-21-17-23-16-14-10-48-18-3-25-30-41-7-27-39-1-43-49-4-36-32-12-38-29-28-42-40-47-13-2-45-33-6-8-24,8113585919,25601,22153,47754
ils,kroA100,99-84-67-82-56-86-50-76-97-90-73-58-98-65-64-96-55-79-88-66-57-60-80-81-94-75-51-77-95-72-68-63-53-52-69-93-87-78-83-71-59-61-92-62-89-74-91-85-54-70,0-5-9-37-35-20-31-44-22-34-26-11-19-46-15-21-17-23-16-14-10-48-18-3-25-30-41-7-27-39-1-43-49-4-36-32-12-38-29-28-42-40-47-13-2-45-33-6-8-24,7693053180,25601,22153,47754
ils,kroA100,0-5-9-37-35-20-31-44-22-34-26-11-19-46-15-21-17-23-16-14-10-48-18-3-25-30-41-7-27-39-1-43-49-4-36-32-12-38-29-28-42-40-47-13-2-45-33-6-8-24,99-84-67-82-56-86-50-76-97-90-73-58-98-65-64-96-55-79-88-66-57-60-80-81-94-75-51-77-95-72-68-63-53-52-69-93-87-78-83-71-59-61-92-62-89-74-91-85-54-70,7438162276,22153,25601,47754
ils,kroA100,0-5-9-37-35-20-31-44-22-34-26-11-19-46-15-21-17-23-16-14-10-48-18-3-25-30-41-7-27-39-1-43-49-4-36-32-12-38-29-28-42-40-47-13-2-45-33-6-8-24,99-84-67-82-56-86-50-76-97-90-73-58-98-65-64-96-55-79-88-66-57-60-80-81-94-75-51-77-95-72-68-63-53-52-69-93-87-78-83-71-59-61-92-62-89-74-91-85-54-70,7231527619,22153,25601,47754
ils,kroA100,0-5-9-37-35-20-31-44-22-34-26-11-19-46-15-21-17-23-16-14-10-48-18-3-25-30-41-7-27-39-1-43-49-4-36-32-12-38-29-28-42-40-47-13-2-45-33-6-8-24,99-84-67-82-56-86-50-76-97-90-73-58-98-65-64-96-55-79-88-66-57-60-80-81-94-75-51-77-95-72-68-63-53-52-69-93-87-78-83-71-59-61-92-62-89-74-91-85-54-70,7347752978,22153,25601,47754
ils,kroA100,99-84-67-82-56-86-50-76-97-90-73-58-98-65-64-96-55-79-88-66-57-60-80-81-94-75-51-77-95-72-68-63-53-52-69-93-87-78-83-71-59-61-92-62-89-74-91-85-54-70,0-5-9-37-35-20-31-44-22-34-26-11-19-46-15-21-17-23-16-14-10-48-18-3-25-30-41-7-27-39-1-43-49-4-36-32-12-38-29-28-42-40-47-13-2-45-33-6-8-24,7419728035,25601,22153,47754
ils,kroA100,99-84-67-82-56-86-50-76-97-90-73-58-98-65-64-96-55-79-88-66-57-60-80-81-94-75-51-77-95-72-68-63-53-52-69-93-87-78-83-71-59-61-92-62-89-74-91-85-54-70,0-5-9-37-35-20-31-44-22-34-26-11-19-46-15-21-17-23-16-14-10-48-18-3-25-30-41-7-27-39-1-43-49-4-36-32-12-38-29-28-42-40-47-13-2-45-33-6-8-24,7627789572,25601,22153,47754
ils,kroA100,0-5-9-37-35-20-31-44-22-34-26-11-19-46-15-21-17-23-16-14-10-48-18-3-25-30-41-7-27-39-1-43-49-4-36-32-12-38-29-28-42-40-47-13-2-45-33-6-8-24,99-84-67-82-56-86-50-76-97-90-73-58-98-65-64-96-55-79-88-66-57-60-80-81-94-75-51-77-95-72-68-63-53-52-69-93-87-78-83-71-59-61-92-62-89-74-91-85-54-70,7482677177,22153,25601,47754
ils,kroA100,0-5-9-37-35-20-31-44-22-34-26-11-19-46-15-21-17-23-16-14-10-48-18-3-25-30-41-7-27-39-1-43-49-4-36-32-12-38-29-28-42-40-47-13-2-45-33-6-8-24,99-84-67-82-56-86-50-76-97-90-73-58-98-65-64-96-55-79-88-66-57-60-80-81-94-75-51-77-95-72-68-63-53-52-69-93-87-78-83-71-59-61-92-62-89-74-91-85-54-70,7456993451,22153,25601,47754
ils,kroA100,99-84-67-82-56-86-50-76-97-90-73-58-98-65-64-96-55-79-88-66-57-60-80-81-94-75-51-77-95-72-68-63-53-52-69-93-87-78-83-71-59-61-92-62-89-74-91-85-54-70,0-5-9-37-35-20-31-44-22-34-26-11-19-46-15-21-17-23-16-14-10-48-18-3-25-30-41-7-27-39-1-43-49-4-36-32-12-38-29-28-42-40-47-13-2-45-33-6-8-24,7451996471,25601,22153,47754
ils,kroA100,99-84-67-82-56-86-50-76-97-90-73-58-98-65-64-96-55-79-88-66-57-60-80-81-94-75-51-77-95-72-68-63-53-52-69-93-87-78-83-71-59-61-92-62-89-74-91-85-54-70,0-5-9-37-35-20-31-44-22-34-26-11-19-46-15-21-17-23-16-14-10-48-18-3-25-30-41-7-27-39-1-43-49-4-36-32-12-38-29-28-42-40-47-13-2-45-33-6-8-24,9222605707,25601,22153,47754
ils,kroA100,99-84-67-82-56-86-50-76-97-90-73-58-98-65-64-96-55-79-88-66-57-60-80-81-94-75-51-77-95-72-68-63-53-52-69-93-87-78-83-71-59-61-92-62-89-74-91-85-54-70,0-5-9-37-35-20-31-44-22-34-26-11-19-46-15-21-17-23-16-14-10-48-18-3-25-30-41-7-27-39-1-43-49-4-36-32-12-38-29-28-42-40-47-13-2-45-33-6-8-24,9136836622,25601,22153,47754
ils,kroA100,99-84-67-82-56-86-50-76-97-90-73-58-98-65-64-96-55-79-88-66-57-60-80-81-94-75-51-77-95-72-68-63-53-52-69-93-87-78-83-71-59-61-92-62-89-74-91-85-54-70,0-5-9-37-35-20-31-44-22-34-26-11-19-46-15-21-17-23-16-14-10-48-18-3-25-30-41-7-27-39-1-43-49-4-36-32-12-38-29-28-42-40-47-13-2-45-33-6-8-24,9373841195,25601,22153,47754
ils,kroA100,0-5-9-37-35-20-31-44-22-34-26-11-19-46-15-21-17-23-16-14-10-48-18-3-25-30-41-7-27-39-1-43-49-4-36-32-12-38-29-28-42-40-47-13-2-45-33-6-8-24,99-84-67-82-56-86-50-76-97-90-73-58-98-65-64-96-55-79-88-66-57-60-80-81-94-75-51-77-95-72-68-63-53-52-69-93-87-78-83-71-59-61-92-62-89-74-91-85-54-70,8913470766,22153,25601,47754
ils,kroA100,0-5-9-37-35-20-31-44-22-34-26-11-19-46-15-21-17-23-16-14-10-48-18-3-25-30-41-7-27-39-1-43-49-4-36-32-12-38-29-28-42-40-47-13-2-45-33-6-8-24,99-84-67-82-56-86-50-76-97-90-73-58-98-65-64-96-55-79-88-66-57-60-80-81-94-75-51-77-95-72-68-63-53-52-69-93-87-78-83-71-59-61-92-62-89-74-91-85-54-70,7478182430,22153,25601,47754
ils,kroA100,0-5-9-37-35-20-31-44-22-34-26-11-19-46-15-21-17-23-16-14-10-48-18-3-25-30-41-7-27-39-1-43-49-4-36-32-12-38-29-28-42-40-47-13-2-45-33-6-8-24,99-84-67-82-56-86-50-76-97-90-73-58-98-65-64-96-55-79-88-66-57-60-80-81-94-75-51-77-95-72-68-63-53-52-69-93-87-78-83-71-59-61-92-62-89-74-91-85-54-70,7305055222,22153,25601,47754
ils,kroA100,0-5-9-37-35-20-31-44-22-34-26-11-19-46-15-21-17-23-16-14-10-48-18-3-25-30-41-7-27-39-1-43-49-4-36-32-12-38-29-28-42-40-47-13-2-45-33-6-8-24,99-84-67-82-56-86-50-76-97-90-73-58-98-65-64-96-55-79-88-66-57-60-80-81-94-75-51-77-95-72-68-63-53-52-69-93-87-78-83-71-59-61-92-62-89-74-91-85-54-70,7091088544,22153,25601,47754
ils,kroA100,60-8-49-81-94-75-32-4-22-44-14-16-10-20-71-98-21-69-65-3-9-46-92-6-45-54-11-26-85-61-59-42-2-13-70-51-77-29-57-27-83-78-15-74-41-30-88-53-39-63,87-93-25-64-96-67-84-38-36-12-43-1-79-55-62-31-90-97-76-34-19-86-50-24-80-0-18-52-17-23-37-35-58-73-89-48-5-91-7-66-68-72-95-47-99-40-28-33-82-56,8637789199,25024,25387,50411
ils,kroA100,99-84-67-82-56-86-50-76-97-90-73-58-98-65-64-96-55-79-88-66-57-60-80-81-94-75-51-77-95-72-68-63-53-52-69-93-87-78-83-71-59-61-92-62-89-74-91-85-54-70,0-5-9-37-35-20-31-44-22-34-26-11-19-46-15-21-17-23-16-14-10-48-18-3-25-30-41-7-27-39-1-43-49-4-36-32-12-38-29-28-42-40-47-13-2-45-33-6-8-24,8095503154,25601,22153,47754
ils,kroA100,0-5-9-37-35-20-31-44-22-34-26-11-19-46-15-21-17-23-16-14-10-48-18-3-25-30-41-7-27-39-1-43-49-4-36-32-12-38-29-28-42-40-47-13-2-45-33-6-8-24,99-84-67-82-56-86-50-76-97-90-73-58-98-65-64-96-55-79-88-66-57-60-80-81-94-75-51-77-95-72-68-63-53-52-69-93-87-78-83-71-59-61-92-62-89-74-91-85-54-70,8262954155,22153,25601,47754
ils,kroA100,0-5-9-37-35-20-31-44-22-34-26-11-19-46-15-21-17-23-16-14-10-48-18-3-25-30-41-7-27-39-1-43-49-4-36-32-12-38-29-28-42-40-47-13-2-45-33-6-8-24,99-84-67-82-56-86-50-76-97-90-73-58-98-65-64-96-55-79-88-66-57-60-80-81-94-75-51-77-95-72-68-63-53-52-69-93-87-78-83-71-59-61-92-62-89-74-91-85-54-70,9106261877,22153,25601,47754
ils,kroA100,72-63-39-1-70-40-99-47-95-84-8-44-10-73-35-98-93-15-87-18-74-7-41-88-66-60-24-67-49-81-94-12-75-32-36-77-2-42-45-11-85-92-91-55-65-69-78-46-50-80,26-19-56-86-68-53-30-79-52-89-97-6-54-82-33-28-13-29-38-51-4-43-96-3-64-25-21-17-23-37-83-9-31-90-22-59-61-76-57-27-0-62-5-48-71-20-58-16-14-34,8053618124,23361,21695,45056
ils,kroA100,99-84-67-82-56-86-50-76-97-90-73-58-98-65-64-96-55-79-88-66-57-60-80-81-94-75-51-77-95-72-68-63-53-52-69-93-87-78-83-71-59-61-92-62-89-74-91-85-54-70,0-5-9-37-35-20-31-44-22-34-26-11-19-46-15-21-17-23-16-14-10-48-18-3-25-30-41-7-27-39-1-43-49-4-36-32-12-38-29-28-42-40-47-13-2-45-33-6-8-24,7605305974,25601,22153,47754
ils,kroA100,0-5-9-37-35-20-31-44-22-34-26-11-19-46-15-21-17-23-16-14-10-48-18-3-25-30-41-7-27-39-1-43-49-4-36-32-12-38-29-28-42-40-47-13-2-45-33-6-8-24,99-84-67-82-56-86-50-76-97-90-73-58-98-65-64-96-55-79-88-66-57-60-80-81-94-75-51-77-95-72-68-63-53-52-69-93-87-78-83-71-59-61-92-62-89-74-91-85-54-70,7991727006,22153,25601,47754
ils,kroA100,0-5-9-37-35-20-31-44-22-34-26-11-19-46-15-21-17-23-16-14-10-48-18-3-25-30-41-7-27-39-1-43-49-4-36-32-12-38-29-28-42-40-47-13-2-45-33-6-8-24,99-84-67-82-56-86-50-76-97-90-73-58-98-65-64-96-55-79-88-66-57-60-80-81-94-75-51-77-95-72-68-63-53-52-69-93-87-78-83-71-59-61-92-62-89-74-91-85-54-70,7497292074,22153,25601,47754
ils,kroA100,0-5-9-37-35-20-31-44-22-34-26-11-19-46-15-21-17-23-16-14-10-48-18-3-25-30-41-7-27-39-1-43-49-4-36-32-12-38-29-28-42-40-47-13-2-45-33-6-8-24,99-84-67-82-56-86-50-76-97-90-73-58-98-65-64-96-55-79-88-66-57-60-80-81-94-75-51-77-95-72-68-63-53-52-69-93-87-78-83-71-59-61-92-62-89-74-91-85-54-70,7808197970,22153,25601,47754
ils,kroA100,0-5-9-37-35-20-31-44-22-34-26-11-19-46-15-21-17-23-16-14-10-48-18-3-25-30-41-7-27-39-1-43-49-4-36-32-12-38-29-28-42-40-47-13-2-45-33-6-8-24,99-84-67-82-56-86-50-76-97-90-73-58-98-65-64-96-55-79-88-66-57-60-80-81-94-75-51-77-95-72-68-63-53-52-69-93-87-78-83-71-59-61-92-62-89-74-91-85-54-70,7090464706,22153,25601,47754
ils,kroA100,60-68-80-86-6-33-49-43-81-4-67-57-92-48-62-46-22-59-61-34-85-56-50-66-41-79-96-18-17-37-98-14-10-54-45-42-40-70-99-13-7-3-64-25-69-21-20-73-90-97,0-5-71-83-9-89-74-91-27-24-72-94-12-75-32-84-82-11-26-19-76-44-31-16-58-35-23-78-52-55-30-65-15-93-87-88-53-39-63-1-36-51-77-95-38-29-47-2-28-8,7183439949,25998,22942,48940
ils,kroA100,99-84-67-82-56-86-50-76-97-90-73-58-98-65-64-96-55-79-88-66-57-60-80-81-94-75-51-77-95-72-68-63-53-52-69-93-87-78-83-71-59-61-92-62-89-74-91-85-54-70,0-5-9-37-35-20-31-44-22-34-26-11-19-46-15-21-17-23-16-14-10-48-18-3-25-30-41-7-27-39-1-43-49-4-36-32-12-38-29-28-42-40-47-13-2-45-33-6-8-24,7251704252,25601,22153,47754
ils,kroA100,99-84-67-82-56-86-50-76-97-90-73-58-98-65-64-96-55-79-88-66-57-60-80-81-94-75-51-77-95-72-68-63-53-52-69-93-87-78-83-71-59-61-92-62-89-74-91-85-54-70,0-5-9-37-35-20-31-44-22-34-26-11-19-46-15-21-17-23-16-14-10-48-18-3-25-30-41-7-27-39-1-43-49-4-36-32-12-38-29-28-42-40-47-13-2-45-33-6-8-24,7205380771,25601,22153,47754
gc,kroA150,8-6-116-56-144-86-124-50-139-134-82-54-148-11-19-85-26-149-61-76-109-59-34-33-28-45-122-114-119-42-2-131-111-106-120-29-100-84-67-24-80-60-57-107-68-72-49-43-113-143-63-39-53-1-115-38-95-77-51-47-13-135-127-70-40-99-4-36-146-81-125-94-12-32-145,30-79-121-41-88-132-137-7-138-55-142-118-96-74-91-129-0-147-141-104-66-27-92-130-62-5-48-89-18-3-64-117-123-25-65-128-69-52-133-105-78-136-87-15-21-93-17-23-83-9-112-46-108-90-97-22-44-31-10-14-16-20-71-73-140-58-126-35-37-103-110-101-98-75-102,11008766,17675,21950,39625
gc,kroA150,9-83-71-112-89-105-78-136-17-23-37-35-126-20-73-140-58-10-16-14-31-108-46-62-5-48-74-18-133-52-87-15-21-93-69-65-3-96-91-0-129-7-138-55-142-118-64-117-123-25-128-103-98-101-110-90-97-44-22-130-92-27-141-104-147-66-57-107-60-50-124-86-144-109-76,80-24-68-72-67-84-139-134-116-8-6-56-19-11-54-82-33-148-26-85-149-61-59-34-119-114-122-45-28-111-106-120-29-100-38-49-113-143-63-39-53-43-1-115-81-125-94-146-95-77-51-4-36-102-145-32-12-75-131-2-42-135-13-47-99-70-40-127-137-132-88-41-121-30-79,11436385,19430,19992,39422
gc,kroA150,14-16-10-31-108-90-44-97-22-46-20-73-140-58-126-71-112-9-83-35-37-23-103-98-101-110-17-78-105-89-48-5-62-0-129-130-92-27-104-141-66-57-109-76-59-61-149-85-34-26-19-11-56-6-8-86-144-50-124-60-24-80-107-147-91-7-74-18-133-52-136-87-15-21-93,115-49-43-113-143-1-81-125-94-12-32-145-102-146-38-100-120-29-106-84-67-72-68-63-39-53-75-36-4-95-77-51-47-111-131-28-134-139-116-33-82-54-148-45-2-13-99-70-40-135-42-122-114-119-127-137-132-88-41-121-30-79-138-55-142-118-96-3-64-65-117-123-25-128-69,10713433,16288,21936,38224
gc,kroA150,13-2-135-70-99-40-47-131-28-45-42-122-127-111-106-29-120-100-38-95-77-51-4-36-146-84-134-33-82-54-148-114-119-11-116-6-8-139-144-86-56-19-26-85-34-149-61-59-76-109-50-124-24-80-67-72-49-115-81-125-94-12-145-102-32-75-43-113-143-63-68-60-57-107-66,3-64-65-123-25-117-118-96-142-55-138-74-18-52-133-87-15-21-69-128-93-136-78-105-89-48-5-62-91-7-41-121-79-30-88-132-137-147-141-129-0-112-9-83-17-23-37-103-110-101-98-35-71-20-73-140-58-126-10-46-130-92-27-104-108-31-90-97-22-44-14-16-39-53-1,11026579,17771,20949,38720
gc,kroA150,34-85-26-149-61-19-11-148-54-82-6-56-8-116-144-86-50-124-76-109-59-22-97-90-44-108-31-10-14-16-46-130-92-27-57-60-24-80-139-134-33-119-114-122-42-45-28-131-111-2-135-127-13-70-40-99-47-29-120-106-100-84-67-72-68-107-66-104-141-147-129-0-62-112-71,51-77-95-4-36-146-38-102-145-32-12-75-94-125-81-115-49-43-113-143-1-63-39-53-137-132-88-41-121-7-91-138-79-30-55-142-96-74-5-48-89-9-83-20-73-140-58-126-35-37-23-105-18-118-3-64-65-117-123-25-128-52-133-78-136-17-87-15-21-93-69-103-98-101-110,10848278,16885,20455,37340
gc,kroA150,137-132-88-41-121-30-79-138-7-147-141-104-66-107-57-27-92-129-0-91-55-142-118-96-74-18-48-5-62-130-46-112-89-105-133-52-3-64-117-123-25-65-128-69-15-87-136-78-9-83-71-20-73-140-58-10-31-108-90-97-22-109-76-60-24-80-68-63-39-53-143-113-43-1-72,33-82-54-148-11-116-6-8-56-144-86-139-134-28-45-2-42-122-114-119-26-85-19-149-34-61-59-50-124-111-131-13-135-127-70-40-99-47-29-120-106-100-38-84-67-49-115-146-95-77-51-4-36-102-145-32-12-75-94-125-81-44-14-16-126-35-37-23-17-103-98-101-110-93-21,10849252,17703,21142,38845
gc,kroA150,51-77-95-4-36-146-38-100-120-29-106-111-131-47-99-70-13-2-28-45-135-40-42-122-33-134-84-67-49-115-81-125-94-12-145-102-32-75-43-113-72-143-1-63-39-53-68-80-24-139-116-8-6-82-54-148-114-119-127-11-56-144-86-124-50-60-107-57-66-104-141-147-27-92-130,93-21-15-87-136-78-133-52-69-17-23-37-103-110-101-98-35-83-105-89-18-74-96-3-65-64-128-25-123-117-118-142-55-138-48-5-9-71-20-73-140-58-126-112-62-91-7-41-121-79-30-88-132-129-0-46-108-31-10-16-14-44-90-97-22-109-76-59-61-149-19-85-26-34-137,10696165,18485,19173,37658
gc,kroA150,11-26-85-19-56-6-8-116-54-82-148-33-134-139-144-86-124-50-60-24-80-149-34-61-59-76-109-22-97-90-44-108-31-10-14-16-46-130-92-27-57-107-68-67-84-111-28-45-122-114-119-42-2-131-13-135-127-70-40-99-47-106-120-29-100-38-95-77-51-4-36-146-49-72-113,142-55-138-96-118-79-30-121-41-88-7-91-74-18-3-64-65-117-123-25-128-69-52-133-105-89-48-5-62-0-129-141-147-132-137-104-66-112-9-83-78-136-87-15-21-93-17-23-37-103-35-71-20-73-140-58-126-98-101-110-39-53-63-143-1-43-115-81-125-94-12-75-32-145-102,10779463,16783,21737,38520
gc,kroA150,138-55-142-96-74-91-7-41-121-79-30-88-132-137-147-141-104-129-0-62-5-48-89-18-118-3-64-65-117-123-25-128-52-133-105-78-136-87-15-21-69-93-17-23-83-9-112-46-130-92-27-66-107-57-60-24-80-68-63-39-53-143-113-43-72-49-1-115-67-84-124-50-86-144-56,12-32-75-145-102-94-125-81-146-36-4-95-77-51-38-100-120-29-106-111-131-28-13-47-99-70-40-135-2-45-33-134-139-116-8-6-82-54-148-11-19-26-85-149-34-119-114-122-42-127-61-76-109-59-22-97-90-108-44-31-10-14-16-73-20-71-140-58-126-35-37-103-98-101-110,11372471,18521,18077,36598
gc,kroA150,54-82-148-11-26-85-19-6-116-8-56-33-134-139-144-86-124-50-60-24-80-67-84-111-28-45-122-114-119-42-2-131-13-135-127-70-40-99-47-29-120-106-100-38-95-77-51-4-36-146-49-72-68-107-57-76-109-149-34-61-59-22-97-90-44-108-31-130-92-27-104-66-141-147-129,46-112-62-0-5-48-89-9-71-20-73-140-58-10-14-16-126-83-105-78-136-133-52-18-74-91-7-138-55-142-96-118-121-41-88-132-137-30-79-3-64-65-87-15-21-93-17-23-37-35-103-98-101-110-69-128-123-25-117-39-63-53-143-113-43-1-115-81-125-94-12-32-145-102-75,10934468,17412,21716,39128
gc,kroA150,98-101-110-103-37-23-35-126-58-140-73-20-71-83-9-17-136-78-105-89-48-5-112-62-46-10-16-14-31-108-90-44-97-22-130-0-129-91-74-18-133-52-87-93-21-15-69-65-64-3-96-142-55-138-7-41-121-79-30-88-132-147-141-104-27-92-57-66-107-60-50-124-109-76-59,53-39-63-143-113-43-1-72-68-49-115-81-125-94-12-75-32-145-102-146-67-84-80-24-86-144-139-134-116-8-6-56-19-11-54-82-33-111-106-100-38-120-29-95-77-51-4-36-131-28-45-2-13-47-99-70-40-135-42-122-148-26-85-149-61-34-119-114-127-137-118-117-123-25-128,10838166,17109,21393,38502
gc,kroA150,80-24-60-124-50-86-144-139-134-67-84-72-68-107-57-66-104-141-27-92-130-109-76-56-8-6-116-82-54-33-148-11-19-85-26-149-61-59-22-97-90-108-31-44-46-0-129-147-63-39-143-113-43-49-115-1-53-137-132-88-41-121-7-91-62-5-48-112-71-20-73-10-14-16-140,93-21-15-87-136-78-133-52-69-17-23-37-103-110-101-98-35-83-105-89-18-74-96-3-65-64-128-25-123-117-118-142-55-138-79-30-9-126-58-34-119-114-122-45-28-111-131-106-120-29-100-38-146-81-125-94-12-32-145-102-36-4-95-77-51-47-13-2-42-127-135-70-40-99-75,10973652,18356,22651,41007
gc,kroA150,144-86-124-50-60-24-80-139-8-6-56-116-11-19-85-26-149-61-76-109-59-34-148-54-82-33-134-84-67-72-68-107-57-92-27-104-66-141-147-130-97-22-90-108-44-31-46-0-129-91-7-132-137-63-39-143-113-43-49-115-38-100-106-120-29-111-131-28-45-122-114-119-42-2-135,40-70-99-13-47-51-77-95-4-36-146-102-145-32-12-75-94-125-81-127-1-53-88-41-121-30-79-138-55-142-96-74-62-5-48-112-10-14-16-140-73-20-58-126-71-9-83-89-105-78-136-133-52-18-118-3-64-65-117-123-25-128-69-15-87-17-23-37-35-103-98-101-110-93-21,10946698,16883,23570,40453
gc,kroA150,135-2-42-122-45-28-131-13-70-40-99-47-111-106-29-120-100-38-95-77-51-4-36-146-84-134-33-82-54-148-114-119-127-11-26-85-19-6-116-8-56-139-144-86-124-50-24-80-67-72-49-43-113-143-68-60-149-34-61-59-76-109-22-97-90-44-108-31-10-14-16-130-57-107-66,147-141-104-27-92-129-0-91-7-41-121-132-137-88-30-79-138-55-142-96-74-5-48-62-46-112-89-105-18-118-3-64-65-117-123-25-128-52-133-78-136-87-15-21-93-17-9-83-71-20-73-140-58-126-35-37-23-103-110-101-98-69-39-63-53-1-115-81-125-94-12-75-32-145-102,11195963,18202,20815,39017
gc,kroA150,12-32-75-145-102-94-125-81-146-36-4-95-77-51-38-100-120-29-106-84-115-49-43-113-143-1-72-67-68-63-39-53-80-24-60-124-50-139-134-111-131-28-13-47-99-70-40-135-2-45-33-82-54-116-8-6-56-144-86-11-148-122-42-127-114-119-26-19-85-149-34-61-76-109-57,3-64-65-123-25-117-118-96-142-55-138-74-18-52-133-87-15-21-69-128-93-136-78-105-89-48-5-62-91-7-41-121-79-30-88-132-137-147-141-129-0-112-9-83-17-23-37-103-110-101-98-35-71-20-73-140-58-126-10-46-130-92-27-104-66-107-108-31-90-97-22-44-14-16-59,10737328,17728,19658,37386
gc,kroA150,85-26-34-149-19-11-148-54-82-6-56-8-116-144-86-50-124-61-59-76-109-22-97-90-44-108-31-10-14-16-46-130-92-27-57-60-24-80-139-134-33-119-114-122-42-45-28-131-111-2-135-127-13-70-40-99-47-106-120-29-100-84-67-72-68-107-66-104-141-147-129-0-62-112-71,43-113-143-1-49-115-81-125-94-12-75-32-145-102-146-38-95-77-51-4-36-63-39-53-137-132-88-41-121-30-79-7-91-138-55-142-118-96-74-5-48-89-105-18-3-64-65-117-123-25-128-52-133-78-136-9-83-20-73-140-58-126-35-37-23-17-87-15-21-93-69-103-98-101-110,12045759,16941,20122,37063
gc,kroA150,27-92-104-141-66-147-129-0-130-57-107-60-50-124-86-144-24-80-68-63-39-53-143-113-72-67-84-139-8-56-6-116-19-76-109-22-97-90-108-46-62-5-48-91-7-41-121-132-137-88-30-79-138-55-142-96-74-18-89-112-71-20-73-140-58-10-31-44-59-61-149-85-26-11-148,118-3-64-65-117-123-25-128-69-52-133-105-78-136-87-15-21-93-17-23-37-83-9-35-103-110-101-98-126-16-14-34-54-82-33-134-49-43-1-115-81-125-94-12-75-32-145-102-146-38-100-106-120-29-111-131-28-45-122-114-119-42-2-13-135-127-70-99-47-95-77-51-4-36-40,11548619,16809,21417,38226
gc,kroA150,104-141-66-147-27-92-57-107-60-24-80-68-63-39-53-143-113-72-49-43-1-137-132-88-41-121-7-129-0-91-62-5-48-130-46-108-90-97-22-109-76-59-61-149-19-50-124-86-144-56-8-6-116-139-134-67-84-106-120-29-100-38-115-81-125-94-146-95-77-51-111-33-82-54-11,25-123-117-128-64-65-3-118-142-96-55-138-74-18-52-133-69-21-15-87-93-136-78-105-89-9-83-17-23-37-103-110-101-98-35-71-112-20-73-140-58-126-10-16-14-31-44-79-30-85-26-34-148-119-114-122-45-28-131-2-42-135-13-47-99-70-40-127-4-36-12-75-32-145-102,11932081,17800,23132,40932
gc,kroA150,82-54-148-33-116-6-8-56-11-26-85-19-149-34-119-114-122-45-28-131-111-134-139-144-86-124-50-60-24-80-67-84-106-120-29-100-38-95-77-51-47-13-2-42-127-135-70-40-99-4-36-146-49-72-68-107-57-76-109-61-59-22-97-90-44-108-31-130-92-27-104-66-141-147-129,145-32-102-12-75-94-125-81-115-43-113-143-1-63-39-53-137-132-88-41-121-30-79-7-91-0-46-62-5-48-74-138-55-142-118-96-18-89-112-71-20-73-10-14-16-140-58-126-9-83-105-78-133-52-136-87-15-21-93-17-23-37-35-103-98-101-110-3-64-65-117-123-25-128-69,11764431,17254,20654,37908
gc,kroA150,12-32-75-145-102-94-125-81-146-36-4-95-77-51-38-100-120-29-106-84-115-49-43-113-143-1-72-67-68-63-39-53-80-24-60-124-50-139-134-111-131-28-13-47-99-70-40-135-2-45-33-82-54-116-8-6-56-144-86-11-148-122-42-127-114-119-26-19-85-149-34-61-76-109-57,5-48-62-89-105-78-133-52-18-74-91-0-129-7-138-55-96-142-118-3-64-65-136-9-112-71-83-17-23-37-35-20-73-140-58-126-46-130-92-27-141-104-147-66-132-41-121-79-30-88-137-107-108-31-10-16-14-90-97-22-44-59-103-110-101-98-87-15-21-93-69-128-123-25-117,11114040,17728,21705,39433
gc,kroA150,44-90-97-22-108-31-10-14-16-140-58-73-20-71-112-46-130-92-27-57-109-76-59-61-149-85-34-26-19-11-56-6-8-86-144-50-124-60-24-80-107-66-104-141-129-0-62-5-48-89-9-83-126-35-37-23-103-98-101-110-17-78-105-133-52-136-87-15-21-93-18-74-91-7-147,123-25-117-64-65-128-3-118-142-96-55-138-79-30-121-41-88-132-137-69-53-39-63-143-113-68-72-43-1-49-67-84-139-116-134-33-82-54-148-119-114-122-45-28-111-106-120-29-100-38-115-81-125-94-12-75-32-145-102-146-36-4-95-77-51-131-2-42-135-13-47-99-70-40-127,11433811,15741,23086,38827
gc,kroA150,62-5-48-89-112-9-83-71-20-73-140-58-126-35-37-23-105-78-136-133-52-18-74-91-0-129-46-130-92-27-141-104-147-7-138-55-142-96-118-3-64-65-87-15-21-93-17-103-98-101-110-10-31-108-90-97-22-44-14-16-109-76-59-61-149-19-56-86-50-124-57-66-107-60-24,144-8-6-116-139-134-33-82-54-148-11-26-85-34-119-114-122-45-28-111-131-106-120-29-100-84-67-80-68-72-49-113-43-143-63-39-53-1-115-38-95-77-51-47-13-2-42-135-127-70-99-40-4-36-146-81-125-94-12-32-145-102-75-137-132-88-41-121-30-79-117-123-25-128-69,11270963,18338,20756,39094
gc,kroA150,88-41-121-30-79-132-137-147-141-104-66-7-138-55-142-118-96-74-91-129-0-62-5-48-89-18-3-64-65-117-123-25-128-52-133-105-78-136-87-15-21-69-93-17-9-112-46-130-92-27-57-107-68-63-39-53-143-113-43-1-72-49-80-24-60-50-124-86-144-56-8-6-116-139-134,75-32-12-145-102-94-125-81-146-36-4-77-95-51-38-100-120-29-106-84-115-67-111-131-28-47-99-70-13-2-45-33-82-54-148-11-19-26-85-149-34-119-114-122-42-135-40-127-61-76-109-59-22-97-90-108-44-31-10-14-16-73-20-71-140-58-126-83-35-37-23-103-98-101-110,11614063,18000,20474,38474
gc,kroA150,94-125-81-12-75-32-145-102-36-4-146-115-49-43-113-143-1-72-67-84-38-100-95-77-51-29-120-106-111-131-28-45-2-13-47-99-70-40-135-42-122-33-134-139-80-24-68-63-39-53-107-60-124-50-86-144-8-116-6-56-82-54-148-11-19-26-85-149-61-76-109-57-66-104-141,121-41-88-30-79-138-55-142-118-96-7-91-129-0-132-137-147-27-92-130-62-5-48-74-18-3-64-65-117-123-25-128-52-133-105-89-9-112-46-108-90-97-22-44-31-10-14-16-20-71-83-78-136-87-15-21-69-93-17-23-37-35-126-73-140-58-103-110-101-98-59-34-119-114-127,11444920,16407,21984,38391
gc,kroA150,86-144-124-50-60-24-80-139-8-6-56-116-11-19-85-26-149-61-76-109-59-34-148-54-82-33-134-84-67-72-68-107-57-92-27-130-97-22-90-108-44-31-46-0-129-104-66-141-147-132-137-63-39-143-113-43-49-115-38-100-106-120-29-111-131-28-45-122-114-119-42-2-135-13-47,123-25-117-64-65-128-3-118-142-96-55-138-74-18-52-133-69-21-15-87-93-136-78-105-89-48-5-91-7-121-79-30-41-88-62-112-9-83-17-23-37-103-110-101-98-35-71-20-73-140-58-126-10-16-14-53-1-81-125-94-12-75-32-145-102-146-36-4-95-77-51-99-70-40-127,11293092,16763,21619,38382
gc,kroA150,11-26-85-19-56-6-8-116-54-82-148-33-134-139-144-86-124-50-60-24-80-149-34-61-59-76-109-22-97-90-44-108-31-10-14-16-46-130-92-27-57-107-68-67-84-111-28-45-122-114-119-42-2-131-13-135-127-70-40-99-47-106-120-29-100-38-95-77-51-4-36-146-49-72-113,21-15-87-93-69-52-133-136-78-17-23-37-103-110-101-98-35-83-105-89-18-3-65-64-128-25-123-117-118-96-74-48-5-62-9-71-112-20-73-140-58-126-91-138-55-142-79-30-121-41-7-129-0-141-104-147-132-88-137-66-39-53-63-143-1-43-115-81-125-94-12-75-32-145-102,11366442,16783,20827,37610
gc,kroA150,120-29-106-100-38-95-77-51-4-36-146-84-67-111-131-28-45-2-13-47-99-70-40-135-42-122-33-134-139-116-8-6-82-54-148-11-56-144-86-124-50-24-80-72-49-115-81-125-94-12-32-145-102-75-43-113-143-63-68-60-107-57-19-26-85-34-119-114-127-149-61-76-109-59-22,117-123-25-128-64-65-3-118-142-55-96-74-18-52-133-87-15-69-21-93-136-78-105-89-48-5-138-79-30-121-41-88-7-91-62-0-129-141-147-132-137-104-66-27-92-130-46-112-9-83-17-23-37-103-110-101-98-35-71-20-73-140-58-126-10-31-108-90-97-44-14-16-39-53-1,11524836,18613,19798,38411
gc,kroA150,87-15-21-93-136-78-133-52-105-17-23-37-103-110-101-98-35-83-9-89-18-69-65-64-3-96-74-48-5-62-112-71-20-73-140-58-126-10-16-14-31-108-46-0-129-91-7-138-55-142-118-117-123-25-128-79-30-121-41-88-132-147-141-104-27-92-130-90-97-22-44-109-76-59-61,43-113-143-1-49-72-67-84-115-81-125-94-12-75-32-145-102-146-38-100-120-29-106-111-134-139-80-68-63-39-53-24-60-124-50-86-144-8-116-6-56-19-11-54-82-33-28-131-95-77-51-4-36-47-13-2-45-122-42-135-70-99-40-127-114-119-148-26-85-149-34-107-57-66-137,11553986,17943,18211,36154
gc,kroA150,121-41-88-30-79-138-55-142-118-96-7-91-129-0-132-137-147-141-104-66-27-92-130-62-5-48-74-18-3-64-65-117-123-25-128-52-133-105-89-9-112-46-108-90-97-22-44-31-10-14-16-20-71-83-78-136-87-15-21-69-93-17-23-37-35-126-73-140-58-103-110-101-98-57-107,39-63-53-143-113-43-1-72-68-80-24-60-124-50-86-144-139-67-49-115-81-125-94-12-75-32-145-102-146-38-84-134-116-8-6-56-19-11-54-82-33-111-106-100-120-29-95-77-51-4-36-131-28-45-2-13-47-99-70-40-135-42-122-148-26-85-149-61-76-109-59-34-119-114-127,11095169,19317,17380,36697
gc,kroA150,132-137-88-41-121-30-79-138-7-147-141-104-66-27-92-129-0-91-55-142-118-96-74-48-5-62-112-46-130-57-107-68-63-39-53-143-113-43-1-72-49-80-24-60-50-124-86-144-56-8-6-116-139-134-67-84-115-81-125-94-12-75-32-145-102-146-38-100-106-120-29-111-131-28-33,10-14-16-31-108-90-44-97-22-73-140-58-20-71-126-35-83-9-89-105-78-136-17-23-37-103-98-101-110-133-52-18-87-15-21-93-69-65-3-64-117-123-25-128-109-76-59-61-149-85-34-26-19-11-148-54-82-119-114-122-42-45-2-135-127-13-70-40-99-47-95-77-51-4-36,11089034,17514,19781,37295
gc,kroA150,112-71-20-73-140-58-126-9-83-89-48-5-62-46-108-31-10-16-14-90-97-22-44-130-0-129-91-7-74-18-105-78-136-133-52-87-15-21-93-17-23-37-35-103-98-101-110-69-65-3-96-138-55-142-118-121-41-88-132-147-141-104-27-92-57-66-107-60-50-124-86-144-109-76-59,137-30-79-53-39-63-143-113-68-80-24-72-43-1-49-67-84-139-134-8-56-6-116-19-11-26-85-149-61-34-148-54-82-33-111-106-100-38-115-81-125-94-12-75-32-145-102-146-36-4-95-77-51-120-29-131-28-45-2-42-122-114-119-127-135-13-47-99-70-40-64-117-123-25-128,11139027,17525,21543,39068
gc,kroA150,84-67-72-49-43-113-143-63-68-80-24-139-134-106-120-29-100-38-95-77-51-4-36-146-115-81-125-94-12-32-145-102-75-111-131-28-33-82-54-116-8-6-56-144-86-124-50-60-107-57-66-104-141-147-39-53-1-45-2-13-47-99-70-40-135-42-122-114-119-148-11-19-26-85-149,22-97-90-44-108-31-10-14-16-46-130-92-27-109-76-59-61-34-0-129-62-112-71-20-73-140-58-126-9-83-89-5-48-91-7-41-121-138-74-18-105-78-136-17-23-37-35-103-98-101-110-133-52-87-15-21-93-69-65-3-96-55-142-118-79-30-88-132-137-64-117-123-25-128-127,11144898,17216,23883,41099
gc,kroA150,20-73-140-58-126-71-112-9-83-35-37-23-103-98-101-110-17-78-105-89-48-5-62-46-10-16-14-31-108-90-44-97-22-130-0-129-91-7-74-18-133-52-136-87-15-21-93-69-65-3-96-138-55-142-118-64-117-123-25-128-121-41-88-132-147-141-104-27-92-57-66-107-60-50-124,102-145-32-12-75-94-125-81-146-36-4-77-51-95-38-100-120-29-106-111-131-47-99-70-40-13-28-45-2-135-42-122-33-134-84-67-115-49-43-113-72-143-1-63-39-53-68-80-24-139-116-8-6-56-144-86-82-54-148-11-19-26-85-149-34-119-114-127-61-76-109-59-137-30-79,11154816,18022,20140,38162
gc,kroA150,125-94-81-115-12-75-32-145-102-146-36-4-95-77-51-38-100-120-29-106-84-67-49-43-113-143-1-72-63-39-53-68-80-24-60-124-50-86-144-139-134-111-131-28-45-2-13-47-99-70-40-135-42-122-33-82-54-116-8-6-56-11-148-114-119-26-19-85-149-61-76-109-57-107-66,93-21-15-87-136-78-133-52-69-17-23-37-103-110-101-98-35-83-105-89-18-74-96-3-65-64-128-25-123-117-118-142-55-138-48-5-9-71-20-73-140-58-126-112-62-91-7-41-121-79-30-88-132-129-0-46-108-31-10-16-14-44-90-97-22-130-92-27-141-104-147-137-59-34-127,11707352,16165,22285,38450
gc,kroA150,75-32-12-145-102-94-125-81-146-36-4-77-95-51-38-100-120-29-106-84-115-49-43-113-143-1-72-67-68-63-39-53-80-24-60-124-50-139-134-111-131-28-47-99-70-13-2-45-33-82-54-116-8-6-56-144-86-11-148-122-42-135-40-127-114-119-26-19-85-149-34-61-76-109-57,132-137-88-41-121-30-79-138-7-147-141-104-66-27-92-129-0-91-55-142-118-96-74-48-5-62-112-46-130-107-97-90-108-31-44-22-59-10-14-16-20-71-9-89-18-3-64-65-117-123-25-128-52-133-105-78-136-87-15-21-69-93-17-83-23-37-35-73-140-58-126-103-110-101-98,10735695,18548,20269,38817
gc,kroA150,136-78-133-52-87-15-21-93-17-23-37-103-110-101-98-35-83-105-89-9-71-20-73-140-58-126-112-48-5-18-74-96-3-65-69-64-128-25-123-117-118-142-55-138-91-62-0-129-7-41-121-79-30-88-132-147-141-104-27-92-130-46-108-31-10-16-14-44-90-97-22-109-76-59-61,122-42-45-2-135-127-114-119-148-54-82-33-28-131-111-13-70-40-99-47-29-120-106-100-38-134-139-116-6-8-11-26-85-34-19-56-144-86-124-50-60-24-80-84-67-72-49-43-113-143-68-107-57-149-95-77-51-4-36-146-115-81-125-94-12-32-145-102-75-1-63-39-53-66-137,10998846,17330,20202,37532
gc,kroA150,17-23-37-103-110-101-98-35-83-9-78-136-87-15-21-93-133-52-105-89-48-5-62-112-71-20-73-140-58-126-10-16-14-31-108-46-0-129-91-74-18-69-65-64-3-96-142-55-138-7-41-121-79-30-118-117-123-25-128-88-132-147-141-104-27-92-130-90-97-44-22-109-76-59-61,67-84-72-49-43-113-143-63-68-80-24-60-124-50-86-144-139-134-106-120-29-100-38-146-115-81-125-94-12-32-145-102-36-4-95-77-51-111-131-28-33-82-54-116-8-6-56-19-11-148-26-85-149-34-119-114-45-2-13-47-99-70-40-135-42-122-127-107-57-66-39-53-1-75-137,10741609,18257,20291,38548
gc,kroA150,123-25-117-64-65-128-3-118-142-96-55-138-74-18-52-133-69-21-15-87-93-136-78-105-89-48-5-91-7-121-79-30-41-88-132-137-147-141-104-129-0-62-112-9-83-17-23-37-103-110-101-98-35-71-20-73-140-58-126-10-46-130-92-27-66-107-57-60-24-80-68-63-39-53-143,108-90-97-22-44-31-14-16-59-109-76-61-149-85-19-56-6-8-86-144-50-124-116-11-26-34-148-54-82-33-139-134-84-67-72-113-43-49-115-1-81-125-94-146-38-100-106-111-28-45-114-119-122-42-2-131-120-29-13-135-127-70-40-99-47-95-77-51-4-36-102-145-32-12-75,10995528,18263,18255,36518
gc,kroA150,65-64-3-123-25-128-117-118-96-18-52-133-15-69-21-87-93-136-78-105-89-74-142-55-138-79-30-121-41-7-91-48-5-62-9-83-17-23-37-103-110-101-98-35-71-112-0-129-141-104-147-132-88-137-66-27-92-130-46-20-73-140-58-126-10-16-14-31-108-90-97-22-44-109-76,26-85-34-149-19-11-148-54-82-116-6-56-8-144-86-50-124-139-134-33-119-114-122-42-45-28-131-111-2-135-127-13-70-40-99-47-29-120-106-100-84-67-24-80-60-61-59-57-107-68-72-49-43-113-143-63-39-53-1-115-38-95-77-51-4-36-146-81-125-94-12-32-145-102-75,10770423,18713,17622,36335
gc,kroA150,139-134-116-8-6-56-144-86-124-50-24-80-60-67-84-106-120-29-100-38-111-131-28-33-82-54-148-11-19-26-85-149-61-76-109-59-34-119-114-122-45-2-42-135-13-47-99-70-40-127-95-77-51-4-36-146-49-72-68-113-43-143-63-39-53-1-115-81-125-94-12-32-145-102-75,103-101-110-98-37-23-17-35-83-9-71-20-73-126-58-140-112-89-105-78-136-87-93-21-15-133-52-18-74-48-5-62-46-10-16-14-31-108-90-44-97-22-130-0-129-91-7-138-96-3-65-69-64-128-25-123-117-118-142-55-121-41-79-30-88-132-147-141-104-27-92-66-57-107-137,10662524,16646,18910,35556
gc,kroA150,136-78-133-52-87-15-21-93-17-23-37-103-110-101-98-35-83-105-89-9-71-20-73-140-58-126-112-48-5-18-74-96-3-65-69-64-128-25-123-117-118-142-55-138-91-62-0-129-7-41-121-79-30-88-132-147-141-104-27-92-130-46-108-31-10-16-14-44-90-97-22-109-76-59-61,135-2-42-122-45-28-131-13-70-40-99-47-111-106-29-120-100-38-95-77-51-4-36-146-84-134-33-82-54-148-114-119-127-11-26-85-19-6-116-8-56-139-144-86-124-50-24-80-67-72-49-43-113-143-68-60-149-34-57-107-66-63-39-53-1-115-81-125-94-12-145-102-32-75-137,10754998,17330,21391,38721
gc,kroA150,130-92-27-104-141-66-57-107-60-50-124-86-144-109-76-97-90-108-46-0-129-62-5-48-112-31-44-22-59-61-149-19-56-8-6-116-11-85-26-34-148-54-82-139-24-80-68-147-7-91-74-89-9-71-20-73-140-58-10-14-16-126-83-105-78-136-133-52-18-96-138-41-121-88-132,42-122-45-2-135-127-114-119-28-131-13-70-40-99-47-111-33-134-106-120-29-100-38-95-77-51-4-36-146-84-67-72-49-43-113-143-63-39-53-1-115-81-125-94-12-145-102-32-75-137-30-79-55-142-118-3-64-65-117-123-25-128-69-15-87-17-23-37-35-103-98-101-110-93-21,10755335,17844,21183,39027
gc,kroA150,62-5-48-89-112-9-83-71-20-73-140-58-126-35-37-23-105-78-136-133-52-18-74-91-0-129-46-130-92-27-141-104-147-7-138-55-142-96-118-3-64-65-87-15-21-93-17-103-98-101-110-10-31-108-90-97-22-44-14-16-109-76-59-61-149-19-56-86-50-124-57-66-107-60-24,81-125-94-12-75-32-145-102-146-115-49-43-113-143-1-72-67-84-38-100-120-29-106-95-77-51-4-36-47-111-131-28-134-139-80-68-63-39-53-137-132-88-41-121-30-79-144-8-116-6-33-82-54-148-11-26-85-34-119-114-45-2-13-99-70-40-135-42-122-127-117-123-25-128-69,10794109,18338,24041,42379
gc,kroA150,54-82-148-11-26-85-19-6-116-8-56-33-134-139-144-86-124-50-60-24-80-67-84-111-28-45-122-114-119-42-2-131-13-135-127-70-40-99-47-29-120-106-100-38-95-77-51-4-36-146-49-72-68-107-57-76-109-149-34-61-59-22-97-90-44-108-31-130-92-27-104-66-141-147-129,105-78-136-133-52-89-48-5-62-9-83-17-23-37-103-35-71-112-18-74-96-3-64-65-87-15-21-93-69-128-123-25-117-118-142-55-138-91-7-0-46-20-73-140-58-126-98-101-110-10-16-14-41-121-79-30-88-132-137-53-39-63-143-113-43-1-115-81-125-94-12-32-145-102-75,10716074,17412,22220,39632
gc,kroA150,22-97-90-44-108-31-10-14-16-46-130-92-27-109-76-59-61-149-85-19-56-6-8-86-144-50-124-60-57-107-66-104-141-129-0-62-112-71-20-73-140-58-126-9-83-89-5-48-91-7-147-132-41-121-138-74-18-105-78-136-17-23-37-35-103-98-101-110-133-52-87-15-21-93-69,12-32-75-145-102-94-125-81-146-36-4-95-77-51-38-100-120-29-106-84-115-49-43-113-143-1-72-67-68-63-39-53-80-24-139-134-111-131-28-13-47-99-70-40-135-2-45-33-82-54-116-148-11-26-119-114-122-42-127-34-137-88-30-79-55-142-118-96-3-64-65-117-123-25-128,10813757,17226,22002,39228
gc,kroA150,13-2-135-70-99-40-47-131-28-45-42-122-127-111-106-29-120-100-38-95-77-51-4-36-146-84-134-33-82-54-148-114-119-11-116-6-8-139-144-86-56-19-26-85-34-149-61-59-76-109-50-124-24-80-67-72-49-115-81-125-94-12-145-102-32-75-43-113-143-63-68-60-57-107-66,15-87-21-93-136-78-133-52-69-65-64-3-18-105-17-23-37-103-110-101-98-35-83-9-89-48-5-74-96-142-118-55-138-91-62-112-71-20-73-140-58-126-10-16-14-31-108-46-0-129-7-41-121-79-30-88-132-147-141-104-27-92-130-90-97-22-44-128-25-123-117-137-53-39-1,10785012,17771,21502,39273
gc,kroA150,87-15-21-93-136-78-133-52-105-17-23-37-103-110-101-98-35-83-9-89-18-69-65-64-3-96-74-48-5-62-112-71-20-73-140-58-126-10-16-14-31-108-46-0-129-91-7-138-55-142-118-117-123-25-128-79-30-121-41-88-132-147-141-104-27-92-130-90-97-22-44-109-76-59-61,100-120-29-106-38-95-77-51-4-36-146-84-67-49-72-43-115-81-125-94-12-32-145-102-75-111-131-28-45-2-13-47-99-70-40-135-42-122-33-134-139-116-8-6-56-144-86-124-50-24-80-60-68-113-143-63-39-53-1-107-57-82-54-148-11-19-26-85-149-34-119-114-127-66-137,10780812,17943,20672,38615
gc,kroA150,93-21-15-87-136-78-133-52-69-17-23-37-103-110-101-98-35-83-105-89-18-74-96-3-65-64-128-25-123-117-118-142-55-138-48-5-9-71-20-73-140-58-126-112-62-91-7-41-121-79-30-88-132-129-0-46-108-31-10-16-14-44-90-97-22-130-92-27-141-104-147-66-57-107-60,54-82-148-11-26-85-19-6-116-8-56-33-134-139-144-86-124-50-24-80-67-84-111-28-45-122-114-119-42-2-131-13-135-127-70-40-99-47-29-120-106-100-38-95-77-51-4-36-146-49-72-68-113-43-143-63-39-53-1-115-81-125-94-12-32-145-102-75-149-34-61-59-76-109-137,10702354,18482,19815,38297
gc,kroA150,92-27-104-141-66-57-107-130-0-129-147-132-7-91-62-46-108-90-97-22-109-76-59-61-149-19-56-86-50-124-60-24-80-68-63-39-53-143-113-72-67-84-139-144-8-6-116-11-85-26-34-148-54-82-33-134-111-131-28-45-122-114-119-42-2-135-13-106-120-29-100-38-49-43-1,115-81-125-94-12-32-145-102-146-36-4-95-77-51-75-47-99-70-40-127-137-88-41-121-30-79-138-55-142-118-96-74-5-48-89-112-31-44-10-14-16-73-20-71-9-83-105-18-3-64-65-117-123-25-128-52-133-78-136-87-15-21-93-17-23-37-35-140-58-126-103-98-101-110-69,11296649,17038,23332,40370
gc,kroA150,35-37-23-103-98-101-110-17-83-9-71-20-73-126-58-140-10-16-14-31-108-112-89-105-78-136-133-52-87-15-93-21-69-18-48-5-62-46-90-44-97-22-130-0-129-91-74-96-3-64-65-128-25-123-117-118-142-55-138-7-41-121-79-30-88-132-147-141-104-27-92-57-66-107-60,114-119-122-42-45-2-28-33-82-54-148-11-26-85-34-149-19-6-116-8-56-144-86-139-134-111-131-13-135-127-70-40-99-47-29-120-106-100-38-84-67-80-24-124-50-61-59-76-109-68-72-49-43-113-143-63-39-53-1-115-146-95-77-51-4-36-102-145-32-12-75-94-125-81-137,10980675,17983,18369,36352
gc,kroA150,143-113-43-1-63-39-53-68-72-49-115-81-125-94-12-75-32-145-102-146-38-67-84-80-24-60-107-57-66-104-141-147-132-137-88-41-121-30-79-7-91-129-27-92-130-50-124-86-144-139-134-106-100-120-29-111-131-28-33-116-8-6-56-19-11-54-82-148-26-85-149-61-76-109-59,15-87-21-93-136-78-133-52-69-65-64-3-18-105-17-23-37-103-110-101-98-35-83-9-89-48-5-74-96-142-118-55-138-117-123-25-128-62-112-71-20-73-140-58-126-10-16-14-31-108-46-0-90-97-22-44-34-119-114-122-45-2-42-127-135-13-47-95-77-51-4-36-99-70-40,10995040,16604,22276,38880
gc,kroA150,113-143-43-49-72-63-39-53-1-115-81-125-94-12-32-145-146-38-67-84-68-80-24-60-124-50-86-144-139-134-106-100-120-29-111-131-28-33-82-54-116-8-6-56-19-11-148-26-85-149-61-76-109-57-107-66-104-141-147-132-137-88-41-121-30-79-7-27-92-130-129-0-91-138-55,16-14-10-31-108-90-44-97-22-46-20-73-140-58-126-71-112-9-83-35-37-23-103-98-101-110-17-78-105-89-48-5-62-74-18-133-52-136-87-15-21-93-69-65-3-96-142-118-64-117-123-25-128-59-34-119-114-122-42-45-2-135-127-13-70-40-99-47-95-77-51-4-36-102-75,10810894,17317,21393,38710
gc,kroA150,69-21-15-87-93-136-133-52-78-105-18-65-64-3-128-25-123-117-118-96-74-89-17-23-37-103-110-101-98-35-83-9-48-5-62-112-71-20-73-140-58-126-10-16-14-31-46-0-91-138-55-142-79-30-121-41-7-129-141-104-147-132-88-137-66-27-92-130-108-90-97-22-44-109-76,82-54-148-33-116-6-8-56-11-26-85-19-149-34-119-114-122-45-28-131-111-134-139-144-86-124-50-60-24-80-67-84-106-120-29-100-38-95-77-51-47-13-2-42-127-135-70-40-99-4-36-146-49-72-68-107-57-61-59-113-43-143-63-39-53-1-115-81-125-94-12-32-145-102-75,11212724,18923,18436,37359
gc,kroA150,0-129-91-7-62-5-48-89-112-46-130-92-27-141-104-66-147-132-41-121-138-55-142-96-74-18-105-9-83-71-20-73-140-58-10-31-108-90-97-22-44-14-16-126-35-37-23-17-78-133-52-136-87-15-21-93-69-3-118-79-30-88-137-107-57-60-50-124-86-144-24-80-68-63-39,49-43-113-72-67-84-115-81-125-94-12-146-38-100-106-120-29-95-77-51-4-36-102-145-32-75-1-143-53-139-134-111-131-28-33-82-54-116-8-6-56-19-11-148-26-85-149-61-76-109-59-34-119-114-45-2-13-47-99-70-40-135-42-122-127-64-65-117-123-25-128-103-98-101-110,11374909,17455,23603,41058
gc,kroA150,31-108-90-44-97-22-10-14-16-140-73-20-58-126-71-112-46-130-92-27-0-129-62-5-48-89-9-83-35-37-23-17-78-105-133-52-136-87-15-21-93-103-98-101-110-18-74-91-7-141-104-66-57-109-76-59-61-149-85-19-56-6-8-86-144-50-124-60-24-80-107-147-132-41-121,11-26-148-54-82-116-33-134-139-34-119-114-122-45-28-131-111-106-120-29-100-84-67-72-68-113-49-43-143-63-39-53-1-115-38-95-77-51-13-2-42-127-135-70-40-99-47-4-36-146-81-125-94-12-32-145-102-75-137-88-30-79-138-55-142-96-118-3-64-65-117-123-25-128-69,11712881,17356,21381,38737
gc,kroA150,99-70-40-13-47-135-2-45-28-131-111-29-120-106-100-95-77-51-4-36-38-146-102-145-32-12-75-94-125-81-115-84-134-33-42-127-122-114-119-148-54-82-116-6-8-139-144-86-56-11-26-85-19-149-34-61-59-76-109-50-124-24-80-67-72-49-43-113-143-63-68-60-57-107-66,132-137-88-41-121-30-79-138-7-147-141-104-27-92-129-0-91-55-142-118-96-74-48-5-62-112-46-130-97-90-108-31-44-22-10-14-16-20-71-9-89-18-3-64-65-117-123-25-128-52-133-105-78-136-87-15-21-69-93-17-83-23-37-35-73-140-58-126-103-110-101-98-39-53-1,11214198,17239,20542,37781
gc,kroA150,99-70-40-13-47-135-2-45-28-131-111-29-120-106-100-95-77-51-4-36-38-146-102-145-32-12-75-94-125-81-115-84-134-33-42-127-122-114-119-148-54-82-116-6-8-139-144-86-56-11-26-85-19-149-34-61-59-76-109-50-124-24-80-67-72-49-43-113-143-63-68-60-57-107-66,121-41-88-30-79-138-55-142-118-96-7-91-129-0-132-137-147-141-104-27-92-130-62-5-48-74-18-3-64-65-117-123-25-128-52-133-105-89-9-112-46-108-90-97-22-44-31-10-14-16-20-71-83-78-136-87-15-21-69-93-17-23-37-35-126-73-140-58-103-110-101-98-39-53-1,11621314,17239,20603,37842
gc,kroA150,5-48-62-89-105-78-133-52-18-74-91-0-129-7-138-55-96-142-118-3-64-65-136-9-112-71-83-17-23-37-35-20-73-140-58-126-46-130-92-27-141-104-147-66-57-107-132-41-121-79-30-88-137-108-31-10-16-14-90-97-22-44-109-76-59-61-149-19-56-86-50-124-60-24-80,131-111-28-45-2-13-135-42-122-33-82-54-148-114-119-127-70-99-47-29-120-106-100-38-95-77-51-4-36-146-84-134-139-116-6-8-144-11-26-85-34-40-67-72-49-43-113-143-68-63-39-53-1-115-81-125-94-12-32-145-102-75-117-123-25-128-69-15-87-21-93-103-98-101-110,11421194,19676,23872,43548
gc,kroA150,58-140-73-20-126-71-112-9-83-35-37-23-103-98-101-110-17-78-105-89-48-5-62-46-10-16-14-31-108-90-44-97-22-130-0-129-91-7-74-18-133-52-136-87-15-21-93-69-65-3-96-138-55-142-118-64-117-123-25-128-121-41-88-132-147-141-104-27-92-57-66-107-60-50-124,26-85-34-149-19-11-148-54-82-116-6-56-8-144-86-139-134-33-119-114-122-42-45-28-131-111-2-135-127-13-70-40-99-47-29-120-106-100-84-67-24-80-61-59-76-109-68-72-49-43-113-143-63-39-53-1-115-38-95-77-51-4-36-146-81-125-94-12-32-145-102-75-137-30-79,11027279,18199,20065,38264
gc,kroA150,85-26-34-149-19-11-148-54-82-6-56-8-116-144-86-50-124-61-59-76-109-22-97-90-44-108-31-10-14-16-46-130-92-27-57-60-24-80-139-134-33-119-114-122-42-45-28-131-111-2-135-127-13-70-40-99-47-106-120-29-100-84-67-72-68-107-66-104-141-147-129-0-62-112-71,121-41-88-30-79-138-55-142-118-96-7-91-74-18-3-64-65-117-123-25-128-52-133-105-89-48-5-132-137-53-39-63-143-113-43-1-49-115-81-125-94-12-75-32-145-102-146-38-95-77-51-4-36-9-83-78-136-87-15-21-69-93-17-23-37-35-20-73-140-58-126-103-110-101-98,11624331,16941,20755,37696
gc,kroA150,0-129-91-7-62-5-48-89-112-46-130-92-27-141-104-66-147-132-41-121-138-55-142-96-74-18-105-9-83-71-20-73-140-58-10-31-108-90-97-22-44-14-16-126-35-37-23-17-78-133-52-136-87-15-21-93-69-3-118-79-30-88-137-107-57-60-50-124-86-144-24-80-68-63-39,11-26-85-19-56-6-8-116-54-82-148-33-134-139-149-34-61-59-76-109-119-114-122-45-28-131-111-106-120-29-100-84-67-72-49-43-113-143-1-53-115-38-95-77-51-13-2-42-127-135-70-40-99-47-4-36-146-81-125-94-12-32-145-102-75-64-65-117-123-25-128-103-98-101-110,11405088,17455,23087,40542
gc,kroA150,37-23-103-110-101-98-35-83-9-17-136-78-105-133-52-87-15-93-21-69-89-48-5-62-112-71-20-73-126-58-140-10-16-14-31-108-46-0-129-91-74-18-96-3-65-64-128-25-123-117-118-142-55-138-7-41-121-79-30-88-132-147-141-104-27-92-130-90-97-44-22-109-76-59-61,116-6-8-56-144-86-139-134-33-82-54-148-11-19-26-85-149-34-119-114-122-45-28-131-111-106-120-29-100-84-67-80-24-124-50-60-57-107-68-72-49-43-113-143-63-39-53-1-115-38-95-77-51-47-13-2-42-135-127-70-40-99-4-36-146-81-125-94-12-32-145-102-75-66-137,11366173,16874,18893,35767
gc,kroA150,96-142-55-138-74-18-3-118-64-65-117-123-25-128-69-52-133-105-89-48-5-91-7-41-121-79-30-88-132-137-147-141-104-129-0-62-112-9-83-78-136-87-15-21-93-17-23-37-103-35-71-20-73-140-58-126-46-130-92-27-66-107-57-60-24-80-68-63-39-53-143-113-72-43-1,61-59-76-109-149-85-34-26-19-11-56-6-8-116-144-86-50-124-139-54-82-148-119-114-33-134-28-45-122-42-2-131-111-106-120-29-100-84-67-49-115-38-95-77-51-13-135-127-70-40-99-47-22-97-90-44-108-31-10-14-16-98-101-110-146-36-4-102-145-32-12-81-125-94-75,11457370,18204,22817,41021
gc,kroA150,37-23-103-110-101-98-35-83-9-17-136-78-105-133-52-87-15-93-21-69-89-48-5-62-112-71-20-73-126-58-140-10-16-14-31-108-46-0-129-91-74-18-96-3-65-64-128-25-123-117-118-142-55-138-7-41-121-79-30-88-132-147-141-104-27-92-130-90-97-44-22-109-76-59-61,4-36-77-51-95-146-102-145-32-12-75-94-125-81-115-38-100-120-29-106-111-131-47-99-70-13-28-45-2-135-40-42-122-33-134-84-67-49-43-113-72-143-1-63-39-53-68-80-24-139-116-8-6-82-54-148-11-56-144-86-124-50-60-107-57-66-137-19-26-85-34-119-114-127-149,11991835,16874,20100,36974
gc,kroA150,71-20-73-140-58-126-35-83-9-112-62-5-48-89-105-78-136-17-23-37-103-98-101-110-10-16-14-31-108-46-90-97-44-22-130-0-129-91-74-18-133-52-87-15-21-93-69-65-3-96-138-7-41-121-55-142-118-64-117-123-25-128-79-30-88-132-147-141-104-27-92-57-66-107-60,120-29-106-100-38-95-77-51-4-36-146-84-67-111-131-28-45-2-13-47-99-70-40-135-42-122-33-134-139-116-8-6-82-54-148-11-56-144-86-124-50-24-80-72-49-115-81-125-94-12-32-145-102-75-43-113-143-63-68-39-53-1-19-26-85-34-119-114-127-149-61-76-109-59-137,11496385,18594,20735,39329
gc,kroA150,52-133-78-136-87-15-21-93-69-18-105-89-48-5-74-96-3-64-65-128-123-25-117-118-142-55-138-91-62-9-83-17-23-37-103-110-101-98-35-71-112-20-73-140-58-126-10-16-14-31-46-0-129-7-41-121-79-30-88-132-147-141-104-27-92-130-108-90-97-22-44-109-76-59-61,19-11-26-85-149-34-56-6-8-116-54-82-148-33-134-139-144-86-50-124-60-24-80-57-107-66-68-67-84-106-111-28-45-122-114-119-42-2-131-13-135-127-70-40-99-47-29-120-100-38-95-77-51-4-36-146-49-72-113-43-143-63-39-53-1-115-81-125-94-12-32-145-102-75-137,11391915,17663,18850,36513
gc,kroA150,87-15-21-93-136-78-133-52-105-17-23-37-103-110-101-98-35-83-9-89-18-69-65-64-3-96-74-48-5-62-112-71-20-73-140-58-126-10-16-14-31-108-46-0-129-91-7-138-55-142-118-117-123-25-128-79-30-121-41-88-132-147-141-104-27-92-130-90-97-22-44-109-76-59-61,33-82-54-148-11-116-6-8-56-144-86-139-134-28-45-2-42-122-114-119-26-85-19-149-34-111-131-13-135-127-70-40-99-47-29-120-106-100-38-84-67-80-24-124-50-60-57-107-68-72-49-43-113-143-63-39-53-1-115-146-95-77-51-4-36-102-145-32-12-75-94-125-81-66-137,11280501,17943,18623,36566
gc,kroA150,94-125-81-12-75-32-145-102-36-4-146-115-49-43-113-143-1-72-67-84-38-100-95-77-51-29-120-106-111-131-28-45-2-13-47-99-70-40-135-42-122-33-134-139-80-24-68-63-39-53-107-60-124-50-86-144-8-116-6-56-82-54-148-11-19-26-85-149-61-76-109-57-66-104-141,69-21-15-87-93-136-133-52-78-105-18-65-64-3-128-25-123-117-118-96-74-89-17-23-37-103-110-101-98-35-83-9-48-5-62-112-71-20-73-140-58-126-10-16-14-31-46-0-91-138-55-142-79-30-121-41-7-129-27-92-130-108-90-97-22-44-59-147-132-88-137-34-119-114-127,11002953,16407,23443,39850
gc,kroA150,110-101-103-98-37-23-17-136-78-105-83-35-126-58-140-73-20-71-9-89-133-52-87-93-21-15-69-18-74-48-5-62-112-46-10-16-14-31-108-90-44-97-22-130-0-129-91-7-138-96-3-65-64-128-25-123-117-118-142-55-79-121-41-30-88-132-147-141-104-27-92-66-57-107-60,94-125-81-12-75-32-145-102-36-4-146-115-49-43-113-143-1-72-67-84-38-100-95-77-51-29-120-106-111-131-28-45-2-13-47-99-70-40-135-42-122-33-134-139-80-24-68-63-39-53-137-124-50-86-144-8-116-6-56-82-54-148-11-19-26-85-149-61-76-109-59-34-119-114-127,10770236,18185,17630,35815
gc,kroA150,123-25-117-64-65-128-3-118-142-96-55-138-74-18-52-133-69-21-15-87-93-136-78-105-89-48-5-91-7-121-79-30-41-88-132-137-147-141-104-129-0-62-112-9-83-17-23-37-103-110-101-98-35-71-20-73-140-58-126-10-46-130-92-27-66-107-57-60-24-80-68-63-39-53-143,90-97-22-44-108-31-14-16-59-109-76-61-149-85-19-56-6-8-86-144-50-124-116-11-26-34-148-54-82-33-139-134-84-67-72-113-43-49-115-1-81-125-94-146-38-100-106-111-28-45-114-119-122-42-2-131-120-29-13-135-127-70-40-99-47-95-77-51-4-36-102-145-32-12-75,11032366,18263,18164,36427
gc,kroA150,121-41-88-30-79-138-55-142-118-96-7-91-129-0-132-137-147-141-104-66-27-92-130-62-5-48-74-18-3-64-65-117-123-25-128-52-133-105-89-9-112-46-108-90-97-22-44-31-10-14-16-20-71-83-78-136-87-15-21-69-93-17-23-37-35-126-73-140-58-103-110-101-98-57-107,125-94-81-115-12-75-32-145-102-146-36-4-95-77-51-38-100-120-29-106-84-67-49-43-113-143-1-72-63-39-53-68-80-24-60-124-50-86-144-139-134-111-131-28-45-2-13-47-99-70-40-135-42-122-33-82-54-116-8-6-56-11-148-114-119-26-19-85-149-61-76-109-59-34-127,10815766,19317,16877,36194
gc,kroA150,119-114-122-42-45-2-28-33-82-54-148-11-26-85-34-149-19-6-116-8-56-144-86-139-134-111-131-13-135-127-70-40-99-47-29-120-106-100-38-84-67-80-24-124-50-60-61-59-76-109-22-97-90-44-108-31-10-14-16-46-130-92-27-57-107-68-72-49-43-113-143-63-39-53-1,48-5-62-89-105-78-133-52-18-74-91-0-129-7-138-55-96-142-118-3-64-65-136-87-15-21-93-17-9-83-112-71-20-73-140-58-126-35-37-23-103-110-101-98-69-128-123-25-117-79-121-41-88-30-132-147-141-104-66-137-115-81-125-94-146-95-77-51-4-36-102-145-12-32-75,10772290,16255,21197,37452
gc,kroA150,108-90-97-22-44-31-10-14-16-46-130-92-27-0-129-62-112-71-20-73-140-58-126-9-83-35-37-23-17-78-105-89-48-5-91-7-141-104-66-57-109-76-59-61-149-85-19-56-6-8-86-144-50-124-60-24-80-107-147-132-41-121-138-74-18-133-52-136-87-15-21-93-103-98-101,69-65-64-3-128-25-123-117-118-96-142-55-79-30-88-137-53-39-63-68-143-113-72-43-1-49-67-84-139-116-11-26-34-148-54-82-33-134-111-131-28-45-122-114-119-42-2-135-13-106-120-29-100-38-115-81-125-94-12-146-95-77-51-4-36-102-145-32-75-47-99-70-40-127-110,10766895,16570,21571,38141
gc,kroA150,108-90-97-22-44-31-10-14-16-46-130-92-27-0-129-62-112-71-20-73-140-58-126-9-83-35-37-23-17-78-105-89-48-5-91-7-141-104-66-57-109-76-59-61-149-85-19-56-6-8-86-144-50-124-60-24-80-107-147-132-41-121-138-74-18-133-52-136-87-15-21-93-103-98-101,30-79-88-55-142-118-96-3-64-117-123-25-65-128-69-137-53-39-63-143-113-68-72-43-1-49-67-84-139-134-116-11-26-34-148-54-82-33-28-111-106-120-29-100-38-115-81-125-94-12-75-32-145-102-146-36-4-95-77-51-131-45-2-42-122-114-119-127-135-13-47-99-70-40-110,10792204,16570,23621,40191
gc,kroA150,123-25-117-64-65-128-3-118-142-96-55-138-74-18-52-133-69-21-15-87-93-136-78-105-89-48-5-91-7-121-79-30-41-88-132-137-147-141-104-129-0-62-112-9-83-17-23-37-103-110-101-98-35-71-20-73-140-58-126-10-46-130-92-27-66-107-57-60-24-80-68-63-39-53-143,108-90-97-22-44-31-14-16-59-109-76-61-149-85-19-56-6-8-86-144-50-124-116-11-26-34-148-54-82-33-139-134-84-67-72-113-43-49-115-1-81-125-94-146-38-100-106-111-28-45-114-119-122-42-2-131-120-29-13-135-127-70-40-99-47-95-77-51-4-36-102-145-32-12-75,10825047,18263,18255,36518
gc,kroA150,95-77-51-4-36-146-38-100-120-29-106-111-131-28-13-47-99-70-40-135-2-45-42-122-33-134-84-67-49-115-81-125-94-12-145-102-32-75-43-113-72-143-1-63-39-53-68-80-24-139-116-8-6-82-54-148-11-56-144-86-124-50-60-107-57-66-104-141-147-27-92-130-109-76-19,114-119-26-85-34-149-61-59-22-97-90-44-108-31-10-14-16-46-0-129-62-112-71-20-73-140-58-126-9-83-5-48-91-7-132-137-88-41-121-30-79-138-55-142-96-74-89-105-78-136-133-52-18-3-118-64-65-87-15-21-93-17-23-37-35-103-98-101-110-127-117-123-25-128-69,10776047,16528,25871,42399
gc,kroA150,87-15-21-93-136-78-133-52-105-17-23-37-103-110-101-98-35-83-9-89-18-69-65-64-3-96-74-48-5-62-112-71-20-73-140-58-126-10-16-14-31-108-46-0-129-91-7-138-55-142-118-117-123-25-128-79-30-121-41-88-132-147-141-104-27-92-130-90-97-22-44-109-76-59-61,148-54-82-33-11-26-85-19-6-116-8-56-144-86-139-134-28-45-122-114-119-42-2-135-127-131-111-106-120-29-100-38-84-67-80-24-124-50-60-149-34-13-70-40-99-47-51-77-95-4-36-146-49-72-68-107-57-66-63-113-43-143-39-53-1-115-81-125-94-12-32-145-102-75-137,10741096,17943,20867,38810
gc,kroA150,96-142-55-138-74-18-3-118-64-65-117-123-25-128-69-52-133-105-89-48-5-91-7-41-121-79-30-88-132-137-147-141-104-129-0-62-112-9-83-78-136-87-15-21-93-17-23-37-103-35-71-20-73-140-58-126-46-130-92-27-66-107-57-60-24-80-68-63-39-53-143-113-72-43-1,100-120-29-106-38-95-77-51-4-36-146-84-67-49-115-81-125-94-12-32-145-102-75-111-131-28-45-2-13-47-99-70-40-135-42-122-33-134-139-116-8-6-56-144-86-124-50-82-54-148-11-19-26-85-149-34-119-114-127-61-76-109-59-22-97-90-108-44-31-10-14-16-98-101-110,11057123,18204,19846,38050
gc,kroA150,15-87-21-93-136-78-133-52-69-65-64-3-18-105-17-23-37-103-110-101-98-35-83-9-89-48-5-74-96-142-118-55-138-91-62-112-71-20-73-140-58-126-10-16-14-31-108-46-0-129-7-41-121-79-30-88-132-147-141-104-27-92-130-90-97-22-44-109-76-59-61-149-19-56-86,12-32-75-145-102-94-125-81-146-36-4-95-77-51-38-100-120-29-106-84-115-49-43-113-143-1-72-67-68-63-39-53-80-24-60-124-50-139-134-111-131-28-13-47-99-70-40-135-2-45-33-82-54-116-8-6-144-11-148-122-42-127-114-119-26-85-34-57-107-66-137-117-123-25-128,10941824,17592,21843,39435
gc,kroA150,33-82-54-148-11-116-6-8-56-144-86-139-134-28-45-2-42-122-114-119-26-85-19-149-34-61-76-109-59-50-124-24-80-60-84-67-111-131-13-135-127-70-40-99-47-29-120-106-100-38-95-77-51-4-36-146-115-49-72-68-113-43-143-63-39-53-1-81-125-94-12-32-145-102-75,16-14-10-31-108-90-44-97-22-46-20-73-140-58-126-71-112-9-83-35-37-23-103-98-101-110-17-78-105-89-48-5-62-0-129-130-92-27-104-141-66-57-107-147-91-7-74-18-133-52-136-87-15-21-93-69-65-3-96-138-55-142-118-121-41-88-132-137-30-79-64-117-123-25-128,10922511,16779,18829,35608
gc,kroA150,108-90-97-22-44-31-10-14-16-46-130-92-27-0-129-62-112-71-20-73-140-58-126-9-83-35-37-23-17-78-105-89-48-5-91-7-141-104-66-57-109-76-59-61-149-85-19-56-6-8-86-144-50-124-60-24-80-107-147-132-41-121-138-74-18-133-52-136-87-15-21-93-103-98-101,36-4-77-51-95-146-102-145-32-12-75-94-125-81-115-38-100-120-29-106-111-131-47-99-70-13-28-45-2-135-40-42-122-33-134-84-67-49-43-113-72-143-1-63-39-53-68-139-116-82-54-148-11-26-119-114-127-34-137-88-30-79-55-142-96-118-3-64-65-117-123-25-128-69-110,11037135,16570,23650,40220
gc,kroA150,133-52-78-136-87-15-21-93-69-105-89-18-74-96-3-64-65-128-123-25-117-118-142-55-138-48-5-62-9-83-17-23-37-103-110-101-98-35-71-112-20-73-140-58-126-10-16-14-31-46-0-129-91-7-41-121-79-30-88-132-147-141-104-27-92-130-108-90-97-22-44-109-76-59-61,53-39-63-143-113-43-1-72-68-49-115-81-125-94-12-75-32-145-102-146-67-84-80-24-60-107-66-57-50-124-86-144-139-134-116-8-6-56-19-11-54-82-33-111-106-100-38-120-29-95-77-51-4-36-131-28-45-2-13-47-99-70-40-135-42-122-148-26-85-149-34-119-114-127-137,10889097,17551,18944,36495
gc,kroA150,50-124-86-144-60-24-80-139-8-56-6-116-19-11-26-85-149-61-76-109-59-22-97-90-108-130-57-107-68-72-67-84-134-33-82-54-148-34-119-114-122-45-28-111-131-106-120-29-100-38-49-113-143-63-39-53-43-1-115-81-125-94-146-95-77-51-4-36-102-145-32-12-75-47-13,96-142-55-138-74-18-3-118-64-65-117-123-25-128-69-52-133-105-89-48-5-91-7-41-121-79-30-88-132-137-147-141-104-129-0-62-112-9-83-78-136-87-15-21-93-17-23-37-103-35-71-20-73-140-58-126-46-92-27-66-31-10-16-14-44-98-101-110-42-2-135-127-70-99-40,11009072,17176,24922,42098
gc,kroA150,105-78-136-133-52-89-48-5-62-9-83-17-23-37-103-35-71-112-18-74-96-3-64-65-87-15-21-93-69-128-123-25-117-118-142-55-138-91-7-129-0-46-20-73-140-58-126-98-101-110-10-16-14-31-108-90-97-22-44-130-92-27-141-104-147-41-121-79-30-88-132-137-66-57-107,60-24-80-124-50-86-144-8-6-56-116-139-134-67-84-72-68-63-39-53-143-113-43-49-115-1-81-125-94-146-38-100-106-120-29-111-33-82-54-148-11-19-85-26-149-61-76-109-59-34-119-114-122-45-28-131-2-42-135-13-47-95-77-51-4-36-102-145-32-12-75-99-70-40-127,10868100,19552,17193,36745
gc,kroA150,8-6-116-56-144-86-124-50-139-134-82-54-148-11-19-85-26-149-61-76-109-59-34-33-28-45-122-114-119-42-2-131-111-106-120-29-100-84-67-24-80-60-57-107-68-72-49-43-113-143-63-39-53-1-115-38-95-77-51-47-13-135-127-70-40-99-4-36-146-81-125-94-12-32-145,98-101-110-103-37-23-35-126-58-140-73-20-71-83-9-17-136-78-105-89-48-5-112-62-46-10-16-14-31-108-90-44-97-22-130-0-129-91-74-18-133-52-87-93-21-15-69-65-64-3-96-142-55-138-7-41-121-79-30-88-132-147-141-104-27-92-66-137-118-117-123-25-128-75-102,10790998,17675,23804,41479
gc,kroA150,74-18-96-55-138-142-118-3-64-65-52-133-105-89-48-5-62-91-7-41-121-79-30-88-132-147-141-129-0-112-9-83-78-136-87-15-21-69-93-17-23-37-35-71-20-73-140-58-126-46-130-92-27-104-66-107-57-60-50-124-24-80-68-137-117-123-25-128-103-110-101-98-10-31-108,61-59-76-109-149-85-34-26-19-11-56-6-8-116-144-86-139-54-82-148-119-114-33-134-28-45-122-42-2-131-111-106-120-29-100-84-67-72-49-113-143-63-39-53-43-115-38-95-77-51-13-135-127-70-40-99-47-22-97-90-44-14-16-1-81-146-36-4-102-145-32-12-94-125-75,10831831,20400,21861,42261
gc,kroA150,41-121-88-30-79-138-7-91-55-142-118-96-74-18-48-5-62-0-129-132-137-147-141-104-66-27-92-130-46-112-89-105-133-52-3-64-65-117-123-25-128-69-15-87-136-78-9-83-71-20-73-140-58-126-35-37-23-17-93-21-103-110-101-98-10-31-108-90-97-22-44-57-107-60-24,115-49-43-113-143-1-81-125-94-12-32-145-102-146-38-100-120-29-106-84-67-72-68-63-39-53-80-139-134-111-131-28-45-2-13-95-77-51-4-36-75-47-99-70-40-135-42-122-33-82-54-116-8-6-144-86-124-50-56-11-148-19-26-85-149-61-76-109-59-34-119-114-127-14-16,10735161,19054,21013,40067
gc,kroA150,142-55-138-96-118-79-30-121-41-88-7-91-74-18-3-64-65-117-123-25-128-69-52-133-105-89-48-5-62-0-129-141-147-132-137-104-66-27-92-130-46-112-9-83-78-136-87-15-21-93-17-23-37-103-35-71-20-73-140-58-126-10-31-108-90-97-22-44-14-16-57-107-60-24-80,86-144-124-50-56-8-6-116-139-134-33-82-54-148-11-19-85-26-149-61-76-109-59-34-119-114-122-45-28-111-131-106-120-29-100-84-67-72-68-113-43-49-143-63-39-53-1-115-38-95-77-51-47-13-2-42-135-127-70-99-40-4-36-146-81-125-94-12-32-145-102-75-98-101-110,11774318,18605,21735,40340
gc,kroA150,45-2-28-131-111-13-135-42-122-114-119-33-82-54-148-11-26-85-19-6-116-8-56-134-139-144-86-124-50-24-80-84-106-120-29-100-38-95-77-51-47-99-70-40-127-34-149-61-59-76-109-60-67-72-49-43-113-143-68-63-39-53-1-115-146-4-36-102-145-32-12-75-94-125-81,108-90-97-22-44-31-10-14-16-46-130-92-27-0-129-62-112-71-20-73-140-58-126-9-83-35-37-23-17-78-105-89-48-5-91-7-141-104-66-57-107-147-132-41-121-138-74-18-133-52-136-87-15-21-93-103-98-101-110-69-65-3-96-55-142-118-79-30-88-137-64-117-123-25-128,10769130,16807,20057,36864
gc,kroA150,52-133-78-136-87-15-21-93-69-18-105-89-48-5-74-96-3-64-65-128-123-25-117-118-142-55-138-91-62-9-83-17-23-37-103-110-101-98-35-71-112-20-73-140-58-126-10-16-14-31-46-0-129-7-41-121-79-30-88-132-147-141-104-27-92-130-108-90-97-22-44-109-76-59-61,143-113-43-1-63-39-53-68-72-49-115-81-125-94-12-75-32-145-102-146-38-67-84-80-24-60-107-57-66-137-124-50-86-144-139-134-106-100-120-29-111-131-28-33-116-8-6-56-19-11-54-82-148-26-85-149-34-119-114-45-2-13-47-95-77-51-4-36-99-70-40-135-42-122-127,11177739,17663,18745,36408
gc,kroA150,32-145-102-12-75-94-125-81-146-36-4-77-51-95-38-100-120-29-106-84-67-115-49-43-113-143-1-72-68-63-39-53-80-24-139-134-111-131-28-47-99-70-13-2-45-33-82-54-116-8-6-56-144-86-124-50-60-107-57-66-104-141-147-137-132-88-41-121-30-79-7-27-92-130-109,128-25-123-117-64-65-3-118-142-96-18-52-133-69-21-15-87-93-136-78-105-89-74-55-138-91-48-5-62-9-83-17-23-37-103-110-101-98-35-71-112-0-129-46-20-73-140-58-126-10-16-14-31-108-90-97-22-44-76-59-61-149-19-85-26-11-34-148-119-114-122-42-135-127-40,10668081,17931,20367,38298
gc,kroA150,3-64-65-123-25-117-118-96-142-55-138-74-18-52-133-87-15-21-69-128-93-136-78-105-89-48-5-62-91-7-41-121-79-30-88-132-137-147-141-129-0-112-9-83-17-23-37-103-110-101-98-35-71-20-73-140-58-126-10-46-130-92-27-104-66-107-57-60-24-80-68-63-39-53-143,13-2-135-70-99-40-47-131-28-45-42-122-127-111-106-29-120-100-38-95-77-51-4-36-146-84-134-33-82-54-148-114-119-11-116-6-8-139-144-86-56-19-26-85-34-149-61-59-76-109-50-124-67-72-49-115-81-125-94-12-145-102-32-75-43-113-1-22-97-90-44-108-31-14-16,10820339,18363,19584,37947
gc,kroA150,132-137-88-41-121-30-79-138-7-147-141-104-66-27-92-129-0-91-55-142-118-96-74-48-5-62-112-46-130-57-107-68-63-39-53-143-113-43-1-72-49-80-24-60-50-124-86-144-56-8-6-116-139-134-67-84-115-81-125-94-12-75-32-145-102-146-38-100-106-120-29-111-131-28-33,61-59-76-109-149-85-34-26-19-11-148-54-82-119-114-122-42-45-2-135-127-13-70-40-99-47-95-77-51-4-36-22-97-90-44-108-31-10-14-16-140-58-73-20-71-126-9-83-89-105-78-136-133-52-18-3-64-65-87-15-21-93-17-23-37-35-103-98-101-110-69-128-123-117-25,10896516,17514,19743,37257
gc,kroA150,84-67-72-49-43-113-143-63-68-80-24-139-134-106-120-29-100-38-95-77-51-4-36-146-115-81-125-94-12-32-145-102-75-111-131-28-33-82-54-116-8-6-56-144-86-124-50-60-107-57-66-104-141-147-39-53-1-45-2-13-47-99-70-40-135-42-122-114-119-148-11-19-26-85-149,118-142-55-96-3-64-65-117-123-25-128-18-74-138-79-30-121-41-88-7-91-5-48-89-105-52-133-78-136-87-15-21-69-93-17-23-37-83-9-62-0-129-132-137-27-92-130-46-112-71-20-73-140-58-126-35-103-110-101-98-10-31-108-90-97-22-44-14-16-109-76-59-61-34-127,10723173,17216,21390,38606
gc,kroA150,52-133-78-136-87-15-21-93-69-18-105-89-48-5-74-96-3-64-65-128-123-25-117-118-142-55-138-91-62-9-83-17-23-37-103-110-101-98-35-71-112-20-73-140-58-126-10-16-14-31-46-0-129-7-41-121-79-30-88-132-147-141-104-27-92-130-108-90-97-22-44-109-76-59-61,116-6-8-56-144-86-139-134-33-82-54-148-11-19-26-85-149-34-119-114-122-45-28-131-111-106-120-29-100-84-67-80-24-124-50-60-57-107-68-72-49-43-113-143-63-39-53-1-115-38-95-77-51-47-13-2-42-135-127-70-40-99-4-36-146-81-125-94-12-32-145-102-75-66-137,10818607,17663,18893,36556
gc,kroA150,87-15-21-93-136-78-133-52-105-17-23-37-103-110-101-98-35-83-9-89-18-69-65-64-3-96-74-48-5-62-112-71-20-73-140-58-126-10-16-14-31-108-46-0-129-91-7-138-55-142-118-117-123-25-128-79-30-121-41-88-132-147-141-104-27-92-130-90-97-22-44-109-76-59-61,53-39-63-143-113-43-1-72-68-49-115-81-125-94-12-75-32-145-102-146-67-84-80-24-60-107-66-57-50-124-86-144-139-134-116-8-6-56-19-11-54-82-33-111-106-100-38-120-29-95-77-51-4-36-131-28-45-2-13-47-99-70-40-135-42-122-148-26-85-149-34-119-114-127-137,10718345,17943,18944,36887
gc,kroA150,143-113-43-1-63-39-53-68-72-49-115-81-125-94-12-75-32-145-102-146-38-67-84-80-24-60-107-57-66-104-141-147-132-137-88-41-121-30-79-7-91-129-27-92-130-50-124-86-144-139-134-106-100-120-29-111-131-28-33-116-8-6-56-19-11-54-82-148-26-85-149-61-76-109-59,55-142-138-96-118-3-64-65-117-123-25-128-74-18-52-133-105-89-48-5-62-0-112-9-83-78-136-87-15-21-69-93-17-23-37-35-71-20-73-140-58-126-46-108-90-97-22-31-10-14-16-44-103-110-101-98-34-119-114-122-45-2-42-135-13-47-95-77-51-4-36-99-70-40-127,10839017,16604,23236,39840
gc,kroA150,7-91-138-41-121-88-30-79-55-142-96-74-48-5-62-0-129-141-147-104-66-132-137-27-92-130-46-112-89-18-118-3-64-65-117-123-25-128-52-133-105-78-136-87-15-21-69-93-17-9-83-71-20-73-140-58-126-35-37-23-103-110-101-98-10-31-108-90-97-22-44-14-16-57-107,42-122-45-2-135-127-114-119-148-54-82-33-28-131-13-70-40-99-47-111-106-120-29-100-38-95-77-51-4-36-146-84-134-139-116-6-8-56-11-26-85-34-19-149-61-59-76-109-86-144-124-50-24-80-60-67-72-49-43-113-143-68-63-39-53-1-115-81-125-94-12-145-102-32-75,10768986,19028,16011,35039
gc,kroA150,94-125-81-12-75-32-145-102-36-4-146-115-49-43-113-143-1-72-67-84-38-100-95-77-51-29-120-106-111-131-28-45-2-13-47-99-70-40-135-42-122-33-134-139-80-24-68-63-39-53-107-60-124-50-86-144-8-116-6-56-82-54-148-11-19-26-85-149-61-76-109-57-66-104-141,44-90-97-22-108-31-10-14-16-140-58-73-20-71-112-46-130-92-27-0-129-62-5-48-89-9-83-126-35-37-23-103-98-101-110-17-78-105-133-52-136-87-15-21-93-18-74-91-7-147-59-34-119-114-127-132-41-121-138-55-142-96-118-79-30-88-137-3-64-65-69-128-123-25-117,10899419,16407,23123,39530
gc,kroA150,146-36-4-95-77-51-38-100-120-29-106-84-67-49-115-81-125-94-12-32-145-102-75-43-113-72-143-1-63-39-53-68-80-24-139-134-111-131-28-45-2-13-47-99-70-40-135-42-122-33-82-54-116-8-6-56-144-86-124-50-60-107-57-66-104-141-147-27-92-130-109-76-19-11-148,30-79-121-41-88-132-137-7-138-55-142-118-96-74-91-129-0-62-5-48-89-18-3-64-117-123-25-65-128-69-52-133-105-78-136-87-15-21-93-17-23-83-9-112-46-108-90-97-22-44-31-10-14-16-20-71-73-140-58-126-35-37-103-110-101-98-59-61-149-85-26-34-119-114-127,10836334,16302,19782,36084
nn,kroA150,99-70-40-135-2-45-28-131-111-106-120-29-100-38-95-77-51-4-36-146-12-32-145-102-75-94-125-81-115-49-43-113-143-63-39-53-1-72-67-84-134-139-116-6-8-56-144-86-124-50-60-24-80-68-107-57-27-92-130-46-108-90-97-22-44-31-10-14-16-140-58-73-20-71-112,123-25-128-65-64-3-96-142-55-138-121-41-88-30-79-7-91-129-0-62-5-48-89-105-78-136-87-15-21-93-69-52-133-18-74-118-117-17-23-37-103-101-110-98-35-83-9-126-59-61-149-85-26-11-19-34-148-54-82-33-122-42-127-114-119-13-47-76-109-104-141-147-66-132-137,3239961,15615,21314,36929
nn,kroA150,125-94-12-32-145-102-75-81-115-49-43-113-143-63-39-53-1-72-67-84-134-139-116-6-8-56-144-86-124-50-60-24-80-68-107-57-27-92-130-46-108-90-97-22-44-31-10-14-16-140-58-73-20-71-112-9-83-35-37-23-17-136-78-105-89-48-5-62-0-129-91-7-41-121-79,15-87-21-93-69-52-133-18-74-96-142-55-138-30-88-132-137-147-141-104-66-109-76-59-61-149-85-26-11-19-34-148-54-82-33-28-131-111-106-120-29-100-38-95-77-51-4-36-146-47-99-70-40-135-2-45-42-122-114-119-127-13-126-98-101-110-103-65-64-3-117-123-25-128-118,3246356,15826,20422,36248
nn,kroA150,144-86-124-50-60-24-80-68-72-49-43-113-143-63-39-53-1-115-81-125-94-12-32-145-102-75-36-4-77-51-95-38-100-120-29-106-111-131-28-45-2-135-42-122-114-119-148-54-82-33-134-139-116-6-8-56-19-11-26-85-34-149-61-59-76-109-22-97-90-108-31-10-14-16-140,40-70-99-47-13-127-84-67-146-107-57-27-92-130-46-112-71-20-73-58-126-35-37-23-17-136-78-105-89-48-5-62-0-129-91-7-41-121-79-30-88-132-137-147-141-104-66-138-55-142-118-96-74-18-52-133-87-15-21-93-69-65-64-3-117-123-25-128-83-9-103-101-110-98-44,3317431,13388,22584,35972
nn,kroA150,116-6-8-56-144-86-124-50-60-24-80-68-72-49-43-113-143-63-39-53-1-115-81-125-94-12-32-145-102-75-36-4-77-51-95-38-100-120-29-106-111-131-28-45-2-135-42-122-114-119-148-54-82-33-134-139-84-67-146-47-99-70-40-13-127-11-26-85-34-149-61-59-76-109-22,15-87-21-93-136-78-105-89-48-5-62-0-129-91-7-41-121-79-30-88-132-137-147-141-104-66-107-57-27-92-130-46-108-90-97-44-31-10-14-16-140-58-73-20-71-112-9-83-35-37-23-17-133-52-18-74-96-142-55-138-118-3-64-65-128-25-123-117-69-103-101-110-98-126-19,3246478,15360,19664,35024
nn,kroA150,52-133-78-136-87-15-21-93-69-65-64-3-96-142-55-138-121-41-88-30-79-7-91-129-0-62-5-48-89-105-18-74-118-117-123-25-128-17-23-37-103-101-110-98-35-83-9-71-20-73-140-58-126-16-14-10-31-108-90-97-22-44-46-130-92-27-104-141-147-66-107-57-60-24-80,19-11-26-85-34-149-61-59-76-109-56-6-8-116-54-82-148-33-134-139-144-86-124-50-68-72-49-43-113-143-63-39-53-1-115-81-125-94-12-32-145-102-75-36-4-77-51-95-38-100-120-29-106-111-131-28-45-2-135-42-122-114-119-127-40-70-99-47-13-84-67-146-137-132-112,3254120,17069,18743,35812
nn,kroA150,27-92-130-46-108-90-97-22-44-31-10-14-16-140-58-73-20-71-112-9-83-35-37-23-17-136-78-105-89-48-5-62-0-129-91-7-41-121-79-30-88-132-137-147-141-104-66-107-57-60-24-80-124-50-86-144-8-6-116-56-19-11-26-85-34-149-61-59-76-109-148-54-82-33-134,81-125-94-12-32-145-102-75-36-4-77-51-95-38-100-120-29-106-111-131-28-45-2-135-42-122-114-119-127-40-70-99-47-13-84-67-72-49-43-113-143-63-39-53-1-115-146-139-68-138-55-142-118-96-74-18-52-133-87-15-21-93-69-65-64-3-117-123-25-128-103-101-110-98-126,3252142,14232,21683,35915
nn,kroA150,35-37-23-17-136-78-105-89-48-5-62-0-129-91-7-41-121-79-30-88-132-137-147-141-104-66-107-57-27-92-130-46-108-90-97-22-44-31-10-14-16-140-58-73-20-71-112-9-83-103-101-110-98-126-133-52-87-15-21-93-69-65-64-3-96-142-55-138-74-18-118-117-123-25-128,40-70-99-47-13-2-45-28-131-111-106-120-29-100-38-95-77-51-4-36-146-12-32-145-102-75-94-125-81-115-49-43-113-143-63-39-53-1-72-67-84-134-139-116-6-8-56-144-86-124-50-60-24-80-68-33-82-54-148-11-26-85-34-149-61-59-76-109-19-119-114-122-42-127-135,3256523,16919,13848,30767
nn,kroA150,31-108-90-97-22-44-10-14-16-140-58-73-20-71-112-9-83-35-37-23-17-136-78-105-89-48-5-62-0-129-91-7-41-121-79-30-88-132-137-147-141-104-66-107-57-27-92-130-46-109-76-59-61-149-85-26-11-19-56-6-8-116-54-82-148-33-134-139-144-86-124-50-60-24-80,131-111-28-45-2-135-42-122-114-119-127-40-70-99-47-13-29-120-106-100-38-95-77-51-4-36-146-12-32-145-102-75-94-125-81-115-49-43-113-143-63-39-53-1-72-67-84-68-34-126-98-101-110-103-93-21-15-87-133-52-18-74-96-142-55-138-118-3-64-65-128-25-123-117-69,3283438,14408,21843,36251
nn,kroA150,93-21-15-87-136-78-105-89-48-5-62-0-129-91-7-41-121-79-30-88-132-137-147-141-104-66-107-57-27-92-130-46-108-90-97-22-44-31-10-14-16-140-58-73-20-71-112-9-83-35-37-23-17-133-52-18-74-96-142-55-138-118-3-64-65-128-25-123-117-69-103-101-110-98-126,94-125-81-115-49-43-113-143-63-39-53-1-72-67-84-134-139-116-6-8-56-144-86-124-50-60-24-80-68-38-100-120-29-106-111-131-28-45-2-135-42-122-114-119-148-54-82-33-11-26-85-34-149-61-59-76-109-19-127-40-70-99-47-13-51-77-95-4-36-146-12-32-145-102-75,3270975,16331,14859,31190
nn,kroA150,143-113-43-49-72-67-84-134-139-116-6-8-56-144-86-124-50-60-24-80-68-63-39-53-1-115-81-125-94-12-32-145-102-75-36-4-77-51-95-38-100-120-29-106-111-131-28-45-2-135-42-122-114-119-148-54-82-33-11-26-85-34-149-61-59-76-109-22-97-90-108-31-10-14-16,40-70-99-47-13-127-19-57-107-66-104-141-147-132-137-88-41-121-79-30-138-55-142-118-96-74-18-52-133-78-136-87-15-21-93-69-65-64-3-117-123-25-128-105-89-48-5-62-0-129-91-7-27-92-130-46-112-71-20-73-140-58-126-35-37-23-17-83-9-103-101-110-98-44-146,3229817,14096,21922,36018
nn,kroA150,118-142-55-138-121-41-88-30-79-7-91-129-0-62-5-48-89-105-78-136-87-15-21-93-69-52-133-18-74-96-3-64-65-128-25-123-117-17-23-37-103-101-110-98-35-83-9-71-20-73-140-58-126-16-14-10-31-108-90-97-22-44-46-130-92-27-104-141-147-66-107-57-60-24-80,2-45-28-131-111-106-120-29-100-38-95-77-51-4-36-146-12-32-145-102-75-94-125-81-115-49-43-113-143-63-39-53-1-72-67-84-134-139-116-6-8-56-144-86-124-50-19-11-26-85-34-149-61-59-76-109-148-54-82-33-122-42-127-135-13-70-40-99-47-114-119-68-137-132-112,3342746,16487,19540,36027
nn,kroA150,98-101-110-103-37-23-17-136-78-105-89-48-5-62-0-129-91-7-41-121-79-30-88-132-137-147-141-104-66-107-57-27-92-130-46-108-90-97-22-44-31-10-14-16-140-58-73-20-71-112-9-83-35-126-133-52-87-15-21-93-69-65-64-3-96-142-55-138-74-18-118-117-123-25-128,116-6-8-56-144-86-124-50-60-24-80-68-72-49-43-113-143-63-39-53-1-115-81-125-94-12-32-145-102-75-36-4-77-51-95-38-100-120-29-106-111-131-28-45-2-135-42-122-114-119-148-54-82-33-134-139-84-67-146-47-99-70-40-13-127-11-26-85-34-149-61-59-76-109-19,3252394,16487,14738,31225
nn,kroA150,60-24-80-124-50-86-144-8-6-116-56-19-11-26-85-34-149-61-59-76-109-22-97-90-108-31-10-14-16-140-58-73-20-71-112-9-83-35-37-23-17-136-78-105-89-48-5-62-0-129-91-7-41-121-79-30-88-132-137-147-141-104-66-107-57-27-92-130-46-44-126-98-101-110-103,81-125-94-12-32-145-102-75-36-4-77-51-95-38-100-120-29-106-111-131-28-45-2-135-42-122-114-119-148-54-82-33-134-139-84-67-72-49-43-113-143-63-39-53-1-115-146-47-99-70-40-13-127-68-138-55-142-118-96-74-18-52-133-87-15-21-93-69-65-64-3-117-123-25-128,3393952,15935,20415,36350
nn,kroA150,48-5-62-0-129-91-7-41-121-79-30-88-132-137-147-141-104-66-107-57-27-92-130-46-108-90-97-22-44-31-10-14-16-140-58-73-20-71-112-9-83-35-37-23-17-136-78-105-89-18-74-96-142-55-138-118-3-64-65-128-25-123-117-69-21-15-87-93-133-52-103-101-110-98-126,56-6-8-116-54-82-148-11-26-85-34-149-61-59-76-109-19-86-144-124-50-60-24-80-68-72-49-43-113-143-63-39-53-1-115-81-125-94-12-32-145-102-75-36-4-77-51-95-38-100-120-29-106-111-131-28-45-2-135-42-122-114-119-33-134-139-84-67-146-47-99-70-40-13-127,3456541,16105,15255,31360
nn,kroA150,62-5-48-89-105-78-136-87-15-21-93-69-52-133-18-74-96-142-55-138-121-41-88-30-79-7-91-129-0-92-27-104-141-147-66-107-57-60-24-80-124-50-86-144-8-6-116-56-19-11-26-85-34-149-61-59-76-109-22-97-90-108-31-10-14-16-140-58-73-20-71-112-9-83-35,146-36-4-77-51-95-38-100-120-29-106-111-131-28-45-2-135-42-122-114-119-148-54-82-33-134-139-84-67-72-49-43-113-143-63-39-53-1-115-81-125-94-12-32-145-102-75-47-99-70-40-13-127-68-137-132-118-3-64-65-128-25-123-117-17-23-37-103-101-110-98-126-46-130-44,3361169,13335,21981,35316
nn,kroA150,29-120-106-100-38-95-77-51-4-36-146-12-32-145-102-75-94-125-81-115-49-43-113-143-63-39-53-1-72-67-84-134-139-116-6-8-56-144-86-124-50-60-24-80-68-107-57-27-92-130-46-108-90-97-22-44-31-10-14-16-140-58-73-20-71-112-9-83-35-37-23-17-136-78-105,109-76-59-61-149-85-26-11-19-34-148-54-82-33-28-131-111-45-2-135-42-122-114-119-127-40-70-99-47-13-66-104-141-147-132-137-88-41-121-79-30-138-55-142-118-96-74-18-52-133-87-15-21-93-69-65-64-3-117-123-25-128-89-48-5-62-0-129-91-7-126-98-101-110-103,3338186,15995,19879,35874
nn,kroA150,122-42-2-45-28-131-111-106-120-29-100-38-95-77-51-4-36-146-12-32-145-102-75-94-125-81-115-49-43-113-143-63-39-53-1-72-67-84-134-139-116-6-8-56-144-86-124-50-60-24-80-68-107-57-27-92-130-46-108-90-97-22-44-31-10-14-16-140-58-73-20-71-112-9-83,117-123-25-128-65-64-3-96-142-55-138-121-41-88-30-79-7-91-129-0-62-5-48-89-105-78-136-87-15-21-93-69-52-133-18-74-118-132-137-147-141-104-66-109-76-59-61-149-85-26-11-19-34-148-54-82-33-114-119-127-135-13-70-40-99-47-126-35-37-23-17-103-101-110-98,3358325,15501,20580,36081
nn,kroA150,101-110-103-37-23-17-136-78-105-89-48-5-62-0-129-91-7-41-121-79-30-88-132-137-147-141-104-66-107-57-27-92-130-46-108-90-97-22-44-31-10-14-16-140-58-73-20-71-112-9-83-35-98-126-133-52-87-15-21-93-69-65-64-3-96-142-55-138-74-18-118-117-123-25-128,70-40-99-47-13-2-45-28-131-111-106-120-29-100-38-95-77-51-4-36-146-12-32-145-102-75-94-125-81-115-49-43-113-143-63-39-53-1-72-67-84-134-139-116-6-8-56-144-86-124-50-60-24-80-68-33-82-54-148-11-26-85-34-149-61-59-76-109-19-119-114-122-42-127-135,3513899,16783,13881,30664
nn,kroA150,110-101-98-103-37-23-17-136-78-105-89-48-5-62-0-129-91-7-41-121-79-30-88-132-137-147-141-104-66-107-57-27-92-130-46-108-90-97-22-44-31-10-14-16-140-58-73-20-71-112-9-83-35-126-133-52-87-15-21-93-69-65-64-3-96-142-55-138-74-18-118-117-123-25-128,77-51-95-4-36-146-38-100-120-29-106-111-131-28-45-2-135-42-122-114-119-148-54-82-33-134-139-116-6-8-56-144-86-124-50-60-24-80-68-72-49-43-113-143-63-39-53-1-115-81-125-94-12-32-145-102-75-84-67-11-26-85-34-149-61-59-76-109-19-127-40-70-99-47-13,3256586,16358,15364,31722
nn,kroA150,111-131-28-45-2-135-42-122-114-119-148-54-82-33-134-139-116-6-8-56-144-86-124-50-60-24-80-68-72-49-43-113-143-63-39-53-1-115-81-125-94-12-32-145-102-75-36-4-77-51-95-38-100-120-29-106-84-67-146-47-99-70-40-13-127-11-26-85-34-149-61-59-76-109-22,136-78-105-89-48-5-62-0-129-91-7-41-121-79-30-88-132-137-147-141-104-66-107-57-27-92-130-46-108-90-97-44-31-10-14-16-140-58-73-20-71-112-9-83-35-37-23-17-93-21-15-87-133-52-18-74-96-142-55-138-118-3-64-65-128-25-123-117-69-103-101-110-98-126-19,3260478,15975,19321,35296
nn,kroA150,124-50-86-144-8-6-116-56-19-11-26-85-34-149-61-59-76-109-22-97-90-108-31-10-14-16-140-58-73-20-71-112-9-83-35-37-23-17-136-78-105-89-48-5-62-0-129-91-7-41-121-79-30-88-132-137-147-141-104-66-107-57-27-92-130-46-44-126-98-101-110-103-93-21-15,146-36-4-77-51-95-38-100-120-29-106-111-131-28-45-2-135-42-122-114-119-148-54-82-33-134-139-24-80-60-68-72-49-43-113-143-63-39-53-1-115-81-125-94-12-32-145-102-75-84-67-13-70-40-99-47-127-138-55-142-118-96-74-18-52-133-87-69-65-64-3-117-123-25-128,3248783,16395,21892,38287
nn,kroA150,108-90-97-22-44-31-10-14-16-140-58-73-20-71-112-9-83-35-37-23-17-136-78-105-89-48-5-62-0-129-91-7-41-121-79-30-88-132-137-147-141-104-66-107-57-27-92-130-46-109-76-59-61-149-85-26-11-19-56-6-8-116-54-82-148-33-134-139-144-86-124-50-60-24-80,118-142-55-138-96-74-18-52-133-87-15-21-93-69-65-64-3-117-123-25-128-103-101-110-98-126-34-119-114-122-42-2-45-28-131-111-106-120-29-100-38-95-77-51-4-36-146-12-32-145-102-75-94-125-81-115-49-43-113-143-63-39-53-1-72-67-84-68-13-135-127-40-70-99-47,3254199,14221,21877,36098
nn,kroA150,13-2-45-28-131-111-106-120-29-100-38-95-77-51-4-36-146-12-32-145-102-75-94-125-81-115-49-43-113-143-63-39-53-1-72-67-84-134-139-116-6-8-56-144-86-124-50-60-24-80-68-107-57-27-92-130-46-108-90-97-22-44-31-10-14-16-140-58-73-20-71-112-9-83-35,109-76-59-61-149-85-26-11-19-34-148-54-82-33-122-42-127-135-70-40-99-47-114-119-66-104-141-147-132-137-88-41-121-79-30-138-55-142-118-96-74-18-52-133-78-136-87-15-21-93-69-65-64-3-117-123-25-128-105-89-48-5-62-0-129-91-7-17-23-37-103-101-110-98-126,3271957,16220,19065,35285
nn,kroA150,104-141-147-66-107-57-27-92-130-46-108-90-97-22-44-31-10-14-16-140-58-73-20-71-112-9-83-35-37-23-17-136-78-105-89-48-5-62-0-129-91-7-41-121-79-30-88-132-137-53-39-63-143-113-43-49-72-67-84-134-139-116-6-8-56-144-86-124-50-60-24-80-68-1-115,149-85-26-11-19-34-61-59-76-109-148-54-82-33-28-131-111-106-120-29-100-38-95-77-51-4-36-146-12-32-145-102-75-94-125-81-47-99-70-40-135-2-45-42-122-114-119-127-13-138-55-142-118-96-74-18-52-133-87-15-21-93-69-65-64-3-117-123-25-128-103-101-110-98-126,3242069,15307,20639,35946
nn,kroA150,74-18-52-133-78-136-87-15-21-93-69-65-64-3-96-142-55-138-121-41-88-30-79-7-91-129-0-62-5-48-89-105-17-23-37-103-101-110-98-35-83-9-71-20-73-140-58-126-16-14-10-31-108-90-97-22-44-46-130-92-27-104-141-147-66-107-57-60-24-80-124-50-86-144-8,2-45-28-131-111-106-120-29-100-38-95-77-51-4-36-146-12-32-145-102-75-94-125-81-115-49-43-113-143-63-39-53-1-72-67-84-134-139-116-6-56-19-11-26-85-34-149-61-59-76-109-148-54-82-33-122-42-127-135-13-70-40-99-47-114-119-68-137-132-118-117-123-25-128-112,3253573,15467,20776,36243
nn,kroA150,19-11-26-85-34-149-61-59-76-109-22-97-90-108-31-10-14-16-140-58-73-20-71-112-9-83-35-37-23-17-136-78-105-89-48-5-62-0-129-91-7-41-121-79-30-88-132-137-147-141-104-66-107-57-27-92-130-46-44-126-98-101-110-103-93-21-15-87-133-52-18-74-96-142-55,127-42-122-45-2-135-13-131-111-28-33-82-54-148-119-114-116-6-8-56-144-86-124-50-60-24-80-68-72-49-43-113-143-63-39-53-1-115-81-125-94-12-32-145-102-75-36-4-77-51-95-38-100-120-29-106-84-67-139-134-47-99-70-40-146-138-118-3-64-65-128-25-123-117-69,3261450,16650,21639,38289
nn,kroA150,149-85-26-11-19-56-6-8-116-54-82-148-33-134-139-144-86-124-50-60-24-80-68-72-49-43-113-143-63-39-53-1-115-81-125-94-12-32-145-102-75-36-4-77-51-95-38-100-120-29-106-111-131-28-45-2-135-42-122-114-119-127-40-70-99-47-13-84-67-146-107-57-27-92-130,66-104-141-147-132-137-88-41-121-79-30-138-55-142-118-96-74-18-52-133-78-136-87-15-21-93-69-65-64-3-117-123-25-128-105-89-48-5-62-0-129-91-7-46-108-90-97-22-44-31-10-14-16-140-58-73-20-71-112-9-83-35-37-23-17-103-101-110-98-126-59-61-76-109-34,3242967,16148,18067,34215
nn,kroA150,27-92-130-46-108-90-97-22-44-31-10-14-16-140-58-73-20-71-112-9-83-35-37-23-17-136-78-105-89-48-5-62-0-129-91-7-41-121-79-30-88-132-137-147-141-104-66-107-57-60-24-80-124-50-86-144-8-6-116-56-19-11-26-85-34-149-61-59-76-109-148-54-82-33-134,118-142-55-138-96-74-18-52-133-87-15-21-93-69-65-64-3-117-123-25-128-103-101-110-98-126-139-84-67-72-49-43-113-143-63-39-53-1-115-81-125-94-12-32-145-102-75-36-4-77-51-95-38-100-120-29-106-111-131-28-45-2-135-42-122-114-119-127-40-70-99-47-13-146-68,3555438,14232,20858,35090
nn,kroA150,129-0-62-5-48-89-105-78-136-87-15-21-93-69-52-133-18-74-96-142-55-138-121-41-88-30-79-7-91-141-104-66-147-132-137-53-39-63-143-113-43-49-72-67-84-134-139-116-6-8-56-144-86-124-50-60-24-80-68-107-57-27-92-130-46-108-90-97-22-44-31-10-14-16-140,131-111-28-45-2-135-42-122-114-119-148-54-82-33-11-26-85-34-149-61-59-76-109-19-127-40-70-99-47-13-29-120-106-100-38-95-77-51-4-36-146-12-32-145-102-75-94-125-81-115-1-118-3-64-65-128-25-123-117-17-23-37-103-101-110-98-35-83-9-71-20-73-58-126-112,3238140,15133,20025,35158
nn,kroA150,38-100-120-29-106-111-131-28-45-2-135-42-122-114-119-148-54-82-33-134-139-116-6-8-56-144-86-124-50-60-24-80-68-72-49-43-113-143-63-39-53-1-115-81-125-94-12-32-145-102-75-36-4-77-51-95-146-84-67-107-57-27-92-130-46-108-90-97-22-44-31-10-14-16-140,128-25-123-117-64-65-3-96-142-55-138-121-41-88-30-79-7-91-129-0-62-5-48-89-105-78-136-87-15-21-93-69-52-133-18-74-118-132-137-147-141-104-66-109-76-59-61-149-85-26-11-19-34-127-40-70-99-47-13-112-71-20-73-58-126-35-37-23-17-83-9-103-101-110-98,3560788,16214,20781,36995
nn,kroA150,149-85-26-11-19-56-6-8-116-54-82-148-33-134-139-144-86-124-50-60-24-80-68-72-49-43-113-143-63-39-53-1-115-81-125-94-12-32-145-102-75-36-4-77-51-95-38-100-120-29-106-111-131-28-45-2-135-42-122-114-119-127-40-70-99-47-13-84-67-146-107-57-27-92-130,140-58-73-20-71-112-9-83-35-37-23-17-136-78-105-89-48-5-62-0-129-91-7-41-121-79-30-88-132-137-147-141-104-66-46-108-90-97-22-44-31-10-14-16-126-98-101-110-103-93-21-15-87-133-52-18-74-96-142-55-138-118-3-64-65-128-25-123-117-69-109-76-59-61-34,3272886,16148,18981,35129
nn,kroA150,136-78-105-89-48-5-62-0-129-91-7-41-121-79-30-88-132-137-147-141-104-66-107-57-27-92-130-46-108-90-97-22-44-31-10-14-16-140-58-73-20-71-112-9-83-35-37-23-17-93-21-15-87-133-52-18-74-96-142-55-138-118-3-64-65-128-25-123-117-69-103-101-110-98-126,32-145-102-12-75-94-125-81-115-49-43-113-143-63-39-53-1-72-67-84-134-139-116-6-8-56-144-86-124-50-60-24-80-68-38-100-120-29-106-111-131-28-45-2-135-42-122-114-119-148-54-82-33-11-26-85-34-149-61-59-76-109-19-127-40-70-99-47-13-51-77-95-4-36-146,3261289,16148,14884,31032
nn,kroA150,28-131-111-106-120-29-100-38-95-77-51-4-36-146-12-32-145-102-75-94-125-81-115-49-43-113-143-63-39-53-1-72-67-84-134-139-116-6-8-56-144-86-124-50-60-24-80-68-107-57-27-92-130-46-108-90-97-22-44-31-10-14-16-140-58-73-20-71-112-9-83-35-37-23-17,0-129-91-7-41-121-79-30-88-132-137-147-141-104-66-62-5-48-89-105-78-136-87-15-21-93-69-52-133-18-74-96-142-55-138-118-3-64-65-128-25-123-117-103-101-110-98-126-59-61-149-85-26-11-19-34-148-54-82-33-45-2-135-42-122-114-119-127-40-70-99-47-13-76-109,3493302,16137,19692,35829
nn,kroA150,51-77-95-4-36-146-38-100-120-29-106-111-131-28-45-2-135-42-122-114-119-148-54-82-33-134-139-116-6-8-56-144-86-124-50-60-24-80-68-72-49-43-113-143-63-39-53-1-115-81-125-94-12-32-145-102-75-84-67-107-57-27-92-130-46-108-90-97-22-44-31-10-14-16-140,11-26-85-34-149-61-59-76-109-19-127-40-70-99-47-13-66-104-141-147-132-137-88-41-121-79-30-138-55-142-118-96-74-18-52-133-78-136-87-15-21-93-69-65-64-3-117-123-25-128-105-89-48-5-62-0-129-91-7-112-71-20-73-58-126-35-37-23-17-83-9-103-101-110-98,3360210,16712,20703,37415
nn,kroA150,121-41-88-30-79-55-142-118-96-74-18-52-133-78-136-87-15-21-93-69-65-64-3-117-123-25-128-105-89-48-5-62-0-129-91-7-138-132-137-147-141-104-66-107-57-27-92-130-46-108-90-97-22-44-31-10-14-16-140-58-73-20-71-112-9-83-35-37-23-17-103-101-110-98-126,13-2-45-28-131-111-106-120-29-100-38-95-77-51-4-36-146-12-32-145-102-75-94-125-81-115-49-43-113-143-63-39-53-1-72-67-84-134-139-116-6-8-56-144-86-124-50-60-24-80-68-33-82-54-148-11-26-85-34-149-61-59-76-109-19-119-114-122-42-127-135-70-40-99-47,3351555,16941,13881,30822
nn,kroA150,8-6-116-56-144-86-124-50-60-24-80-68-72-49-43-113-143-63-39-53-1-115-81-125-94-12-32-145-102-75-36-4-77-51-95-38-100-120-29-106-111-131-28-45-2-135-42-122-114-119-148-54-82-33-134-139-84-67-146-47-99-70-40-13-127-11-26-85-34-149-61-59-76-109-22,9-83-71-20-73-140-58-126-35-37-23-17-136-78-105-89-48-5-62-0-129-91-7-41-121-79-30-88-132-137-147-141-104-66-107-57-27-92-130-46-108-90-97-44-31-10-14-16-112-74-18-52-133-87-15-21-93-69-65-64-3-96-142-55-138-118-117-123-25-128-103-101-110-98-19,3272344,15359,19956,35315
nn,kroA150,75-32-145-102-12-94-125-81-115-49-43-113-143-63-39-53-1-72-67-84-134-139-116-6-8-56-144-86-124-50-60-24-80-68-107-57-27-92-130-46-108-90-97-22-44-31-10-14-16-140-58-73-20-71-112-9-83-35-37-23-17-136-78-105-89-48-5-62-0-129-91-7-41-121-79,126-98-101-110-103-93-21-15-87-133-52-18-74-96-142-55-138-30-88-132-137-147-141-104-66-109-76-59-61-149-85-26-11-19-34-148-54-82-33-28-131-111-106-120-29-100-38-95-77-51-4-36-146-47-99-70-40-135-2-45-42-122-114-119-127-13-118-3-64-65-128-25-123-117-69,3355355,15838,20311,36149
nn,kroA150,74-18-52-133-78-136-87-15-21-93-69-65-64-3-96-142-55-138-121-41-88-30-79-7-91-129-0-62-5-48-89-105-17-23-37-103-101-110-98-35-83-9-71-20-73-140-58-126-16-14-10-31-108-90-97-22-44-46-130-92-27-104-141-147-66-107-57-60-24-80-124-50-86-144-8,82-54-148-11-26-85-34-149-61-59-76-109-19-56-6-116-139-134-33-28-131-111-106-120-29-100-38-95-77-51-4-36-146-12-32-145-102-75-94-125-81-115-49-43-113-143-63-39-53-1-72-67-84-68-137-132-118-117-123-25-128-112-119-114-122-42-2-45-135-13-70-40-99-47-127,3278716,15467,19540,35007
nn,kroA150,125-94-12-32-145-102-75-81-115-49-43-113-143-63-39-53-1-72-67-84-134-139-116-6-8-56-144-86-124-50-60-24-80-68-107-57-27-92-130-46-108-90-97-22-44-31-10-14-16-140-58-73-20-71-112-9-83-35-37-23-17-136-78-105-89-48-5-62-0-129-91-7-41-121-79,29-120-106-100-38-95-77-51-4-36-146-111-131-28-45-2-135-42-122-114-119-148-54-82-33-11-26-85-34-149-61-59-76-109-19-127-40-70-99-47-13-66-104-141-147-132-137-88-30-138-55-142-118-96-74-18-52-133-87-15-21-93-69-65-64-3-117-123-25-128-103-101-110-98-126,3257380,15826,20915,36741
nn,kroA150,38-100-120-29-106-111-131-28-45-2-135-42-122-114-119-148-54-82-33-134-139-116-6-8-56-144-86-124-50-60-24-80-68-72-49-43-113-143-63-39-53-1-115-81-125-94-12-32-145-102-75-36-4-77-51-95-146-84-67-107-57-27-92-130-46-108-90-97-22-44-31-10-14-16-140,19-11-26-85-34-149-61-59-76-109-104-141-147-66-132-137-88-41-121-79-30-138-55-142-118-96-74-18-52-133-78-136-87-15-21-93-69-65-64-3-117-123-25-128-105-89-48-5-62-0-129-91-7-112-71-20-73-58-126-35-37-23-17-83-9-103-101-110-98-127-40-70-99-47-13,4356971,16214,20593,36807
nn,kroA150,147-141-104-66-107-57-27-92-130-46-108-90-97-22-44-31-10-14-16-140-58-73-20-71-112-9-83-35-37-23-17-136-78-105-89-48-5-62-0-129-91-7-41-121-79-30-88-132-137-53-39-63-143-113-43-49-72-67-84-134-139-116-6-8-56-144-86-124-50-60-24-80-68-1-115,125-94-12-32-145-102-75-81-146-36-4-77-51-95-38-100-120-29-106-111-131-28-45-2-135-42-122-114-119-148-54-82-33-11-26-85-34-149-61-59-76-109-19-127-40-70-99-47-13-138-55-142-118-96-74-18-52-133-87-15-21-93-69-65-64-3-117-123-25-128-103-101-110-98-126,3245469,15234,21601,36835
nn,kroA150,66-104-141-147-132-137-88-41-121-79-30-138-55-142-118-96-74-18-52-133-78-136-87-15-21-93-69-65-64-3-117-123-25-128-105-89-48-5-62-0-129-91-7-27-92-130-46-108-90-97-22-44-31-10-14-16-140-58-73-20-71-112-9-83-35-37-23-17-103-101-110-98-126-59-61,81-125-94-12-32-145-102-75-36-4-77-51-95-38-100-120-29-106-111-131-28-45-2-135-42-122-114-119-148-54-82-33-134-139-116-6-8-56-144-86-124-50-60-24-80-68-72-49-43-113-143-63-39-53-1-115-146-84-67-107-57-109-76-149-85-26-11-19-34-127-40-70-99-47-13,3358752,17427,16322,33749
nn,kroA150,54-82-148-11-26-85-34-149-61-59-76-109-22-97-90-108-31-10-14-16-140-58-73-20-71-112-9-83-35-37-23-17-136-78-105-89-48-5-62-0-129-91-7-41-121-79-30-88-132-137-147-141-104-66-107-57-27-92-130-46-44-126-98-101-110-103-93-21-15-87-133-52-18-74-96,144-86-124-50-60-24-80-68-72-49-43-113-143-63-39-53-1-115-81-125-94-12-32-145-102-75-36-4-77-51-95-38-100-120-29-106-111-131-28-45-2-135-42-122-114-119-33-134-139-116-6-8-56-19-84-67-146-47-99-70-40-13-127-138-55-142-118-3-64-65-128-25-123-117-69,3298536,16890,20730,37620
nn,kroA150,108-90-97-22-44-31-10-14-16-140-58-73-20-71-112-9-83-35-37-23-17-136-78-105-89-48-5-62-0-129-91-7-41-121-79-30-88-132-137-147-141-104-66-107-57-27-92-130-46-109-76-59-61-149-85-26-11-19-56-6-8-116-54-82-148-33-134-139-144-86-124-50-60-24-80,120-29-106-100-38-95-77-51-4-36-146-12-32-145-102-75-94-125-81-115-49-43-113-143-63-39-53-1-72-67-84-111-131-28-45-2-135-42-122-114-119-127-40-70-99-47-13-34-68-138-55-142-118-96-74-18-52-133-87-15-21-93-69-65-64-3-117-123-25-128-103-101-110-98-126,3501019,14221,21823,36044
nn,kroA150,91-7-41-121-79-30-88-132-137-147-141-104-66-107-57-27-92-130-46-108-90-97-22-44-31-10-14-16-140-58-73-20-71-112-9-83-35-37-23-17-136-78-105-89-48-5-62-0-129-138-55-142-118-96-74-18-52-133-87-15-21-93-69-65-64-3-117-123-25-128-103-101-110-98-126,6-8-116-56-144-86-124-50-60-24-80-68-72-49-43-113-143-63-39-53-1-115-81-125-94-12-32-145-102-75-36-4-77-51-95-38-100-120-29-106-111-131-28-45-2-135-42-122-114-119-148-54-82-33-134-139-84-67-146-47-99-70-40-13-127-11-26-85-34-149-61-59-76-109-19,3260372,16640,14742,31382
nn,kroA150,12-32-145-102-75-94-125-81-115-49-43-113-143-63-39-53-1-72-67-84-134-139-116-6-8-56-144-86-124-50-60-24-80-68-107-57-27-92-130-46-108-90-97-22-44-31-10-14-16-140-58-73-20-71-112-9-83-35-37-23-17-136-78-105-89-48-5-62-0-129-91-7-41-121-79,128-25-123-117-64-65-3-96-142-55-138-74-18-52-133-87-15-21-93-69-118-30-88-132-137-147-141-104-66-109-76-59-61-149-85-26-11-19-34-148-54-82-33-28-131-111-106-120-29-100-38-95-77-51-4-36-146-47-99-70-40-135-2-45-42-122-114-119-127-13-126-98-101-110-103,3296289,15830,20213,36043
nn,kroA150,110-101-98-103-37-23-17-136-78-105-89-48-5-62-0-129-91-7-41-121-79-30-88-132-137-147-141-104-66-107-57-27-92-130-46-108-90-97-22-44-31-10-14-16-140-58-73-20-71-112-9-83-35-126-133-52-87-15-21-93-69-65-64-3-96-142-55-138-74-18-118-117-123-25-128,77-51-95-4-36-146-38-100-120-29-106-111-131-28-45-2-135-42-122-114-119-148-54-82-33-134-139-116-6-8-56-144-86-124-50-60-24-80-68-72-49-43-113-143-63-39-53-1-115-81-125-94-12-32-145-102-75-84-67-11-26-85-34-149-61-59-76-109-19-127-40-70-99-47-13,3721913,16358,15364,31722
nn,kroA150,47-99-70-40-135-2-45-28-131-111-106-120-29-100-38-95-77-51-4-36-146-12-32-145-102-75-94-125-81-115-49-43-113-143-63-39-53-1-72-67-84-134-139-116-6-8-56-144-86-124-50-60-24-80-68-107-57-27-92-130-46-108-90-97-22-44-31-10-14-16-140-58-73-20-71,112-9-83-35-37-23-17-136-78-105-89-48-5-62-0-129-91-7-41-121-79-30-88-132-137-147-141-104-66-138-55-142-118-96-74-18-52-133-87-15-21-93-69-65-64-3-117-123-25-128-103-101-110-98-126-59-61-149-85-26-11-19-34-148-54-82-33-122-42-127-114-119-13-76-109,3251754,15686,20045,35731
nn,kroA150,82-54-148-11-26-85-34-149-61-59-76-109-22-97-90-108-31-10-14-16-140-58-73-20-71-112-9-83-35-37-23-17-136-78-105-89-48-5-62-0-129-91-7-41-121-79-30-88-132-137-147-141-104-66-107-57-27-92-130-46-44-126-98-101-110-103-93-21-15-87-133-52-18-74-96,86-144-124-50-60-24-80-68-72-49-43-113-143-63-39-53-1-115-81-125-94-12-32-145-102-75-36-4-77-51-95-38-100-120-29-106-111-131-28-45-2-135-42-122-114-119-33-134-139-116-6-8-56-19-84-67-146-47-99-70-40-13-127-138-55-142-118-3-64-65-128-25-123-117-69,3557251,16875,20723,37598
nn,kroA150,46-108-90-97-22-44-31-10-14-16-140-58-73-20-71-112-9-83-35-37-23-17-136-78-105-89-48-5-62-0-129-91-7-41-121-79-30-88-132-137-147-141-104-66-107-57-27-92-130-109-76-59-61-149-85-26-11-19-56-6-8-116-54-82-148-33-134-139-144-86-124-50-60-24-80,99-70-40-135-2-45-28-131-111-106-120-29-100-38-95-77-51-4-36-146-12-32-145-102-75-94-125-81-115-49-43-113-143-63-39-53-1-72-67-84-68-34-119-114-122-42-127-13-47-138-55-142-118-96-74-18-52-133-87-15-21-93-69-65-64-3-117-123-25-128-103-101-110-98-126,3247770,13979,22803,36782
nn,kroA150,21-15-87-93-136-78-105-89-48-5-62-0-129-91-7-41-121-79-30-88-132-137-147-141-104-66-107-57-27-92-130-46-108-90-97-22-44-31-10-14-16-140-58-73-20-71-112-9-83-35-37-23-17-133-52-18-74-96-142-55-138-118-3-64-65-128-25-123-117-69-103-101-110-98-126,4-36-146-38-100-120-29-106-111-131-28-45-2-135-42-122-114-119-148-54-82-33-134-139-116-6-8-56-144-86-124-50-60-24-80-68-72-49-43-113-143-63-39-53-1-115-81-125-94-12-32-145-102-75-95-77-51-47-99-70-40-13-127-11-26-85-34-149-61-59-76-109-19-84-67,3493807,16534,15335,31869
nn,kroA150,19-11-26-85-34-149-61-59-76-109-22-97-90-108-31-10-14-16-140-58-73-20-71-112-9-83-35-37-23-17-136-78-105-89-48-5-62-0-129-91-7-41-121-79-30-88-132-137-147-141-104-66-107-57-27-92-130-46-44-126-98-101-110-103-93-21-15-87-133-52-18-74-96-142-55,47-99-70-40-135-2-45-28-131-111-106-120-29-100-38-95-77-51-4-36-146-12-32-145-102-75-94-125-81-115-49-43-113-143-63-39-53-1-72-67-84-134-139-116-6-8-56-144-86-124-50-60-24-80-68-33-82-54-148-119-114-122-42-127-13-138-118-3-64-65-128-25-123-117-69,3310535,16650,20887,37537
nn,kroA150,9-83-71-20-73-140-58-126-35-37-23-17-136-78-105-89-48-5-62-0-129-91-7-41-121-79-30-88-132-137-147-141-104-66-107-57-27-92-130-46-108-90-97-22-44-31-10-14-16-112-74-18-52-133-87-15-21-93-69-65-64-3-96-142-55-138-118-117-123-25-128-103-101-110-98,60-24-80-124-50-86-144-8-6-116-56-19-11-26-85-34-149-61-59-76-109-148-54-82-33-134-139-84-67-72-49-43-113-143-63-39-53-1-115-81-125-94-12-32-145-102-75-36-4-77-51-95-38-100-120-29-106-111-131-28-45-2-135-42-122-114-119-127-40-70-99-47-13-146-68,3294694,16544,15201,31745
nn,kroA150,80-24-60-124-50-86-144-8-6-116-56-19-11-26-85-34-149-61-59-76-109-22-97-90-108-31-10-14-16-140-58-73-20-71-112-9-83-35-37-23-17-136-78-105-89-48-5-62-0-129-91-7-41-121-79-30-88-132-137-147-141-104-66-107-57-27-92-130-46-44-126-98-101-110-103,128-25-123-117-64-65-3-96-142-55-138-74-18-52-133-87-15-21-93-69-118-53-39-63-143-113-43-49-72-67-84-134-139-33-82-54-148-119-114-122-42-2-45-28-131-111-106-120-29-100-38-95-77-51-4-36-146-12-32-145-102-75-94-125-81-115-1-68-13-135-127-40-70-99-47,3581872,16032,21183,37215
nn,kroA150,18-74-96-142-55-138-121-41-88-30-79-7-91-129-0-62-5-48-89-105-78-136-87-15-21-93-69-52-133-17-23-37-103-101-110-98-35-83-9-71-20-73-140-58-126-16-14-10-31-108-90-97-22-44-46-130-92-27-104-141-147-66-107-57-60-24-80-124-50-86-144-8-6-116-56,106-120-29-100-38-95-77-51-4-36-146-12-32-145-102-75-94-125-81-115-49-43-113-143-63-39-53-1-72-67-84-134-139-33-82-54-148-11-26-85-34-149-61-59-76-109-19-119-114-122-42-2-45-28-131-111-13-135-127-40-70-99-47-68-137-132-118-3-64-65-128-25-123-117-112,3244226,15256,20319,35575
nn,kroA150,82-54-148-11-26-85-34-149-61-59-76-109-22-97-90-108-31-10-14-16-140-58-73-20-71-112-9-83-35-37-23-17-136-78-105-89-48-5-62-0-129-91-7-41-121-79-30-88-132-137-147-141-104-66-107-57-27-92-130-46-44-126-98-101-110-103-93-21-15-87-133-52-18-74-96,75-32-145-102-12-94-125-81-115-49-43-113-143-63-39-53-1-72-67-84-134-139-116-6-8-56-144-86-124-50-60-24-80-68-38-100-120-29-106-111-131-28-45-2-135-42-122-114-119-33-19-127-40-70-99-47-13-51-77-95-4-36-146-138-55-142-118-3-64-65-128-25-123-117-69,3678540,16875,21733,38608
nn,kroA150,46-108-90-97-22-44-31-10-14-16-140-58-73-20-71-112-9-83-35-37-23-17-136-78-105-89-48-5-62-0-129-91-7-41-121-79-30-88-132-137-147-141-104-66-107-57-27-92-130-109-76-59-61-149-85-26-11-19-56-6-8-116-54-82-148-33-134-139-144-86-124-50-60-24-80,49-43-113-143-63-39-53-1-115-81-125-94-12-32-145-102-75-36-4-77-51-95-38-100-120-29-106-111-131-28-45-2-135-42-122-114-119-127-40-70-99-47-13-84-67-72-68-146-34-126-98-101-110-103-93-21-15-87-133-52-18-74-96-142-55-138-118-3-64-65-128-25-123-117-69,3247899,13979,22508,36487
nn,kroA150,83-9-71-20-73-140-58-126-35-37-23-17-136-78-105-89-48-5-62-0-129-91-7-41-121-79-30-88-132-137-147-141-104-66-107-57-27-92-130-46-108-90-97-22-44-31-10-14-16-112-74-18-52-133-87-15-21-93-69-65-64-3-96-142-55-138-118-117-123-25-128-103-101-110-98,77-51-95-4-36-146-38-100-120-29-106-111-131-28-45-2-135-42-122-114-119-148-54-82-33-134-139-116-6-8-56-144-86-124-50-60-24-80-68-72-49-43-113-143-63-39-53-1-115-81-125-94-12-32-145-102-75-84-67-11-26-85-34-149-61-59-76-109-19-127-40-70-99-47-13,3579294,16367,15364,31731
nn,kroA150,1-143-113-43-49-72-67-84-134-139-116-6-8-56-144-86-124-50-60-24-80-68-63-39-53-107-57-27-92-130-46-108-90-97-22-44-31-10-14-16-140-58-73-20-71-112-9-83-35-37-23-17-136-78-105-89-48-5-62-0-129-91-7-41-121-79-30-88-132-137-147-141-104-66-138,120-29-106-100-38-95-77-51-4-36-146-12-32-145-102-75-94-125-81-115-111-131-28-45-2-135-42-122-114-119-148-54-82-33-11-26-85-34-149-61-59-76-109-19-127-40-70-99-47-13-126-98-101-110-103-93-21-15-87-133-52-18-74-96-142-55-118-3-64-65-128-25-123-117-69,3457603,15929,21927,37856
nn,kroA150,129-0-62-5-48-89-105-78-136-87-15-21-93-69-52-133-18-74-96-142-55-138-121-41-88-30-79-7-91-141-104-66-147-132-137-53-39-63-143-113-43-49-72-67-84-134-139-116-6-8-56-144-86-124-50-60-24-80-68-107-57-27-92-130-46-108-90-97-22-44-31-10-14-16-140,34-85-26-11-19-149-61-59-76-109-148-54-82-33-28-131-111-106-120-29-100-38-95-77-51-4-36-146-12-32-145-102-75-94-125-81-115-1-47-99-70-40-135-2-45-42-122-114-119-127-13-112-71-20-73-58-126-35-37-23-17-83-9-103-101-110-98-65-64-3-117-123-25-128-118,3377666,15133,22273,37406
nn,kroA150,117-123-25-128-65-64-3-96-142-55-138-121-41-88-30-79-7-91-129-0-62-5-48-89-105-78-136-87-15-21-93-69-52-133-18-74-118-132-137-147-141-104-66-107-57-27-92-130-46-108-90-97-22-44-31-10-14-16-140-58-73-20-71-112-9-83-35-37-23-17-103-101-110-98-126,94-125-81-115-49-43-113-143-63-39-53-1-72-67-84-134-139-116-6-8-56-144-86-124-50-60-24-80-68-38-100-120-29-106-111-131-28-45-2-135-42-122-114-119-148-54-82-33-11-26-85-34-149-61-59-76-109-19-127-40-70-99-47-13-51-77-95-4-36-146-12-32-145-102-75,3430438,17034,14859,31893
nn,kroA150,43-113-143-63-39-53-1-49-72-67-84-134-139-116-6-8-56-144-86-124-50-60-24-80-68-107-57-27-92-130-46-108-90-97-22-44-31-10-14-16-140-58-73-20-71-112-9-83-35-37-23-17-136-78-105-89-48-5-62-0-129-91-7-41-121-79-30-88-132-137-147-141-104-66-138,101-110-103-98-126-133-52-87-15-21-93-69-65-64-3-96-142-55-118-117-123-25-128-18-74-109-76-59-61-149-85-26-11-19-34-148-54-82-33-28-131-111-106-120-29-100-38-95-77-51-4-36-146-12-32-145-102-75-94-125-81-115-47-99-70-40-135-2-45-42-122-114-119-127-13,3304970,15948,21005,36953
nn,kroA150,129-0-62-5-48-89-105-78-136-87-15-21-93-69-52-133-18-74-96-142-55-138-121-41-88-30-79-7-91-141-104-66-147-132-137-53-39-63-143-113-43-49-72-67-84-134-139-116-6-8-56-144-86-124-50-60-24-80-68-107-57-27-92-130-46-108-90-97-22-44-31-10-14-16-140,13-2-45-28-131-111-106-120-29-100-38-95-77-51-4-36-146-12-32-145-102-75-94-125-81-115-1-33-82-54-148-11-26-85-34-149-61-59-76-109-19-119-114-122-42-127-135-70-40-99-47-112-71-20-73-58-126-35-37-23-17-83-9-103-101-110-98-65-64-3-117-123-25-128-118,3570494,15133,22491,37624
nn,kroA150,122-42-2-45-28-131-111-106-120-29-100-38-95-77-51-4-36-146-12-32-145-102-75-94-125-81-115-49-43-113-143-63-39-53-1-72-67-84-134-139-116-6-8-56-144-86-124-50-60-24-80-68-107-57-27-92-130-46-108-90-97-22-44-31-10-14-16-140-58-73-20-71-112-9-83,87-15-21-93-136-78-105-89-48-5-62-0-129-91-7-41-121-79-30-88-132-137-147-141-104-66-138-55-142-118-96-74-18-52-133-17-23-37-103-101-110-98-35-126-69-65-64-3-117-123-25-128-109-76-59-61-149-85-26-11-19-34-148-54-82-33-114-119-127-135-13-70-40-99-47,3478389,15501,21786,37287
nn,kroA150,141-104-66-147-132-137-88-41-121-79-30-138-55-142-118-96-74-18-52-133-78-136-87-15-21-93-69-65-64-3-117-123-25-128-105-89-48-5-62-0-129-91-7-27-92-130-46-108-90-97-22-44-31-10-14-16-140-58-73-20-71-112-9-83-35-37-23-17-103-101-110-98-126-59-61,99-70-40-135-2-45-28-131-111-106-120-29-100-38-95-77-51-4-36-146-12-32-145-102-75-94-125-81-115-49-43-113-143-63-39-53-1-72-67-84-134-139-116-6-8-56-144-86-124-50-60-24-80-68-107-57-109-76-149-85-26-11-19-34-148-54-82-33-122-42-127-114-119-13-47,3581451,17525,14409,31934
nn,kroA150,106-120-29-100-38-95-77-51-4-36-146-12-32-145-102-75-94-125-81-115-49-43-113-143-63-39-53-1-72-67-84-134-139-116-6-8-56-144-86-124-50-60-24-80-68-107-57-27-92-130-46-108-90-97-22-44-31-10-14-16-140-58-73-20-71-112-9-83-35-37-23-17-136-78-105,15-87-21-93-69-52-133-18-74-96-142-55-138-121-41-88-30-79-7-91-129-0-62-5-48-89-3-64-65-128-25-123-117-118-132-137-147-141-104-66-109-76-59-61-149-85-26-11-19-34-148-54-82-33-28-131-111-45-2-135-42-122-114-119-127-40-70-99-47-13-126-98-101-110-103,3255480,15895,19840,35735
nn,kroA150,87-15-21-93-136-78-105-89-48-5-62-0-129-91-7-41-121-79-30-88-132-137-147-141-104-66-107-57-27-92-130-46-108-90-97-22-44-31-10-14-16-140-58-73-20-71-112-9-83-35-37-23-17-133-52-18-74-96-142-55-138-118-3-64-65-128-25-123-117-69-103-101-110-98-126,114-119-122-42-2-45-28-131-111-106-120-29-100-38-95-77-51-4-36-146-12-32-145-102-75-94-125-81-115-49-43-113-143-63-39-53-1-72-67-84-134-139-116-6-8-56-144-86-124-50-60-24-80-68-33-82-54-148-11-26-85-34-149-61-59-76-109-19-127-135-13-70-40-99-47,3513426,16407,15023,31430
nn,kroA150,130-92-27-104-141-147-66-107-57-60-24-80-124-50-86-144-8-6-116-56-19-11-26-85-34-149-61-59-76-109-22-97-90-108-31-10-14-16-140-58-73-20-71-112-9-83-35-37-23-17-136-78-105-89-48-5-62-0-129-91-7-41-121-79-30-88-132-137-53-39-63-143-113-43-49,82-54-148-33-134-139-84-67-72-68-1-115-81-125-94-12-32-145-102-75-36-4-77-51-95-38-100-120-29-106-111-131-28-45-2-135-42-122-114-119-127-40-70-99-47-13-146-46-44-126-98-101-110-103-93-21-15-87-133-52-18-74-96-142-55-138-118-3-64-65-128-25-123-117-69,3604275,13880,22620,36500
nn,kroA150,118-142-55-138-121-41-88-30-79-7-91-129-0-62-5-48-89-105-78-136-87-15-21-93-69-52-133-18-74-96-3-64-65-128-25-123-117-17-23-37-103-101-110-98-35-83-9-71-20-73-140-58-126-16-14-10-31-108-90-97-22-44-46-130-92-27-104-141-147-66-107-57-60-24-80,135-2-45-28-131-111-106-120-29-100-38-95-77-51-4-36-146-12-32-145-102-75-94-125-81-115-49-43-113-143-63-39-53-1-72-67-84-134-139-116-6-8-56-144-86-124-50-19-11-26-85-34-149-61-59-76-109-148-54-82-33-122-42-127-114-119-13-70-40-99-47-68-137-132-112,3400244,16487,19603,36090
nn,kroA150,38-100-120-29-106-111-131-28-45-2-135-42-122-114-119-148-54-82-33-134-139-116-6-8-56-144-86-124-50-60-24-80-68-72-49-43-113-143-63-39-53-1-115-81-125-94-12-32-145-102-75-36-4-77-51-95-146-84-67-107-57-27-92-130-46-108-90-97-22-44-31-10-14-16-140,89-105-78-136-87-15-21-93-69-52-133-18-74-96-142-55-138-121-41-88-30-79-7-91-129-0-62-5-48-112-71-20-73-58-126-35-37-23-17-83-9-103-101-110-98-65-64-3-117-123-25-128-118-132-137-147-141-104-66-109-76-59-61-149-85-26-11-19-34-127-40-70-99-47-13,3664989,16214,21238,37452
nn,kroA150,77-51-95-4-36-146-38-100-120-29-106-111-131-28-45-2-135-42-122-114-119-148-54-82-33-134-139-116-6-8-56-144-86-124-50-60-24-80-68-72-49-43-113-143-63-39-53-1-115-81-125-94-12-32-145-102-75-84-67-107-57-27-92-130-46-108-90-97-22-44-31-10-14-16-140,71-20-73-58-126-35-37-23-17-136-78-105-89-48-5-62-0-129-91-7-41-121-79-30-88-132-137-147-141-104-66-138-55-142-118-96-74-18-52-133-87-15-21-93-69-65-64-3-117-123-25-128-83-9-112-103-101-110-98-59-61-149-85-26-11-19-34-76-109-127-40-70-99-47-13,3385470,16727,22024,38751
nn,kroA150,57-107-66-104-141-147-132-137-88-41-121-79-30-138-55-142-118-96-74-18-52-133-78-136-87-15-21-93-69-65-64-3-117-123-25-128-105-89-48-5-62-0-129-91-7-27-92-130-46-108-90-97-22-44-31-10-14-16-140-58-73-20-71-112-9-83-35-37-23-17-103-101-110-98-126,54-82-148-11-26-85-34-149-61-59-76-109-19-56-6-8-116-144-86-124-50-60-24-80-68-72-49-43-113-143-63-39-53-1-115-81-125-94-12-32-145-102-75-36-4-77-51-95-38-100-120-29-106-111-131-28-45-2-135-42-122-114-119-33-134-139-84-67-146-47-99-70-40-13-127,4075140,16817,14731,31548
nn,kroA150,8-6-116-56-144-86-124-50-60-24-80-68-72-49-43-113-143-63-39-53-1-115-81-125-94-12-32-145-102-75-36-4-77-51-95-38-100-120-29-106-111-131-28-45-2-135-42-122-114-119-148-54-82-33-134-139-84-67-146-47-99-70-40-13-127-11-26-85-34-149-61-59-76-109-22,41-121-79-30-88-132-137-147-141-104-66-107-57-27-92-130-46-108-90-97-44-31-10-14-16-140-58-73-20-71-112-9-83-35-37-23-17-136-78-105-89-48-5-62-0-129-91-7-138-55-142-118-96-74-18-52-133-87-15-21-93-69-65-64-3-117-123-25-128-103-101-110-98-126-19,3481392,15359,18710,34069
nn,kroA150,57-107-66-104-141-147-132-137-88-41-121-79-30-138-55-142-118-96-74-18-52-133-78-136-87-15-21-93-69-65-64-3-117-123-25-128-105-89-48-5-62-0-129-91-7-27-92-130-46-108-90-97-22-44-31-10-14-16-140-58-73-20-71-112-9-83-35-37-23-17-103-101-110-98-126,8-6-116-56-144-86-124-50-60-24-80-68-72-49-43-113-143-63-39-53-1-115-81-125-94-12-32-145-102-75-36-4-77-51-95-38-100-120-29-106-111-131-28-45-2-135-42-122-114-119-148-54-82-33-134-139-84-67-146-47-99-70-40-13-127-11-26-85-34-149-61-59-76-109-19,3590180,16817,14776,31593
nn,kroA150,33-82-54-148-11-26-85-34-149-61-59-76-109-22-97-90-108-31-10-14-16-140-58-73-20-71-112-9-83-35-37-23-17-136-78-105-89-48-5-62-0-129-91-7-41-121-79-30-88-132-137-147-141-104-66-107-57-27-92-130-46-44-126-98-101-110-103-93-21-15-87-133-52-18-74,53-39-63-143-113-43-49-72-67-84-134-139-116-6-8-56-144-86-124-50-60-24-80-68-1-115-81-125-94-12-32-145-102-75-36-4-77-51-95-38-100-120-29-106-111-131-28-45-2-135-42-122-114-119-127-40-70-99-47-13-146-19-138-55-142-118-96-3-64-65-128-25-123-117-69,3276651,16708,20258,36966
nn,kroA150,145-32-75-12-94-125-81-115-49-43-113-143-63-39-53-1-72-67-84-134-139-116-6-8-56-144-86-124-50-60-24-80-68-107-57-27-92-130-46-108-90-97-22-44-31-10-14-16-140-58-73-20-71-112-9-83-35-37-23-17-136-78-105-89-48-5-62-0-129-91-7-41-121-79-30,77-51-95-4-36-146-38-100-120-29-106-111-131-28-45-2-135-42-122-114-119-148-54-82-33-11-26-85-34-149-61-59-76-109-19-127-40-70-99-47-13-102-66-104-141-147-132-137-88-138-55-142-118-96-74-18-52-133-87-15-21-93-69-65-64-3-117-123-25-128-103-101-110-98-126,3800670,15704,21977,37681
nn,kroA150,81-125-94-12-32-145-102-75-36-4-77-51-95-38-100-120-29-106-111-131-28-45-2-135-42-122-114-119-148-54-82-33-134-139-116-6-8-56-144-86-124-50-60-24-80-68-72-49-43-113-143-63-39-53-1-115-146-84-67-107-57-27-92-130-46-108-90-97-22-44-31-10-14-16-140,149-85-26-11-19-34-61-59-76-109-104-141-147-66-132-137-88-41-121-79-30-138-55-142-118-96-74-18-52-133-78-136-87-15-21-93-69-65-64-3-117-123-25-128-105-89-48-5-62-0-129-91-7-112-71-20-73-58-126-35-37-23-17-83-9-103-101-110-98-127-40-70-99-47-13,3363803,16546,21026,37572
nn,kroA150,8-6-116-56-144-86-124-50-60-24-80-68-72-49-43-113-143-63-39-53-1-115-81-125-94-12-32-145-102-75-36-4-77-51-95-38-100-120-29-106-111-131-28-45-2-135-42-122-114-119-148-54-82-33-134-139-84-67-146-47-99-70-40-13-127-11-26-85-34-149-61-59-76-109-22,10-14-16-31-108-90-97-44-46-130-92-27-104-141-147-66-107-57-129-0-62-5-48-89-105-78-136-87-15-21-93-69-52-133-18-74-96-142-55-138-121-41-88-30-79-7-91-132-137-118-3-64-65-128-25-123-117-17-23-37-103-101-110-98-35-83-9-71-20-73-140-58-126-112-19,3683825,15359,19265,34624
nn,kroA150,71-20-73-140-58-126-35-37-23-17-136-78-105-89-48-5-62-0-129-91-7-41-121-79-30-88-132-137-147-141-104-66-107-57-27-92-130-46-108-90-97-22-44-31-10-14-16-112-9-83-103-101-110-98-93-21-15-87-133-52-18-74-96-142-55-138-118-3-64-65-128-25-123-117-69,28-131-111-106-120-29-100-38-95-77-51-4-36-146-12-32-145-102-75-94-125-81-115-49-43-113-143-63-39-53-1-72-67-84-134-139-116-6-8-56-144-86-124-50-60-24-80-68-33-82-54-148-11-26-85-34-149-61-59-76-109-19-119-114-122-42-2-45-135-13-70-40-99-47-127,3382178,16290,14733,31023
nn,kroA150,133-52-78-136-87-15-21-93-69-65-64-3-96-142-55-138-121-41-88-30-79-7-91-129-0-62-5-48-89-105-18-74-118-117-123-25-128-17-23-37-103-101-110-98-35-83-9-71-20-73-140-58-126-16-14-10-31-108-90-97-22-44-46-130-92-27-104-141-147-66-107-57-60-24-80,95-77-51-4-36-146-38-100-120-29-106-111-131-28-45-2-135-42-122-114-119-148-54-82-33-134-139-116-6-8-56-144-86-124-50-19-11-26-85-34-149-61-59-76-109-68-72-49-43-113-143-63-39-53-1-115-81-125-94-12-32-145-102-75-84-67-13-70-40-99-47-127-132-137-112,3427260,17109,21697,38806
nn,kroA150,0-129-91-7-41-121-79-30-88-132-137-147-141-104-66-107-57-27-92-130-46-108-90-97-22-44-31-10-14-16-140-58-73-20-71-112-9-83-35-37-23-17-136-78-105-89-48-5-62-74-18-52-133-87-15-21-93-69-65-64-3-96-142-55-138-118-117-123-25-128-103-101-110-98-126,59-61-149-85-26-11-19-56-6-8-116-54-82-148-33-134-139-144-86-124-50-60-24-80-68-72-49-43-113-143-63-39-53-1-115-81-125-94-12-32-145-102-75-36-4-77-51-95-38-100-120-29-106-111-131-28-45-2-135-42-122-114-119-127-40-70-99-47-13-84-67-146-34-76-109,3618083,16760,15764,32524
nn,kroA150,96-142-55-138-121-41-88-30-79-7-91-129-0-62-5-48-89-105-78-136-87-15-21-93-69-52-133-18-74-3-64-65-128-25-123-117-118-132-137-147-141-104-66-107-57-27-92-130-46-108-90-97-22-44-31-10-14-16-140-58-73-20-71-112-9-83-35-37-23-17-103-101-110-98-126,109-76-59-61-149-85-26-11-19-56-6-8-116-54-82-148-33-134-139-144-86-124-50-60-24-80-68-72-49-43-113-143-63-39-53-1-115-81-125-94-12-32-145-102-75-36-4-77-51-95-38-100-120-29-106-111-131-28-45-2-135-42-122-114-119-127-40-70-99-47-13-84-67-146-34,3510337,16676,15792,32468
nn,kroA150,62-5-48-89-105-78-136-87-15-21-93-69-52-133-18-74-96-142-55-138-121-41-88-30-79-7-91-129-0-92-27-104-141-147-66-107-57-60-24-80-124-50-86-144-8-6-116-56-19-11-26-85-34-149-61-59-76-109-22-97-90-108-31-10-14-16-140-58-73-20-71-112-9-83-35,101-110-103-37-23-17-98-126-46-130-44-148-54-82-33-134-139-84-67-72-49-43-113-143-63-39-53-1-115-81-125-94-12-32-145-102-75-36-4-77-51-95-38-100-120-29-106-111-131-28-45-2-135-42-122-114-119-127-40-70-99-47-13-146-68-137-132-118-3-64-65-128-25-123-117,3652375,13335,21263,34598
nn,kroA150,31-108-90-97-22-44-10-14-16-140-58-73-20-71-112-9-83-35-37-23-17-136-78-105-89-48-5-62-0-129-91-7-41-121-79-30-88-132-137-147-141-104-66-107-57-27-92-130-46-109-76-59-61-149-85-26-11-19-56-6-8-116-54-82-148-33-134-139-144-86-124-50-60-24-80,111-131-28-45-2-135-42-122-114-119-127-40-70-99-47-13-29-120-106-100-38-95-77-51-4-36-146-12-32-145-102-75-94-125-81-115-49-43-113-143-63-39-53-1-72-67-84-68-34-126-98-101-110-103-93-21-15-87-133-52-18-74-96-142-55-138-118-3-64-65-128-25-123-117-69,3292690,14408,21696,36104
nn,kroA150,64-65-3-96-142-55-138-121-41-88-30-79-7-91-129-0-62-5-48-89-105-78-136-87-15-21-93-69-52-133-18-74-118-117-123-25-128-17-23-37-103-101-110-98-35-83-9-71-20-73-140-58-126-16-14-10-31-108-90-97-22-44-46-130-92-27-104-141-147-66-107-57-60-24-80,122-42-2-45-28-131-111-106-120-29-100-38-95-77-51-4-36-146-12-32-145-102-75-94-125-81-115-49-43-113-143-63-39-53-1-72-67-84-134-139-116-6-8-56-144-86-124-50-19-11-26-85-34-149-61-59-76-109-148-54-82-33-114-119-127-135-13-70-40-99-47-68-137-132-112,3565153,17192,18905,36097
nn,kroA150,103-101-110-98-35-37-23-17-136-78-105-89-48-5-62-0-129-91-7-41-121-79-30-88-132-137-147-141-104-66-107-57-27-92-130-46-108-90-97-22-44-31-10-14-16-140-58-73-20-71-112-9-83-126-133-52-87-15-21-93-69-65-64-3-96-142-55-138-74-18-118-117-123-25-128,36-4-77-51-95-38-100-120-29-106-111-131-28-45-2-135-42-122-114-119-148-54-82-33-134-139-116-6-8-56-144-86-124-50-60-24-80-68-72-49-43-113-143-63-39-53-1-115-81-125-94-12-32-145-102-75-146-84-67-11-26-85-34-149-61-59-76-109-19-127-40-70-99-47-13,3381545,16592,15361,31953
nn,kroA150,71-20-73-140-58-126-35-37-23-17-136-78-105-89-48-5-62-0-129-91-7-41-121-79-30-88-132-137-147-141-104-66-107-57-27-92-130-46-108-90-97-22-44-31-10-14-16-112-9-83-103-101-110-98-93-21-15-87-133-52-18-74-96-142-55-138-118-3-64-65-128-25-123-117-69,4-36-146-38-100-120-29-106-111-131-28-45-2-135-42-122-114-119-148-54-82-33-134-139-116-6-8-56-144-86-124-50-60-24-80-68-72-49-43-113-143-63-39-53-1-115-81-125-94-12-32-145-102-75-95-77-51-47-99-70-40-13-127-11-26-85-34-149-61-59-76-109-19-84-67,3619290,16290,15335,31625
nn,kroA150,110-101-98-103-37-23-17-136-78-105-89-48-5-62-0-129-91-7-41-121-79-30-88-132-137-147-141-104-66-107-57-27-92-130-46-108-90-97-22-44-31-10-14-16-140-58-73-20-71-112-9-83-35-126-133-52-87-15-21-93-69-65-64-3-96-142-55-138-74-18-118-117-123-25-128,42-122-45-2-135-13-131-111-28-33-82-54-148-11-26-85-34-149-61-59-76-109-19-56-6-8-116-144-86-124-50-60-24-80-68-72-49-43-113-143-63-39-53-1-115-81-125-94-12-32-145-102-75-36-4-77-51-95-38-100-120-29-106-84-67-139-134-114-119-127-40-70-99-47-146,3467204,16358,15528,31886
nn,kroA150,5-48-62-0-129-91-7-41-121-79-30-88-132-137-147-141-104-66-107-57-27-92-130-46-108-90-97-22-44-31-10-14-16-140-58-73-20-71-112-9-83-35-37-23-17-136-78-105-89-18-74-96-142-55-138-118-3-64-65-128-25-123-117-69-21-15-87-93-133-52-103-101-110-98-126,32-145-102-12-75-94-125-81-115-49-43-113-143-63-39-53-1-72-67-84-134-139-116-6-8-56-144-86-124-50-60-24-80-68-38-100-120-29-106-111-131-28-45-2-135-42-122-114-119-148-54-82-33-11-26-85-34-149-61-59-76-109-19-127-40-70-99-47-13-51-77-95-4-36-146,3360200,16151,14884,31035
nn,kroA150,33-82-54-148-11-26-85-34-149-61-59-76-109-22-97-90-108-31-10-14-16-140-58-73-20-71-112-9-83-35-37-23-17-136-78-105-89-48-5-62-0-129-91-7-41-121-79-30-88-132-137-147-141-104-66-107-57-27-92-130-46-44-126-98-101-110-103-93-21-15-87-133-52-18-74,8-6-116-56-144-86-124-50-60-24-80-68-72-49-43-113-143-63-39-53-1-115-81-125-94-12-32-145-102-75-36-4-77-51-95-38-100-120-29-106-111-131-28-45-2-135-42-122-114-119-127-40-70-99-47-13-134-139-84-67-146-19-138-55-142-118-96-3-64-65-128-25-123-117-69,4302519,16708,20536,37244
nn,kroA150,147-141-104-66-107-57-27-92-130-46-108-90-97-22-44-31-10-14-16-140-58-73-20-71-112-9-83-35-37-23-17-136-78-105-89-48-5-62-0-129-91-7-41-121-79-30-88-132-137-53-39-63-143-113-43-49-72-67-84-134-139-116-6-8-56-144-86-124-50-60-24-80-68-1-115,126-98-101-110-103-93-21-15-87-133-52-18-74-96-142-55-138-118-3-64-65-128-25-123-117-69-109-76-59-61-149-85-26-11-19-34-148-54-82-33-28-131-111-106-120-29-100-38-95-77-51-4-36-146-12-32-145-102-75-94-125-81-47-99-70-40-135-2-45-42-122-114-119-127-13,3294293,15234,20438,35672
nn,kroA150,121-41-88-30-79-55-142-118-96-74-18-52-133-78-136-87-15-21-93-69-65-64-3-117-123-25-128-105-89-48-5-62-0-129-91-7-138-132-137-147-141-104-66-107-57-27-92-130-46-108-90-97-22-44-31-10-14-16-140-58-73-20-71-112-9-83-35-37-23-17-103-101-110-98-126,80-24-60-124-50-86-144-8-6-116-56-19-11-26-85-34-149-61-59-76-109-148-54-82-33-134-139-84-67-72-49-43-113-143-63-39-53-1-115-81-125-94-12-32-145-102-75-36-4-77-51-95-38-100-120-29-106-111-131-28-45-2-135-42-122-114-119-127-40-70-99-47-13-146-68,4055549,16941,14965,31906
nn,kroA150,141-104-66-147-132-137-88-41-121-79-30-138-55-142-118-96-74-18-52-133-78-136-87-15-21-93-69-65-64-3-117-123-25-128-105-89-48-5-62-0-129-91-7-27-92-130-46-108-90-97-22-44-31-10-14-16-140-58-73-20-71-112-9-83-35-37-23-17-103-101-110-98-126-59-61,125-94-12-32-145-102-75-81-115-49-43-113-143-63-39-53-1-72-67-84-134-139-116-6-8-56-144-86-124-50-60-24-80-68-107-57-109-76-149-85-26-11-19-34-148-54-82-33-28-131-111-106-120-29-100-38-95-77-51-4-36-146-47-99-70-40-135-2-45-42-122-114-119-127-13,3363952,17525,16108,33633
nn,kroA150,50-124-86-144-8-6-116-56-19-11-26-85-34-149-61-59-76-109-22-97-90-108-31-10-14-16-140-58-73-20-71-112-9-83-35-37-23-17-136-78-105-89-48-5-62-0-129-91-7-41-121-79-30-88-132-137-147-141-104-66-107-57-27-92-130-46-44-126-98-101-110-103-93-21-15,55-142-118-96-74-18-52-133-87-69-65-64-3-117-123-25-128-138-53-39-63-143-113-43-49-72-67-84-134-139-24-80-60-68-1-115-81-125-94-12-32-145-102-75-36-4-77-51-95-38-100-120-29-106-111-131-28-45-2-135-42-122-114-119-148-54-82-33-13-70-40-99-47-127-146,3552179,16371,20843,37214
nn,kroA150,123-25-128-65-64-3-96-142-55-138-121-41-88-30-79-7-91-129-0-62-5-48-89-105-78-136-87-15-21-93-69-52-133-18-74-118-117-17-23-37-103-101-110-98-35-83-9-71-20-73-140-58-126-16-14-10-31-108-90-97-22-44-46-130-92-27-104-141-147-66-107-57-60-24-80,124-50-86-144-8-6-116-56-19-11-26-85-34-149-61-59-76-109-148-54-82-33-134-139-84-67-72-49-43-113-143-63-39-53-1-115-81-125-94-12-32-145-102-75-36-4-77-51-95-38-100-120-29-106-111-131-28-45-2-135-42-122-114-119-127-40-70-99-47-13-146-68-137-132-112,3314327,17539,18144,35683
nn,kroA150,67-84-134-139-116-6-8-56-144-86-124-50-60-24-80-68-72-49-43-113-143-63-39-53-1-115-81-125-94-12-32-145-102-75-36-4-77-51-95-38-100-120-29-106-111-131-28-45-2-135-42-122-114-119-148-54-82-33-11-26-85-34-149-61-59-76-109-22-97-90-108-31-10-14-16,128-25-123-117-64-65-3-96-142-55-138-121-41-88-30-79-7-91-129-0-62-5-48-89-105-78-136-87-15-21-93-69-52-133-18-74-118-132-137-147-141-104-66-107-57-27-92-130-46-112-71-20-73-140-58-126-35-37-23-17-83-9-103-101-110-98-44-19-127-40-70-99-47-13-146,3896372,13841,22999,36840
nn,kroA150,107-57-27-92-130-46-108-90-97-22-44-31-10-14-16-140-58-73-20-71-112-9-83-35-37-23-17-136-78-105-89-48-5-62-0-129-91-7-41-121-79-30-88-132-137-147-141-104-66-60-24-80-124-50-86-144-8-6-116-56-19-11-26-85-34-149-61-59-76-109-148-54-82-33-134,131-111-28-45-2-135-42-122-114-119-127-40-70-99-47-13-29-120-106-100-38-95-77-51-4-36-146-12-32-145-102-75-94-125-81-115-49-43-113-143-63-39-53-1-72-67-84-139-68-138-55-142-118-96-74-18-52-133-87-15-21-93-69-65-64-3-117-123-25-128-103-101-110-98-126,3282204,14230,20269,34499
nn,kroA150,48-5-62-0-129-91-7-41-121-79-30-88-132-137-147-141-104-66-107-57-27-92-130-46-108-90-97-22-44-31-10-14-16-140-58-73-20-71-112-9-83-35-37-23-17-136-78-105-89-18-74-96-142-55-138-118-3-64-65-128-25-123-117-69-21-15-87-93-133-52-103-101-110-98-126,148-54-82-33-134-139-116-6-8-56-144-86-124-50-60-24-80-68-72-49-43-113-143-63-39-53-1-115-81-125-94-12-32-145-102-75-36-4-77-51-95-38-100-120-29-106-111-131-28-45-2-135-42-122-114-119-26-85-34-149-61-59-76-109-19-11-127-40-70-99-47-13-84-67-146,3420307,16105,15782,31887
nn,kroA150,17-23-37-103-101-110-98-35-83-9-71-20-73-140-58-126-16-14-10-31-108-90-97-22-44-46-130-92-27-104-141-147-66-107-57-60-24-80-124-50-86-144-8-6-116-56-19-11-26-85-34-149-61-59-76-109-148-54-82-33-134-139-84-67-72-49-43-113-143-63-39-53-1-115-81,112-62-5-48-89-105-78-136-87-15-21-93-69-52-133-18-74-96-142-55-138-121-41-88-30-79-7-91-129-0-132-137-68-38-100-120-29-106-111-131-28-45-2-135-42-122-114-119-127-40-70-99-47-13-51-77-95-4-36-146-12-32-145-102-75-94-125-118-3-64-65-128-25-123-117,3521913,16786,19880,36666
nn,kroA150,33-82-54-148-11-26-85-34-149-61-59-76-109-22-97-90-108-31-10-14-16-140-58-73-20-71-112-9-83-35-37-23-17-136-78-105-89-48-5-62-0-129-91-7-41-121-79-30-88-132-137-147-141-104-66-107-57-27-92-130-46-44-126-98-101-110-103-93-21-15-87-133-52-18-74,1-143-113-43-49-72-67-84-134-139-116-6-8-56-144-86-124-50-60-24-80-68-63-39-53-115-81-125-94-12-32-145-102-75-36-4-77-51-95-38-100-120-29-106-111-131-28-45-2-135-42-122-114-119-127-40-70-99-47-13-146-19-138-55-142-118-96-3-64-65-128-25-123-117-69,3283196,16708,20647,37355
ls-random,kroA150,92-91-5-62-90-22-59-149-34-85-120-4-36-75-146-38-100-6-8-84-67-49-43-1-74-18-15-21-96-138-107-50-56-54-82-116-63-39-88-117-25-142-132-147-104-31-10-16-58-73-108-72-115-81-29-99-70-127-119-148-11-109-71-35-98-101-83-78-65-64-3-33-42-28-124,27-143-125-94-102-51-77-95-106-139-144-86-60-66-141-41-30-79-121-7-19-26-114-122-13-47-40-135-61-44-14-140-20-46-130-57-68-113-80-24-134-111-131-2-45-76-97-133-52-69-93-87-136-105-89-48-145-32-12-53-137-55-118-123-128-129-0-112-126-103-110-37-23-17-9,282011969,39321,36075,75396
ls-random,kroA150,35-37-3-64-25-117-118-131-99-70-40-127-34-76-44-31-140-58-126-71-46-130-92-27-57-60-24-80-67-72-115-125-94-75-32-145-102-4-95-29-124-104-129-0-89-83-19-148-114-45-54-56-6-28-111-134-144-147-121-30-79-55-138-132-53-143-63-7-52-78-136-87-15-101-98,119-149-61-109-50-107-68-49-113-66-141-91-133-93-21-69-96-142-88-137-100-47-13-135-2-42-122-59-22-10-73-20-112-62-86-139-77-51-120-106-5-48-18-65-128-123-85-26-11-116-8-108-103-110-16-14-90-97-84-38-146-36-12-81-43-1-39-41-74-105-17-23-9-82-33,239761056,32356,40748,73104
ls-random,kroA150,136-17-71-14-34-122-127-40-70-99-13-47-29-120-113-63-0-48-5-109-149-19-8-144-83-23-37-110-126-42-135-2-111-33-82-44-31-92-147-66-38-95-4-36-145-32-75-125-88-79-123-25-128-3-142-53-1-81-115-49-68-46-140-58-20-62-91-96-18-69-52-80-84-67-107,77-51-106-131-28-129-7-41-121-30-132-137-24-45-114-119-26-105-133-87-15-117-118-55-138-74-89-112-108-90-61-85-148-54-134-139-97-10-73-16-59-11-116-6-56-86-76-22-130-27-57-50-124-60-104-141-39-143-43-94-12-102-146-72-9-35-98-101-103-78-93-21-65-64-100,413285086,43115,36120,79235
ls-random,kroA150,103-71-60-84-38-51-4-75-94-81-1-79-142-55-132-53-39-147-105-78-9-73-140-59-61-11-148-6-19-109-3-64-69-21-16-14-10-108-107-63-143-113-106-28-70-40-127-42-114-26-85-149-46-136-87-15-133-5-62-0-92-80-43-115-145-102-146-56-86-124-50-130-37-110-101,65-96-125-12-32-36-77-95-2-135-13-99-47-100-49-72-68-137-88-30-121-41-144-8-116-134-139-24-57-104-141-129-91-48-20-58-126-35-98-93-128-25-123-117-118-138-7-27-97-90-83-23-17-52-74-66-67-120-29-111-131-45-122-119-33-82-54-34-76-22-44-31-112-89-18,321624251,38181,31247,69428
ls-random,kroA150,5-9-20-80-67-38-95-51-4-146-12-1-113-139-8-116-82-148-40-99-29-120-100-68-128-123-117-118-142-91-129-0-46-90-44-10-14-126-35-23-136-105-89-62-85-114-127-13-2-45-33-144-86-60-50-19-61-59-130-27-57-107-147-132-41-30-3-65-21-93-101-103-52-18-48,149-56-63-39-53-137-88-79-25-64-69-15-87-17-78-133-141-104-66-143-43-84-134-54-119-122-42-28-32-75-94-125-81-92-112-73-58-140-16-109-76-124-24-72-49-115-106-111-131-135-70-47-102-145-36-77-6-11-26-34-31-71-83-74-7-121-138-55-96-37-110-98-108-97-22,401206866,31933,33180,65113
ls-random,kroA150,133-52-136-78-37-23-93-15-69-128-142-30-121-122-42-127-114-148-54-11-26-59-108-46-104-147-134-99-40-135-2-29-100-81-125-94-146-38-67-50-60-80-68-143-63-39-137-74-9-98-126-20-16-116-77-51-4-36-145-32-12-115-53-91-5-71-31-44-22-109-56-8-86-89-105,141-66-132-88-79-138-48-112-73-58-140-14-10-90-97-130-92-27-57-76-61-149-6-144-124-24-72-113-49-84-95-102-75-18-87-21-65-64-25-123-117-3-118-55-96-17-110-101-103-35-83-62-107-139-33-111-131-13-28-45-119-34-85-19-82-70-47-120-106-43-1-41-7-0-129,291440005,34756,29751,64507
ls-random,kroA150,70-40-34-61-59-76-71-35-101-110-9-27-60-29-51-95-100-68-88-121-142-55-41-147-45-127-122-114-119-148-11-149-56-8-139-80-113-43-143-7-18-52-15-136-133-91-104-38-4-102-75-81-53-105-78-17-126-58-16-14-112-62-5-48-3-128-117-30-125-94-12-111-28-13-99,109-89-87-93-21-69-65-64-118-138-86-6-116-2-135-42-19-44-140-98-103-37-23-83-130-92-66-141-46-20-73-10-31-57-107-63-1-39-137-132-79-123-25-96-74-129-0-108-90-97-22-50-124-144-145-32-115-49-72-24-134-131-47-77-36-146-67-84-120-106-33-82-54-26-85,332250363,38968,32447,71415
ls-random,kroA150,139-33-131-29-106-6-8-144-124-50-57-66-27-92-129-0-46-112-71-16-31-44-97-49-81-94-125-1-53-39-68-56-34-149-59-76-147-138-64-65-123-117-118-142-96-126-101-17-78-136-93-21-15-52-74-48-130-19-11-148-114-127-40-99-2-45-47-146-12-4-51-77-95-100-134,14-108-90-36-102-145-32-75-115-3-25-128-69-89-9-62-5-18-55-79-30-88-137-63-143-113-43-38-120-28-42-122-119-86-116-82-54-26-85-61-109-22-91-7-121-41-132-84-111-13-70-135-35-37-23-87-133-105-83-20-73-140-58-98-110-103-60-24-80-67-72-107-104-141-10,336906509,28826,35066,63892
ls-random,kroA150,96-18-52-133-89-109-76-104-147-88-138-91-27-60-50-124-86-144-8-116-6-11-82-148-119-114-122-40-70-13-131-111-106-29-100-67-68-39-137-79-55-142-3-65-21-93-78-62-139-45-2-75-32-145-102-4-51-28-85-59-44-31-10-20-126-103-110-23-17-24-80-84-38-12-81,132-49-146-36-94-125-115-1-7-74-37-35-98-101-136-87-15-69-90-97-22-19-56-92-5-48-105-83-9-112-108-42-127-135-99-47-77-95-120-134-43-143-113-72-57-130-140-58-73-71-107-63-53-66-141-129-0-46-16-14-34-26-54-33-149-61-64-128-25-123-117-118-30-121-41,294625694,32412,36166,68578
ls-random,kroA150,66-107-60-124-13-70-135-127-42-22-16-31-108-90-50-75-145-102-36-38-19-149-76-130-129-41-79-138-142-96-52-87-93-136-0-92-57-86-144-8-139-134-49-43-113-68-56-85-34-26-82-28-111-120-51-95-146-1-53-147-9-83-17-103-101-58-73-20-65-25-123-3-74-7-141,72-67-33-45-2-40-99-47-131-122-114-119-148-11-133-69-21-15-23-37-78-105-89-46-44-97-109-59-61-6-116-54-106-29-100-84-27-35-98-110-5-91-132-104-24-80-115-81-125-94-12-32-4-77-143-39-137-88-30-121-62-71-126-140-14-10-112-48-18-55-118-117-128-64-63,258833986,32565,33364,65929
ls-random,kroA150,16-14-44-114-127-70-13-135-35-37-78-69-52-133-89-84-100-38-32-145-36-4-77-29-120-106-57-92-62-5-48-96-55-124-86-8-116-6-11-19-76-128-25-118-79-107-68-113-67-139-22-46-0-7-141-143-43-131-2-45-33-54-148-119-61-31-73-126-9-121-41-1-125-81-90,39-53-49-146-95-51-102-75-12-94-115-56-144-50-27-129-147-104-66-80-47-99-40-111-134-24-60-130-10-20-140-58-98-103-18-74-138-142-117-123-21-93-83-71-108-97-112-87-15-65-64-3-132-137-88-30-91-105-136-17-23-110-101-109-59-149-34-85-26-82-122-42-28-72-63,256900281,42552,32296,74848
ls-random,kroA150,133-52-65-64-96-66-57-116-54-33-2-13-4-102-145-12-132-128-25-118-79-121-138-91-16-14-148-99-70-40-135-127-42-45-28-131-111-106-100-36-146-67-72-53-147-129-62-71-126-58-140-50-124-144-139-120-51-77-5-87-15-69-21-136-37-101-44-8-6-19-85-59-9-105-78,39-107-130-97-90-108-0-141-27-92-149-61-20-35-23-17-93-110-103-98-73-10-22-109-76-60-24-80-68-113-49-38-95-47-29-134-46-112-89-83-31-34-119-114-122-32-75-94-84-82-26-11-56-86-104-7-55-142-117-123-3-18-74-48-41-30-88-137-125-81-115-43-1-143-63,296319054,36930,33455,70385
ls-random,kroA150,97-90-14-98-101-110-103-17-93-78-52-96-138-55-123-25-30-7-104-27-129-48-89-112-46-10-140-58-126-35-23-83-9-108-59-76-122-42-127-40-70-99-13-28-106-29-47-51-77-95-53-88-132-147-107-33-54-119-148-6-8-124-68-63-39-143-49-146-36-100-84-60-57-109-22,72-115-43-113-137-41-121-142-118-3-18-20-73-16-31-44-61-19-11-116-56-133-87-15-21-69-1-81-125-94-12-75-32-145-102-4-135-2-131-120-38-67-80-24-79-117-128-65-64-74-149-34-85-26-82-114-45-111-134-139-144-86-50-91-5-62-0-141-66-92-130-71-37-136-105,306155152,28973,34456,63429
ls-random,kroA150,79-142-118-64-65-69-123-117-125-75-32-13-45-42-122-114-71-17-136-133-18-96-147-141-66-63-72-68-107-27-109-76-54-33-111-120-29-47-99-80-60-50-144-116-56-85-149-97-108-20-126-35-110-93-21-15-87-78-105-74-91-92-31-10-140-58-16-22-134-100-95-1-39-88-121,4-36-43-41-138-7-24-67-84-139-82-148-28-131-51-77-46-112-9-73-14-44-90-130-57-81-94-12-145-102-104-129-0-124-86-70-40-135-26-34-83-37-23-52-89-48-5-3-128-25-55-11-119-127-2-49-113-143-132-30-137-53-115-146-38-62-103-101-98-59-61-19-6-8-106,234574508,34655,45339,79994
ls-random,kroA150,36-146-43-107-66-91-62-0-57-50-47-99-135-42-122-11-8-124-80-68-143-125-12-84-139-76-90-22-149-34-26-19-106-38-102-145-75-1-63-39-18-52-133-136-87-15-21-117-118-3-9-112-140-126-98-37-17-74-138-88-137-27-92-130-46-16-108-56-6-116-28-13-29-120-95,33-109-97-71-83-78-105-96-55-132-53-113-115-49-72-144-86-60-147-123-25-128-64-65-69-93-89-82-54-148-61-44-14-58-73-48-7-121-41-131-70-40-51-77-4-32-94-81-100-2-127-114-119-85-20-35-103-101-110-23-142-79-30-67-111-134-24-104-141-129-5-10-31-59-45,253253456,33516,39943,73459
ls-random,kroA150,60-24-80-143-113-43-125-81-22-108-14-16-10-112-89-142-79-121-41-18-133-87-93-105-83-9-46-149-26-114-122-127-135-2-45-11-19-109-130-27-95-4-36-32-98-110-103-23-37-35-126-58-62-129-66-68-39-53-147-132-117-123-128-64-3-141-104-139-13-99-40-28-33-6-56,97-76-8-134-102-145-15-21-69-65-25-118-55-138-7-91-71-20-73-140-31-90-124-86-144-146-12-75-94-137-88-30-96-74-0-92-57-50-85-34-148-54-82-119-42-70-131-111-106-84-67-107-52-78-136-17-101-48-5-63-1-72-49-115-38-100-120-29-77-51-47-116-61-59-44,286012581,35567,35197,70764
ls-random,kroA150,1-39-88-117-25-65-64-121-132-68-84-120-134-139-129-62-89-9-97-59-61-149-54-28-40-99-111-56-44-16-98-110-103-37-18-30-79-142-96-21-15-87-52-76-119-122-42-82-6-144-60-80-72-49-43-113-107-57-92-27-66-104-141-147-7-126-140-73-10-31-51-4-36-94-125,48-112-83-17-136-78-105-91-53-81-12-75-32-145-102-86-50-90-22-109-19-148-33-116-8-46-133-93-69-3-118-55-41-137-2-45-14-58-20-35-101-23-71-108-34-114-127-135-70-47-13-131-106-143-63-11-26-85-74-128-123-138-38-95-77-29-100-146-115-67-24-124-130-0-5,272858822,36041,40936,76977
ls-random,kroA150,79-142-55-5-0-27-130-56-82-135-13-131-111-29-100-38-147-117-123-25-3-96-43-115-125-94-146-95-77-47-40-127-119-114-42-2-45-148-26-85-34-149-59-109-50-80-107-66-133-15-136-101-98-58-73-14-10-108-90-97-46-71-20-22-86-75-32-102-134-116-67-49-137-41-30,124-28-122-33-54-8-144-143-1-81-12-145-36-4-51-84-72-113-63-68-24-60-104-141-7-91-89-110-103-83-62-129-39-53-132-88-121-138-74-18-52-78-87-21-93-17-23-37-35-126-140-9-105-69-128-65-64-118-48-112-16-31-44-70-99-120-106-139-6-11-19-61-76-92-57,286578988,33503,29852,63355
ls-random,kroA150,56-144-86-124-50-41-55-30-137-113-49-95-77-51-4-146-143-63-39-141-0-62-112-9-16-10-31-46-48-5-27-57-68-125-94-75-12-81-1-91-23-17-136-69-64-96-92-19-149-61-22-97-85-11-82-33-45-131-111-100-38-84-90-58-126-98-37-134-47-70-127-119-148-116-6,105-78-87-15-133-52-3-65-128-21-93-18-74-104-66-147-121-138-79-88-107-24-80-28-13-99-40-135-2-139-60-142-118-89-83-71-20-73-140-108-130-129-123-25-117-32-145-102-36-115-43-35-103-110-101-14-44-59-109-76-8-54-26-34-114-122-42-29-120-106-67-72-53-132-7,319277760,35747,35406,71153
ls-random,kroA150,86-146-145-4-13-135-127-122-119-82-8-147-137-53-39-63-143-68-24-60-92-27-107-80-67-32-75-125-49-31-14-16-73-126-101-37-23-89-48-106-95-51-45-33-104-141-7-142-64-123-25-128-69-93-17-136-133-96-55-79-121-41-5-112-46-90-34-85-26-148-11-149-61-59-76,114-42-2-28-54-116-6-56-74-18-3-30-1-94-12-102-81-115-43-113-72-84-139-144-109-22-44-10-58-140-108-97-19-111-77-36-38-100-120-29-50-130-62-105-52-15-65-117-118-138-70-40-99-47-131-134-124-57-66-0-129-132-88-91-35-98-103-110-21-87-78-83-9-71-20,296089227,32929,35901,68830
ls-random,kroA150,72-67-84-45-2-40-135-42-82-60-107-27-92-86-6-56-22-16-98-110-17-93-87-133-55-138-147-39-143-80-50-124-120-100-4-51-131-116-90-83-23-37-10-31-59-61-26-148-54-114-119-34-149-76-109-48-74-3-64-25-118-96-105-89-58-73-62-91-129-141-104-1-32-102-115,112-7-132-66-63-68-24-14-35-101-103-9-5-0-46-108-44-97-139-134-38-146-36-95-77-47-13-29-106-49-43-113-88-79-30-137-53-125-81-33-11-19-8-144-57-41-142-117-123-128-69-65-121-94-12-75-145-111-28-99-70-127-122-85-130-18-52-15-21-136-78-126-140-20-71,304594867,34120,37031,71151
ls-random,kroA150,121-64-123-117-118-63-115-146-4-38-100-72-68-107-104-141-129-9-110-101-98-35-140-14-10-22-61-19-50-124-24-143-1-125-75-32-145-57-130-90-108-112-62-91-7-55-18-3-69-21-15-105-97-34-119-114-11-56-8-6-54-134-106-99-127-42-133-87-93-103-37-5-147-137-132,26-85-149-76-109-116-82-33-70-40-135-122-148-92-48-52-78-136-17-23-16-31-44-59-111-120-29-95-36-102-77-51-47-13-2-45-28-131-12-94-81-80-46-71-20-73-58-126-83-89-74-96-142-138-41-66-60-139-144-86-27-0-65-128-25-79-30-88-53-39-113-43-49-67-84,322749117,35507,30771,66278
ls-random,kroA150,40-42-148-27-7-117-25-128-64-118-121-41-57-60-80-116-144-86-50-62-133-87-93-15-52-0-104-68-72-43-137-132-141-92-130-108-90-97-61-119-114-45-28-111-100-38-4-32-12-146-115-84-71-83-23-17-78-18-96-142-105-103-101-35-140-73-31-44-109-134-106-95-77-51-131,94-125-1-69-21-136-89-5-129-107-67-49-113-143-63-39-53-88-30-79-46-10-20-126-58-14-16-98-110-37-9-112-22-76-59-34-127-122-82-54-11-26-85-149-19-56-6-8-124-139-33-13-102-145-81-147-91-48-74-3-65-123-55-138-66-24-2-135-70-99-47-29-120-36-75,269186823,33689,33071,66760
ls-random,kroA150,105-46-85-26-114-127-122-117-25-128-103-101-126-20-113-43-12-94-125-63-66-104-141-90-44-97-22-59-61-149-11-148-33-106-100-84-124-50-129-7-91-83-35-17-74-55-79-121-41-147-56-76-14-71-138-132-75-32-145-146-80-24-139-131-70-99-95-38-137-30-142-3-21-15-133,62-0-27-57-86-19-109-10-31-108-77-51-4-36-102-16-98-110-58-140-73-112-9-78-69-65-64-123-118-96-88-60-144-8-6-116-120-29-111-28-13-135-40-47-134-48-136-87-93-23-37-5-53-1-81-115-49-67-45-2-42-119-82-54-34-89-52-18-39-143-72-68-107-92-130,288538691,41805,39286,81091
ls-random,kroA150,61-56-86-139-29-77-95-38-68-0-9-23-37-103-98-101-110-93-21-17-35-126-140-16-31-108-90-97-6-116-33-127-70-99-4-146-115-1-88-30-79-121-142-117-123-25-128-69-15-133-18-48-7-147-80-24-45-2-135-13-102-32-125-81-143-104-141-27-60-50-82-114-119-85-149,52-87-136-78-89-94-12-75-145-36-130-73-58-47-40-148-26-34-76-109-132-137-53-43-49-51-100-92-62-5-74-96-3-65-64-118-113-72-67-84-106-120-111-131-54-11-19-59-14-10-124-144-8-122-42-28-134-107-57-22-44-46-129-91-138-55-41-39-63-66-112-20-71-83-105,471029548,29434,40488,69922
ls-random,kroA150,75-32-102-51-77-95-6-86-50-80-66-147-30-117-123-25-128-64-65-71-31-14-98-101-105-55-79-121-41-88-137-53-113-43-49-72-68-104-141-27-82-13-99-70-54-148-11-76-46-21-15-52-133-78-17-23-37-83-89-48-5-62-90-44-114-127-135-131-106-120-100-38-84-81-94,122-42-2-28-111-146-12-145-47-40-134-107-138-142-118-74-9-112-0-129-130-92-57-60-24-143-1-115-67-139-144-22-97-108-136-93-87-18-96-3-69-110-103-35-126-58-73-20-124-29-4-36-125-63-39-132-7-91-109-61-149-34-85-26-116-8-56-19-59-10-140-16-119-33-45,304577141,29891,34354,64245
ls-random,kroA150,45-134-67-84-95-77-43-143-63-88-69-93-87-52-132-53-39-107-57-22-59-61-149-85-146-12-75-1-147-78-17-112-46-97-44-31-126-37-23-129-24-139-135-70-99-4-102-145-106-111-54-26-11-6-56-104-117-123-25-64-3-79-121-41-91-62-89-18-142-55-141-66-80-33-127,71-83-9-5-48-105-133-128-65-74-47-40-42-122-82-60-92-27-68-113-72-124-50-76-109-130-0-136-21-15-137-94-32-36-51-29-86-108-73-58-140-16-14-7-138-30-118-96-110-101-98-103-35-20-10-19-148-116-8-144-49-115-81-125-38-100-120-131-28-13-2-114-119-34-90,225405522,39098,37159,76257
ls-random,kroA150,6-19-76-22-97-90-104-147-115-146-4-47-99-120-106-137-132-88-79-142-96-71-20-35-101-98-126-58-16-10-31-149-34-114-2-45-121-25-128-65-69-15-87-139-134-28-111-51-95-100-91-52-78-17-110-37-89-48-129-102-75-12-125-1-53-39-63-113-43-72-68-80-60-86-56,59-108-14-44-119-40-70-13-57-64-123-117-118-55-138-7-141-66-107-124-50-46-103-23-136-133-3-18-74-5-62-0-92-27-143-49-67-24-144-8-116-84-38-36-77-29-130-105-93-21-30-41-145-32-94-81-140-73-83-9-112-109-11-122-42-127-135-131-33-82-54-148-26-85-61,292782522,36861,38659,75520
ls-random,kroA150,39-68-107-27-97-22-109-56-144-80-146-75-81-1-136-17-37-126-20-71-15-21-69-141-66-60-8-6-116-82-148-26-11-134-106-4-77-51-28-45-122-119-85-59-46-62-89-105-101-98-140-10-31-108-90-19-13-70-47-49-43-53-88-79-123-25-64-96-7-0-91-18-65-3-147,117-48-5-129-33-131-111-29-120-100-38-84-67-132-41-74-110-103-35-92-57-24-139-86-124-50-130-112-9-83-58-73-104-63-143-113-72-115-12-94-125-137-121-30-118-142-55-138-54-2-42-127-135-40-99-95-36-102-145-32-16-14-44-61-34-114-149-76-23-93-87-78-133-52-128,251155917,36257,37791,74048
ls-random,kroA150,76-119-122-42-2-135-70-99-13-29-67-88-96-3-64-25-123-32-4-146-38-100-120-90-20-98-93-87-15-21-69-65-136-17-37-83-9-112-108-68-49-115-81-125-1-113-143-53-132-7-91-52-133-5-129-92-57-107-60-139-111-28-33-8-56-85-149-61-59-44-16-58-140-31-22,12-94-137-138-74-62-46-130-11-148-116-6-144-86-97-10-73-71-126-14-34-26-114-127-40-47-51-77-95-36-43-30-79-118-117-128-142-55-121-41-106-131-45-82-54-19-109-27-141-147-104-66-39-63-80-24-50-124-134-84-72-0-48-89-18-105-78-23-110-101-103-35-102-145-75,341031683,33449,35604,69053
ls-random,kroA150,45-113-63-147-142-118-64-117-79-53-39-1-43-49-84-67-92-83-23-37-101-140-16-14-34-85-149-46-105-78-136-93-21-15-50-134-120-36-102-75-12-139-86-8-54-82-42-119-26-108-20-9-5-141-104-66-80-24-57-27-7-138-96-18-52-133-89-109-19-127-135-70-99-13-2,94-143-62-48-103-110-98-35-71-112-97-11-148-116-6-56-130-0-129-107-68-72-60-124-76-61-144-115-81-125-4-51-77-95-29-100-38-91-74-3-65-128-69-87-17-126-58-73-59-114-122-40-47-106-132-41-121-55-123-25-30-88-137-111-131-28-33-22-44-10-31-90-146-145-32,402485000,36569,38911,75480
ls-random,kroA150,122-114-119-16-140-98-110-142-79-30-88-137-39-113-72-139-76-109-22-97-60-24-80-68-66-121-117-123-25-69-21-15-23-37-73-31-149-148-82-8-27-91-0-92-28-99-47-4-145-115-132-41-138-74-52-105-83-71-112-46-33-111-77-95-84-62-5-48-136-87-125-94-12-2-42,61-19-56-11-85-34-26-54-131-51-36-102-32-75-146-81-43-1-64-128-65-133-18-7-147-129-108-10-58-14-44-107-63-143-53-55-118-3-96-141-104-130-90-20-35-103-101-126-127-135-40-70-13-45-116-6-86-144-67-49-38-100-120-29-106-134-124-50-57-89-78-93-17-9-59,236704677,41266,34998,76264
ls-random,kroA150,92-80-36-51-99-70-114-119-34-61-90-5-74-96-138-79-30-7-147-137-53-39-143-1-115-102-75-94-125-43-113-72-60-57-129-91-118-117-65-52-136-78-89-144-116-134-67-49-38-29-120-106-131-45-122-127-135-13-28-37-23-17-87-21-110-98-58-10-33-82-44-16-140-83-62,18-105-9-103-101-35-126-14-149-11-148-54-6-8-56-59-22-31-108-97-139-146-145-32-12-81-104-0-133-15-93-69-128-25-123-121-41-48-112-71-20-73-46-130-86-42-2-40-47-111-77-4-95-100-84-24-107-66-132-88-63-68-124-50-109-76-85-26-19-27-141-55-142-64-3,343265276,35663,32168,67831
ls-random,kroA150,48-105-133-18-55-121-143-81-75-12-146-131-28-111-24-142-118-117-64-128-15-136-78-114-119-34-108-14-10-41-88-137-68-99-40-127-122-11-130-89-17-103-101-98-35-112-46-97-56-6-116-148-82-33-134-84-72-49-95-51-106-139-86-104-147-74-5-0-27-57-19-26-85-109-62,25-123-53-1-32-145-102-77-47-70-13-29-120-60-66-141-90-31-73-20-71-9-3-96-7-107-80-100-38-4-36-115-113-43-125-94-67-124-50-63-39-132-30-79-138-91-129-92-59-61-149-54-45-2-135-42-8-144-76-22-44-16-37-23-110-126-58-140-83-52-87-93-21-69-65,414416061,39077,32306,71383
ls-random,kroA150,124-90-14-16-10-91-41-132-125-32-102-36-100-134-144-101-37-18-142-55-137-1-115-6-11-76-108-140-58-71-133-64-65-69-93-136-78-105-89-48-5-74-96-3-117-30-88-57-50-86-54-82-45-131-111-29-95-77-13-40-135-42-34-61-109-130-92-27-141-147-66-107-113-72-80,73-20-9-83-103-23-17-87-15-52-0-129-104-53-39-63-143-43-145-75-12-94-81-49-68-97-22-59-149-122-127-2-28-33-56-19-46-121-79-118-138-7-60-24-67-139-8-116-148-114-119-26-85-44-31-112-62-123-25-128-21-110-98-35-126-84-38-51-47-70-99-4-146-120-106,283397399,33715,34571,68286
ls-random,kroA150,56-60-57-141-55-142-96-48-112-10-46-129-147-121-30-88-63-143-72-139-116-82-33-100-146-102-75-115-1-137-65-69-87-93-17-37-98-35-58-73-14-61-148-54-45-127-2-51-77-4-36-84-67-80-66-104-27-109-59-90-108-31-136-133-52-70-99-134-123-25-64-3-149-34-19,132-125-94-81-89-105-83-9-119-114-122-42-135-40-47-24-107-91-74-18-5-62-0-39-113-43-6-11-26-85-76-22-97-50-124-8-28-13-131-111-38-49-68-92-130-71-126-103-101-110-23-78-15-21-128-117-118-79-53-12-32-145-95-44-16-140-20-86-144-106-29-120-7-138-41,263796369,39096,40925,80021
ls-random,kroA150,140-4-102-145-125-115-52-15-87-141-51-29-120-0-5-78-136-7-147-132-30-142-25-21-93-23-20-10-31-108-149-19-26-119-127-42-122-82-54-86-92-27-107-68-63-39-53-137-41-121-138-55-96-110-98-71-112-47-13-135-45-33-76-109-60-80-144-139-134-84-49-113-104-73-58,94-75-32-12-88-79-118-74-91-129-57-24-67-38-100-95-77-36-146-66-9-83-37-17-69-133-126-16-14-18-65-128-123-117-64-3-48-62-59-61-56-8-6-2-99-70-40-114-34-85-148-111-106-43-1-143-72-124-50-116-131-28-11-46-89-105-103-101-35-44-22-97-90-130-81,297083527,41832,36558,78390
ls-random,kroA150,2-70-99-111-120-106-48-105-136-133-18-91-7-132-39-143-115-81-36-77-95-137-79-142-21-15-87-17-37-126-20-46-125-12-32-100-33-82-54-148-11-85-149-19-57-147-121-128-65-138-107-24-124-56-116-8-144-86-76-22-97-90-10-98-110-83-113-43-49-68-104-141-129-61-34,146-72-130-71-9-112-62-5-74-3-64-52-73-16-14-31-44-108-96-117-123-25-69-93-78-89-50-139-45-135-127-42-122-140-58-101-103-23-35-6-13-40-47-29-84-134-131-28-114-119-26-59-109-92-27-0-55-118-30-53-1-94-75-63-88-41-66-60-80-67-38-51-4-102-145,322800659,38233,38756,76989
ls-random,kroA150,78-105-109-76-56-144-86-63-39-66-141-104-50-124-24-80-106-120-100-38-77-4-145-32-146-68-107-9-35-37-65-117-3-96-138-11-114-85-61-22-90-87-15-52-0-122-135-40-47-13-28-131-111-30-79-142-74-58-140-44-116-33-134-101-110-7-143-81-125-137-25-128-69-21-93,31-10-14-16-73-17-136-133-113-43-115-49-72-67-84-139-126-98-103-23-83-108-34-42-127-70-99-29-95-51-36-132-55-64-123-118-88-53-1-82-54-148-19-62-5-48-46-97-59-149-26-119-45-2-102-75-12-94-20-71-112-27-57-6-8-60-147-41-121-18-89-91-129-92-130,217629506,44632,40663,85295
ls-random,kroA150,115-102-32-75-94-81-123-25-23-101-35-126-33-28-111-100-120-29-2-122-42-135-70-127-16-140-71-83-18-74-96-55-132-43-95-77-4-36-1-30-64-3-138-147-141-66-27-130-108-31-73-20-62-0-57-60-72-84-134-139-116-11-59-44-109-76-19-56-144-86-46-112-93-15-87,89-61-149-85-26-119-114-54-82-6-9-37-103-110-98-22-34-148-45-40-99-145-12-125-146-38-106-8-124-50-92-5-48-118-117-128-65-69-21-142-79-88-137-53-39-63-68-107-41-121-7-91-129-97-90-10-14-58-17-136-78-105-24-80-143-113-49-67-51-47-13-131-104-52-133,273665176,40325,35756,76081
ls-random,kroA150,131-111-134-139-49-1-115-81-94-32-145-146-106-2-45-119-34-108-103-98-126-58-73-71-112-46-124-86-11-85-26-148-54-0-74-18-52-133-136-17-105-5-62-80-38-36-4-95-29-120-63-39-137-88-30-79-129-76-59-97-90-92-27-107-68-104-91-118-3-64-65-128-25-117-33,8-144-57-130-48-89-23-37-110-101-35-140-20-83-78-69-123-96-113-72-67-77-51-47-135-127-42-122-114-82-116-84-100-13-28-24-132-121-41-141-109-149-61-22-44-31-10-14-16-93-21-15-87-9-40-70-99-102-75-12-125-43-143-53-142-55-138-7-147-66-60-50-56-19-6,344555309,33892,34011,67903
ls-random,kroA150,38-146-67-57-92-103-98-110-136-3-142-55-138-79-118-25-65-69-133-52-96-7-39-143-94-81-113-68-107-90-31-44-109-76-56-106-120-111-131-116-6-124-50-104-41-88-53-145-36-4-95-77-51-40-13-2-127-9-78-105-48-62-19-11-54-82-114-119-26-149-58-126-37-83-60,28-33-137-132-121-112-71-46-130-86-8-85-61-35-101-93-21-42-135-70-99-47-125-115-49-84-134-139-144-66-147-141-27-108-10-14-16-140-23-17-89-5-18-64-74-91-0-129-1-12-75-32-102-100-29-148-59-22-97-73-20-24-80-72-43-63-30-117-123-128-15-87-34-122-45,309286043,38447,41589,80036
ls-random,kroA150,86-106-100-38-67-139-116-54-2-135-13-131-43-143-63-39-129-62-9-73-140-126-35-83-105-48-132-137-81-12-75-32-145-102-4-77-122-114-119-148-11-19-85-149-61-76-130-91-55-142-118-79-88-7-74-52-136-69-21-93-103-37-128-123-57-68-60-109-22-44-14-16-10-90-97,113-1-53-41-121-138-5-0-26-70-40-127-34-59-46-112-20-58-31-108-115-125-94-146-36-51-95-80-24-107-18-133-15-87-78-17-23-89-141-104-66-147-96-117-30-84-120-29-71-98-101-110-65-25-64-3-27-92-50-124-144-56-8-6-82-42-45-33-134-111-28-99-47-49-72,291304815,30369,38747,69116
ls-random,kroA150,95-51-29-120-38-63-53-74-18-48-22-59-61-149-119-122-127-4-145-32-146-81-43-143-113-106-111-82-54-148-11-109-130-89-98-110-17-133-69-64-142-131-13-47-99-40-135-2-28-134-139-24-104-141-147-121-30-55-129-0-92-27-68-72-67-144-116-56-44-31-10-20-83-108-90,138-79-41-66-107-60-50-57-52-136-37-35-97-114-45-33-3-65-128-25-123-9-71-16-14-42-70-77-100-84-101-103-23-78-105-46-76-86-124-7-96-117-118-88-137-1-125-94-115-49-80-19-85-34-26-6-8-36-102-75-12-39-132-15-21-93-87-126-58-140-73-112-62-5-91,235978957,35583,42908,78491
ls-random,kroA150,67-109-97-44-22-76-122-40-99-80-118-117-25-128-64-69-93-23-35-58-14-10-57-107-113-49-81-94-1-129-105-78-17-83-9-89-48-5-0-86-56-6-8-24-66-41-96-52-21-136-112-31-59-34-119-114-29-95-4-36-145-12-19-85-26-148-28-131-13-47-111-54-116-139-84,32-102-62-37-103-126-73-20-18-133-87-15-65-123-3-142-55-121-132-60-50-16-140-98-101-110-71-46-82-33-45-134-144-124-7-138-74-91-141-104-147-39-63-143-43-72-68-27-92-130-108-90-61-149-11-127-42-2-135-70-106-120-100-38-77-51-146-115-137-30-79-88-53-125-75,330484000,36071,34442,70513
ls-random,kroA150,68-113-143-63-123-128-93-15-52-133-78-9-17-23-103-110-98-140-71-112-72-49-115-81-94-1-147-48-18-96-117-118-142-141-50-114-42-40-99-131-26-149-97-90-124-84-38-36-4-95-100-24-60-92-27-129-55-79-30-88-53-32-145-102-146-106-134-6-8-144-86-44-31-46-107,132-2-135-127-34-14-16-10-61-85-82-33-13-70-47-51-77-39-137-25-69-21-87-136-105-89-66-43-125-75-12-67-80-20-73-58-126-35-101-37-83-108-109-76-130-91-74-65-64-3-138-7-57-56-116-11-19-59-22-62-5-0-139-120-29-111-28-45-122-119-148-54-104-41-121,306209920,36106,38382,74488
ls-random,kroA150,77-95-112-9-83-5-91-138-142-117-65-101-98-103-35-146-145-102-4-29-106-124-107-63-143-125-75-12-115-49-72-88-121-133-105-90-97-8-6-28-131-139-86-57-147-141-27-92-130-149-34-114-127-122-82-148-26-19-76-109-44-16-10-78-136-15-3-96-129-2-40-70-99-47-51,104-41-79-55-74-18-52-87-93-17-23-37-110-126-58-140-73-31-108-22-59-81-94-32-36-46-71-20-14-33-120-100-38-84-0-62-48-89-21-69-128-64-60-134-111-13-135-42-45-119-54-7-123-25-118-30-132-137-66-80-67-113-43-1-53-39-68-24-50-144-56-116-11-85-61,319323238,37732,35981,73713
ls-random,kroA150,103-140-20-27-104-146-12-102-77-51-47-99-134-121-118-3-64-25-128-69-133-48-129-92-33-45-114-148-34-90-31-14-10-141-147-53-39-68-24-139-56-149-61-59-74-55-79-88-137-43-125-81-49-113-72-120-106-84-67-107-66-50-86-8-6-11-19-22-97-130-62-5-78-17-37,38-30-117-123-65-52-105-108-109-76-44-16-73-71-83-9-112-46-60-29-95-100-80-57-7-18-136-87-96-142-138-41-132-63-1-94-75-115-143-15-21-93-110-101-98-126-119-122-127-135-40-70-13-2-42-131-111-28-82-116-144-124-0-91-89-23-35-58-85-26-54-4-36-145-32,293995049,35031,39175,74206
ls-random,kroA150,107-67-84-83-17-37-101-98-58-2-13-47-99-70-135-127-42-139-142-118-123-25-65-69-21-93-87-20-73-108-72-49-115-94-75-102-36-4-120-131-119-34-97-14-16-10-46-0-129-130-61-149-76-91-96-74-89-5-62-57-56-11-54-82-8-124-24-80-143-63-147-41-55-138-141,133-52-18-3-79-30-88-121-7-92-22-90-64-128-117-132-137-60-50-19-85-26-148-6-116-134-43-113-27-112-9-71-109-145-32-12-125-81-1-53-39-146-38-95-77-51-40-28-45-122-114-59-44-31-140-126-35-103-110-23-15-136-78-105-86-144-33-111-106-29-100-68-66-104-48,329966200,36234,34729,70963
ls-random,kroA150,117-54-122-42-2-49-1-53-30-138-55-142-96-3-18-91-7-12-32-145-36-11-19-147-132-88-41-141-50-116-38-146-27-112-98-103-17-23-37-35-126-58-10-107-63-113-43-24-109-31-14-34-114-135-70-51-77-95-29-106-13-28-6-0-105-52-21-93-83-140-73-20-128-25-123,65-64-118-4-120-45-127-119-148-82-139-60-57-137-121-79-78-110-101-9-71-16-44-134-100-84-67-72-143-68-80-124-86-144-56-92-130-62-136-87-15-69-133-89-46-26-85-149-61-59-22-108-90-97-76-8-33-111-131-40-99-47-102-75-94-125-81-115-39-66-104-129-5-48-74,314081271,41971,33261,75232
ls-random,kroA150,119-122-42-82-8-147-117-123-128-65-64-118-5-14-16-73-35-93-21-137-113-146-145-102-95-29-100-38-84-68-63-39-143-43-75-32-72-80-107-92-76-109-44-71-9-105-133-18-74-141-139-33-2-40-131-111-148-11-149-22-108-112-62-91-7-79-55-87-17-23-103-110-101-126-10,34-46-78-37-98-83-20-58-140-31-90-97-59-61-56-115-81-125-94-12-77-51-47-135-114-26-85-19-57-104-41-88-132-24-106-120-28-45-54-6-116-134-67-49-1-53-30-142-25-3-96-121-36-4-129-48-89-138-66-60-50-124-144-86-130-52-69-15-136-0-27-13-99-70-127,279884579,36447,39462,75909
ls-random,kroA150,9-26-119-127-42-122-139-24-60-3-64-25-117-118-55-74-23-37-110-101-98-126-140-20-56-6-8-116-120-29-131-2-45-82-19-149-44-31-112-89-5-41-132-39-143-49-68-92-130-0-129-141-104-84-111-99-47-51-77-4-102-145-32-81-115-1-88-79-138-18-52-21-136-78-17,113-90-108-58-103-93-69-15-87-133-97-22-59-61-106-100-38-95-13-70-40-135-28-134-124-50-80-72-63-53-137-30-121-71-35-83-105-91-7-147-66-107-57-27-46-62-48-96-142-123-128-65-73-16-14-10-109-76-34-85-11-148-114-33-54-144-86-67-146-36-12-75-94-125-43,229091428,31806,30940,62746
ls-random,kroA150,61-59-64-123-128-65-69-23-101-58-73-20-97-22-14-10-108-57-107-80-24-144-8-109-9-136-15-133-89-48-76-149-19-11-116-134-106-4-102-145-12-125-1-137-88-96-18-74-141-104-67-49-113-143-63-30-142-55-41-146-95-77-51-29-131-47-70-2-42-122-45-33-148-26-85,94-81-115-43-39-53-132-7-147-66-68-72-84-38-100-120-111-139-129-62-5-105-78-83-112-13-99-40-135-127-6-124-60-121-79-138-118-3-52-87-17-37-103-110-98-35-126-140-16-46-0-91-117-25-21-93-71-34-119-114-56-86-50-27-92-130-90-31-44-54-82-28-36-32-75,300113427,33074,33703,66777
ls-random,kroA150,131-13-99-2-42-127-122-45-28-111-39-53-137-142-136-21-93-110-37-35-83-9-89-133-65-25-123-117-129-0-56-8-107-132-88-79-138-48-112-20-73-58-16-44-106-120-4-145-12-81-84-134-82-148-11-149-97-31-46-130-92-1-115-146-51-77-95-49-72-66-147-141-27-50-139,32-75-38-90-10-140-14-61-85-114-119-34-59-108-71-17-69-128-64-3-118-30-121-113-43-125-94-67-144-86-124-68-143-63-104-7-91-5-62-116-6-109-22-126-98-101-103-23-57-100-29-33-54-26-19-76-74-18-52-15-87-78-105-96-55-41-60-24-80-135-40-70-47-36-102,242690553,32566,37938,70504
ls-random,kroA150,116-13-70-40-135-127-45-54-85-26-119-114-149-61-59-133-52-87-136-78-105-83-35-71-48-7-132-137-53-63-68-24-76-109-22-97-31-10-16-73-20-112-46-12-75-102-95-100-49-88-123-128-138-147-141-104-107-60-124-50-103-101-110-23-17-18-81-94-84-139-86-27-129-0-56,11-19-72-43-1-115-146-77-51-111-122-42-2-99-47-131-28-34-44-14-126-98-37-93-15-21-69-65-64-3-96-74-91-92-130-62-5-89-55-79-30-117-25-118-142-121-41-66-57-80-144-8-6-67-125-32-145-36-4-38-134-90-108-140-58-9-39-143-113-120-29-106-33-82-148,340792486,36695,30539,67234
ls-random,kroA150,34-14-35-37-23-78-89-18-96-132-53-1-38-100-106-120-51-4-36-102-145-146-84-134-82-148-6-8-19-76-109-124-50-108-10-140-58-73-123-25-15-93-87-65-117-3-68-72-49-94-12-86-97-90-130-27-66-107-131-28-26-59-46-0-142-138-7-129-33-45-13-99-135-127-119,69-21-101-98-126-16-31-92-104-141-30-79-91-71-20-44-61-11-116-56-144-139-67-43-115-81-125-75-32-29-111-122-114-85-149-22-9-83-103-110-17-136-105-48-5-62-57-60-24-80-113-143-63-39-137-88-41-121-55-74-52-133-112-54-42-2-40-70-47-77-95-147-118-64-128,363165669,35964,32053,68017
ls-random,kroA150,58-17-78-87-21-128-52-18-129-104-27-92-57-60-24-80-49-43-113-63-137-132-88-30-79-121-144-56-149-61-31-108-50-12-32-36-4-8-6-130-46-71-20-126-35-98-110-37-83-9-48-5-91-138-55-147-107-134-111-120-38-84-115-146-51-28-45-13-99-70-135-122-82-14-140,131-133-15-69-93-136-1-125-94-81-11-85-26-148-54-33-29-95-77-102-145-75-143-7-96-74-89-105-23-90-22-109-86-72-68-66-0-62-97-76-19-116-106-100-67-117-25-123-124-139-42-127-119-59-101-103-65-64-3-118-142-41-53-39-141-112-73-16-10-44-34-114-2-40-47,311960459,31711,46052,77763
ls-random,kroA150,100-134-116-45-2-135-40-70-99-111-72-49-36-4-67-24-41-138-55-96-74-5-31-90-97-149-119-127-122-26-16-58-35-101-136-105-89-91-63-113-68-66-147-62-20-73-140-145-32-12-125-123-25-3-142-88-86-8-6-18-133-69-21-93-83-44-19-11-148-82-28-13-47-77-38,76-34-85-56-124-137-79-118-117-128-64-65-15-87-52-48-0-50-144-54-114-42-131-106-33-61-59-108-112-9-78-17-23-37-103-126-14-10-22-109-139-84-43-115-146-95-51-29-120-143-1-53-39-80-60-57-27-92-46-71-98-110-107-81-94-75-102-104-141-132-30-121-7-129-130,305455710,40829,34452,75281
ls-random,kroA150,2-29-32-75-12-38-100-116-6-8-139-106-111-45-114-119-148-82-134-84-72-68-121-65-128-69-112-90-97-50-124-86-19-59-44-108-5-48-3-96-55-79-30-132-99-70-40-133-21-93-78-9-10-14-16-58-35-103-83-92-141-104-63-113-49-81-36-4-95-77-47-13-135-42-122,1-53-137-88-142-118-117-123-25-64-41-147-27-66-43-115-146-125-94-145-102-51-120-33-54-56-52-15-87-136-105-46-109-76-22-71-37-23-17-26-11-127-28-131-67-80-24-144-85-34-149-61-31-140-73-20-89-18-74-138-7-91-129-0-62-110-101-98-126-130-57-60-107-39-143,292707688,34349,33604,67953
ls-random,kroA150,78-9-126-58-10-57-107-53-63-60-44-16-103-23-17-93-15-125-75-32-12-137-88-121-118-123-128-64-3-139-134-42-122-114-119-34-82-36-146-81-1-113-49-38-40-135-127-149-76-92-27-141-147-95-77-29-106-131-13-2-45-28-33-6-8-144-50-130-46-90-31-112-89-105-52,30-79-138-83-37-110-65-25-117-142-55-19-85-26-11-148-51-4-115-72-68-109-59-22-97-108-73-20-71-62-0-104-66-80-24-140-35-101-98-14-61-70-99-54-56-21-69-96-41-132-94-145-102-43-143-39-7-74-18-133-87-136-48-5-91-129-124-86-116-111-47-120-100-84-67,254999267,37328,41370,78698
ls-random,kroA150,7-121-88-132-137-80-60-22-16-10-31-90-97-9-105-78-17-87-15-52-48-0-104-66-30-142-64-65-110-98-116-134-106-100-38-143-113-84-33-2-13-99-40-119-148-54-128-25-123-96-57-124-8-19-26-34-103-37-23-1-125-94-146-29-131-47-102-32-75-12-63-58-126-71-91,138-41-147-107-149-85-6-56-86-144-45-135-70-127-42-92-27-141-129-74-3-133-136-20-73-44-61-114-122-76-130-62-5-18-89-83-112-46-108-109-50-24-139-67-95-77-51-120-111-28-82-11-59-14-140-35-101-93-21-69-117-118-68-72-4-36-145-81-115-49-43-39-53-79-55,247719891,41925,34643,76568
ls-random,kroA150,3-142-55-52-133-21-93-78-89-112-31-14-16-140-73-98-110-103-71-20-130-92-107-68-39-43-125-94-75-51-100-120-111-33-82-54-11-85-149-59-44-90-7-41-121-79-137-60-86-8-116-13-70-47-131-139-56-19-109-22-48-5-141-104-84-134-122-42-127-114-34-91-65-128-25,87-136-105-83-9-62-46-28-38-36-102-145-32-12-81-49-72-67-106-29-95-77-4-146-115-1-53-88-30-138-118-96-74-129-0-37-23-17-64-123-117-132-147-66-63-143-113-80-24-50-108-10-58-126-101-35-97-76-61-119-135-40-99-2-45-148-26-6-144-124-57-27-18-69-15,277581714,31067,31127,62194
ls-random,kroA150,122-114-119-34-59-112-23-87-69-25-3-124-111-70-135-42-101-98-58-140-73-20-108-22-86-134-106-29-56-19-26-149-76-109-130-129-141-104-66-67-95-36-145-146-5-52-133-78-62-0-60-24-80-72-113-63-132-88-79-142-55-7-49-115-12-75-94-125-81-84-139-8-116-82-45,53-1-47-99-40-127-44-90-97-4-102-32-43-107-92-46-48-89-105-136-17-37-103-110-93-21-15-18-27-57-100-51-77-38-143-39-30-117-123-128-64-65-71-31-10-14-16-126-35-83-9-74-96-118-138-91-147-50-144-6-61-85-11-148-54-33-28-2-13-131-120-68-41-121-137,312118511,37458,35938,73396
ls-random,kroA150,12-102-36-51-77-95-115-49-80-139-114-119-148-8-56-57-88-41-52-133-110-98-103-37-23-17-21-87-136-126-58-20-48-5-62-130-2-70-135-42-122-16-140-73-71-89-18-118-142-55-138-30-79-117-123-128-64-61-34-26-19-76-90-108-129-147-39-63-113-72-45-28-131-106-38,24-92-46-10-31-44-54-82-33-47-4-145-32-75-1-68-60-107-132-121-7-74-78-101-35-14-127-40-99-13-111-134-27-0-105-15-65-3-96-91-141-104-66-53-143-43-11-85-149-59-112-9-83-93-69-25-137-120-29-100-146-94-125-81-124-50-97-22-109-6-116-86-144-84-67,296518098,31832,38392,70224
ls-random,kroA150,65-128-64-88-137-66-68-72-29-47-99-70-135-2-119-149-16-73-20-48-74-138-7-30-55-142-118-18-17-23-110-103-35-126-58-140-130-49-12-75-125-1-53-39-113-139-134-54-148-45-131-120-106-144-50-90-108-105-133-15-21-136-78-0-129-95-4-36-145-146-56-61-59-109-3,122-114-111-100-102-32-94-81-115-43-104-141-41-132-147-107-63-143-80-24-8-6-11-19-37-101-98-14-44-34-26-85-76-22-97-31-10-62-91-96-52-87-93-69-25-123-117-79-121-60-124-86-116-51-77-38-84-67-57-27-92-46-112-71-83-9-89-5-82-33-28-13-40-127-42,236589834,35030,31863,66893
ls-random,kroA150,30-79-55-74-130-76-109-90-73-126-98-101-110-23-49-32-102-4-114-119-148-46-52-69-128-123-3-96-54-82-42-122-14-10-71-62-5-48-91-129-92-27-57-60-134-131-28-116-8-108-83-17-93-105-89-24-80-84-106-135-70-13-77-95-38-143-39-66-147-104-59-149-19-56-132,78-37-103-35-58-140-16-20-65-64-25-117-118-142-41-43-115-81-94-125-1-53-137-88-121-21-15-87-136-133-18-138-7-63-12-75-145-36-6-85-26-11-111-29-120-100-139-144-67-72-68-124-50-86-33-45-2-127-34-61-22-97-44-31-112-0-141-107-113-146-51-47-99-40-9,275971724,40586,34449,75035
ls-random,kroA150,56-129-118-25-128-65-64-3-74-48-71-20-16-10-100-51-47-70-135-127-82-87-21-93-78-105-5-62-91-30-79-142-55-141-66-57-107-113-43-49-72-124-50-126-98-103-37-35-53-1-63-68-60-8-139-115-125-94-36-4-52-133-89-97-59-109-76-26-119-42-28-111-29-116-6,18-17-110-101-88-137-80-134-84-81-12-75-32-77-95-120-106-102-145-146-38-67-143-39-147-104-27-92-130-46-0-7-121-41-132-24-86-144-19-85-112-136-15-69-123-117-11-148-114-34-14-58-140-122-45-2-40-99-13-131-33-54-9-83-23-73-44-61-149-22-90-108-31-138-96,252636611,38652,38667,77319
ls-random,kroA150,77-4-102-145-115-43-88-118-55-138-7-57-80-67-106-120-38-49-143-63-147-66-92-129-91-79-30-137-53-75-32-95-10-140-98-101-35-20-130-50-86-144-116-6-11-19-76-105-52-87-21-93-110-103-37-69-123-117-64-18-59-34-119-122-45-82-62-48-112-108-44-22-134-111-99,127-54-8-56-124-24-139-131-13-47-51-36-27-0-5-89-9-133-15-136-78-17-23-83-71-46-72-146-12-94-125-81-1-113-97-90-31-14-16-58-126-73-61-114-42-2-28-33-148-26-85-149-109-96-142-121-41-132-39-68-107-141-104-60-29-100-84-25-128-65-3-74-135-70-40,326302811,38387,37115,75502
ls-random,kroA150,88-132-122-114-26-85-71-35-98-126-140-73-14-19-86-24-115-125-94-12-51-120-38-67-116-6-56-129-91-52-133-103-110-93-21-15-46-130-124-50-90-108-10-44-34-45-2-135-40-70-47-13-111-107-104-66-63-43-53-117-25-128-64-3-96-97-59-61-92-141-147-138-55-142-30,5-7-41-137-1-81-75-32-145-102-36-4-146-72-68-27-20-16-31-57-39-143-113-49-95-77-99-127-42-119-148-149-58-101-37-23-17-83-9-89-74-18-65-123-118-79-121-8-33-131-28-82-54-11-76-109-22-112-105-69-87-136-78-48-60-80-84-100-29-106-134-139-144-0-62,346222830,37400,33297,70697
ls-random,kroA150,57-80-72-39-43-99-40-135-127-122-114-34-16-58-103-101-110-69-65-3-7-147-141-104-27-76-61-149-56-144-24-137-132-55-142-117-123-128-91-84-106-120-100-95-77-4-102-145-32-75-94-146-44-10-20-83-133-18-121-41-66-50-124-6-148-28-2-47-134-97-108-48-5-0-92,107-129-62-105-87-15-21-64-25-118-60-111-131-13-70-116-11-26-19-130-88-30-79-96-52-93-37-35-9-89-74-138-1-81-125-12-36-51-29-139-86-68-63-53-143-113-115-38-33-82-54-45-42-119-85-59-46-112-71-78-136-17-23-98-126-140-73-14-31-90-22-109-8-67-49,252876423,35217,33363,68580
ls-random,kroA150,76-149-85-11-116-86-137-132-41-121-7-60-80-139-134-111-28-2-99-40-127-42-106-100-38-72-18-133-136-87-15-21-69-128-123-118-142-55-91-5-62-46-112-83-89-48-0-141-104-107-57-108-14-16-10-79-30-53-115-12-75-102-4-51-47-45-114-119-34-61-59-126-101-37-35,96-138-88-27-19-56-6-33-146-94-125-43-68-66-147-74-3-64-65-52-109-26-148-54-82-8-144-124-50-22-44-73-98-110-103-23-67-36-145-32-81-1-39-63-143-113-49-77-95-84-24-130-20-71-9-78-17-58-140-31-90-97-122-135-70-13-131-29-120-92-129-105-93-25-117,381917149,31874,37140,69014
ls-random,kroA150,145-125-84-134-139-8-56-86-57-27-129-7-118-96-91-62-48-105-37-103-101-110-17-93-21-133-3-88-141-80-131-2-42-127-40-99-47-29-106-100-77-146-43-1-113-68-128-25-123-117-53-39-130-9-98-126-58-20-108-19-45-28-33-90-31-16-14-34-85-26-11-54-82-4-36,0-52-15-87-136-78-89-6-13-70-46-71-112-81-94-75-12-115-107-92-104-41-138-74-18-142-55-121-132-137-147-66-67-120-111-116-5-69-65-64-79-30-32-102-51-95-38-144-124-50-97-44-22-109-76-61-149-119-114-122-135-148-59-10-140-73-35-23-83-63-143-49-72-24-60,315969950,34967,41780,76747
ls-random,kroA150,29-51-77-95-38-22-14-126-37-23-17-52-74-79-30-137-80-139-144-60-55-142-118-121-41-132-54-119-122-42-135-40-47-43-63-105-78-136-71-44-97-130-91-7-92-57-107-72-146-36-102-32-12-94-125-1-53-117-25-65-3-48-149-34-26-6-8-87-69-93-110-101-35-106-120,96-64-123-128-5-62-112-10-16-140-58-98-103-73-20-9-89-18-133-15-21-83-31-108-90-59-61-19-56-27-0-129-141-104-39-81-75-145-4-100-84-134-33-45-13-99-70-2-127-114-148-85-46-138-88-147-66-11-82-116-86-124-50-76-109-24-68-143-113-49-115-111-131-28-67,264697482,41067,31895,72962
ls-random,kroA150,0-129-141-27-92-60-67-84-47-99-13-26-16-98-101-23-93-69-15-87-20-73-140-126-35-37-18-118-142-55-79-30-41-11-119-114-131-111-29-120-106-134-56-76-90-31-46-62-48-89-74-138-132-1-32-4-51-146-49-139-54-148-24-80-63-39-53-43-72-19-149-97-78-136-133,40-85-34-61-59-8-94-125-81-124-50-107-66-147-137-88-121-17-110-103-83-9-71-58-14-10-108-44-22-109-144-86-130-64-65-128-25-123-117-3-96-91-7-104-57-6-82-122-45-28-33-116-68-143-113-115-38-135-127-42-2-36-102-145-75-12-5-52-21-105-112-100-95-77-70,356595067,33729,35885,69614
ls-random,kroA150,48-17-37-103-110-101-12-32-146-84-116-76-109-50-68-72-113-143-1-39-53-132-88-41-141-115-4-77-2-42-122-114-26-85-130-129-128-69-15-133-105-83-35-98-14-44-61-148-33-111-29-120-100-38-95-70-40-13-134-80-24-60-57-27-0-62-9-10-90-97-46-91-79-55-74,147-67-106-51-36-102-145-75-94-66-104-92-86-144-8-6-56-22-108-31-52-65-3-131-47-99-135-127-119-54-121-142-118-96-5-112-20-73-58-140-16-59-19-139-49-81-125-43-63-107-124-11-34-149-64-25-123-117-30-137-28-45-82-78-136-87-21-93-23-126-71-89-18-138-7,218965918,34606,40915,75521
ls-random,kroA150,100-38-113-143-63-39-53-27-0-129-104-137-88-30-79-118-117-123-96-112-20-140-16-149-34-119-114-40-70-99-2-148-11-19-116-8-86-50-139-81-94-75-32-102-36-107-18-52-69-21-15-87-133-9-83-126-58-109-76-28-47-95-106-54-26-98-101-110-103-23-89-5-62-57-60,145-115-55-142-64-3-74-138-121-41-7-130-90-44-14-73-17-93-136-71-97-22-59-124-24-80-84-120-29-82-85-61-56-6-134-111-13-135-127-42-122-66-147-141-92-144-33-45-131-51-77-4-146-67-72-49-43-68-91-78-37-35-10-31-108-46-48-105-65-128-25-132-1-125-12,345514138,33117,34752,67869
ls-random,kroA150,98-101-103-37-65-64-118-142-55-132-137-53-39-63-68-107-27-129-20-140-83-9-62-48-74-89-136-93-21-128-25-3-96-7-60-67-84-100-106-82-19-76-109-149-148-131-47-77-38-146-36-145-75-125-81-1-143-113-72-24-124-85-26-11-86-144-45-42-135-40-127-31-16-58-35,80-115-94-12-32-102-4-134-139-50-73-126-110-23-71-46-56-116-33-122-54-105-133-52-69-15-87-17-78-18-138-79-30-88-8-6-114-119-34-14-10-108-90-97-22-61-59-44-112-123-117-121-41-147-66-43-49-95-51-29-120-111-13-99-70-2-28-104-141-91-5-0-130-92-57,288644700,29071,35100,64171
ls-random,kroA150,14-140-20-130-141-118-117-123-25-65-3-30-88-104-66-107-124-92-27-0-62-112-71-90-22-120-100-51-40-114-119-126-35-98-103-37-23-17-93-21-87-78-83-9-61-11-6-8-116-54-122-42-45-111-84-53-137-132-74-18-52-133-109-76-139-67-80-68-63-49-94-36-4-146-10,70-13-28-97-46-108-31-44-59-149-29-95-77-102-145-125-81-106-131-2-135-127-33-138-96-64-128-69-15-136-105-89-48-5-91-7-129-147-57-56-19-85-34-26-148-82-134-43-113-143-110-101-58-73-16-12-75-32-144-86-50-60-24-72-41-121-55-142-79-39-1-115-38-47-99,281205232,35666,36484,72150
ls-random,kroA150,41-7-96-18-74-5-116-2-135-40-47-49-63-53-137-132-147-66-104-141-46-108-31-58-35-23-17-112-97-22-85-26-56-144-86-80-84-146-12-102-36-4-95-148-82-134-43-143-1-115-38-100-120-106-111-131-122-34-61-76-27-57-60-124-44-10-140-93-21-3-25-117-118-142-55,75-32-145-113-39-107-14-16-73-20-126-83-65-128-123-64-79-30-88-121-138-89-105-52-133-78-37-103-110-101-98-149-119-114-127-70-99-13-51-77-67-72-68-24-50-139-54-11-19-109-48-136-87-15-69-91-130-8-6-59-90-71-9-62-0-129-92-33-42-45-28-29-81-125-94,288885655,30746,32283,63029
ls-random,kroA150,125-102-46-20-140-58-126-105-133-65-117-118-142-96-138-7-27-86-144-60-107-137-30-79-121-132-56-6-82-54-149-61-78-136-87-15-17-23-37-10-14-59-34-114-45-135-13-70-40-99-47-51-77-29-106-129-91-74-0-130-85-26-134-100-38-49-72-139-24-80-68-63-39-143-81,92-57-50-148-119-122-127-42-2-131-28-33-116-8-73-98-101-110-69-128-25-123-64-89-48-5-62-22-109-76-124-67-84-120-111-11-19-44-16-31-108-90-97-113-43-115-75-32-145-36-4-95-66-104-141-112-71-35-103-83-9-41-88-55-3-18-147-53-1-94-12-146-52-21-93,242406391,32741,36178,68919
ls-random,kroA150,104-27-130-108-90-97-22-109-85-119-122-42-82-54-6-19-149-59-44-78-136-17-73-58-16-10-31-46-112-5-74-7-30-79-117-123-128-64-142-138-41-88-137-147-66-57-50-8-28-2-135-77-4-36-102-12-125-1-143-60-24-72-113-43-95-106-35-110-23-93-87-15-69-3-18,116-11-26-148-33-131-111-61-126-98-101-103-37-83-105-96-118-55-91-76-56-139-67-84-100-120-29-13-70-40-99-47-51-81-115-49-53-25-65-21-52-133-62-86-144-124-92-0-129-121-132-39-63-68-80-134-45-127-114-34-14-140-20-71-9-89-48-141-107-94-75-32-145-146-38,244614109,29752,34541,64293
ls-random,kroA150,28-131-134-139-89-23-78-52-21-65-128-25-123-117-3-138-147-107-57-90-97-22-76-149-85-148-106-120-100-77-4-32-125-81-38-13-114-119-26-58-98-101-110-103-20-44-19-135-70-99-67-68-129-0-91-62-5-18-96-142-30-88-1-43-143-46-112-71-31-50-24-80-6-82-33,49-72-84-111-54-116-8-144-86-124-60-66-104-48-105-136-93-17-37-35-126-83-9-7-41-137-132-10-16-14-61-34-11-29-51-95-146-113-63-39-53-27-130-73-140-108-59-109-141-121-79-55-118-64-69-15-87-133-74-92-56-122-45-2-42-127-40-47-36-102-145-75-12-94-115,321667619,35157,30184,65341
ls-random,kroA150,112-20-83-93-21-15-25-123-137-1-115-94-146-38-134-26-85-76-109-97-46-74-96-121-30-88-7-122-127-135-2-111-100-84-113-53-39-107-141-129-52-87-105-62-60-24-80-95-77-51-86-35-98-101-110-23-37-73-108-56-6-116-11-54-33-106-120-29-47-70-119-34-130-5-48,91-0-92-27-57-144-8-139-28-131-67-68-104-66-63-81-125-4-13-99-40-42-45-114-149-14-16-140-58-126-103-17-136-10-44-59-61-147-41-138-55-142-79-132-50-124-72-49-143-43-12-75-32-145-102-36-82-148-19-22-90-31-71-9-18-3-118-117-64-65-128-69-133-78-89,231722892,36805,31502,68307
ls-random,kroA150,55-79-121-41-147-107-54-114-119-34-98-101-110-35-58-73-20-46-27-57-56-19-149-59-44-90-68-63-39-137-88-123-25-128-65-71-31-84-38-146-125-32-145-102-36-4-113-91-87-93-103-37-23-78-105-0-141-33-122-42-70-51-95-100-29-111-26-85-109-130-62-89-133-18-3,67-12-75-94-81-115-132-30-142-138-7-92-22-97-108-5-48-136-52-74-129-104-66-80-120-106-134-139-144-86-124-50-11-148-45-2-28-82-116-6-8-72-43-1-53-143-49-77-47-127-61-76-83-9-112-60-131-13-99-40-135-96-118-117-64-69-21-15-17-126-140-16-14-10-24,266047468,36757,35321,72078
ls-random,kroA150,1-53-147-141-0-9-83-20-73-44-34-148-45-99-47-29-106-118-117-123-128-65-55-121-88-124-144-35-98-101-103-17-87-15-52-105-89-90-22-149-11-54-111-38-43-113-68-107-66-46-31-14-10-112-74-138-41-7-91-129-27-57-19-85-26-56-24-80-119-114-127-135-51-77-115,142-25-69-21-93-133-39-125-94-81-49-72-137-30-79-132-122-42-2-95-4-36-60-23-37-110-126-108-50-102-145-32-75-12-146-143-63-96-3-64-18-5-62-92-130-140-58-16-97-109-76-6-8-116-134-84-67-139-61-59-71-136-78-48-40-70-13-120-100-131-28-33-82-86-104,263327753,34500,42669,77169
ls-random,kroA150,121-147-54-119-122-135-70-99-13-2-59-31-73-126-71-67-84-146-32-12-37-103-101-110-93-21-123-117-79-1-125-102-36-4-72-55-118-96-5-62-46-61-34-85-26-139-80-60-144-8-6-22-108-130-92-27-91-7-41-138-74-136-17-112-57-134-33-131-120-100-38-63-39-137-30,11-19-9-105-89-48-0-24-111-47-40-127-42-14-16-44-76-149-114-45-28-50-129-25-128-69-15-87-133-52-18-141-49-115-43-113-143-53-88-132-104-66-107-124-86-116-56-109-97-90-83-35-98-23-78-65-64-3-142-68-95-77-51-29-10-140-58-20-81-94-75-145-106-82-148,332178350,40044,40416,80460
ls-random,kroA150,7-66-68-32-145-102-36-77-95-60-130-140-126-98-23-17-133-48-27-57-50-144-45-2-111-84-67-49-115-81-38-106-134-139-97-22-56-82-42-135-127-114-26-61-44-14-10-83-78-105-89-132-137-121-117-123-64-65-69-15-87-93-112-46-13-70-47-104-141-129-0-62-118-142-55,128-3-96-74-18-37-103-35-9-71-59-19-11-148-100-125-94-75-12-120-33-54-116-6-41-88-30-79-138-5-20-73-58-16-31-108-90-92-91-147-107-131-99-40-122-119-34-101-110-136-21-52-113-43-72-8-86-80-143-39-63-24-124-109-76-149-85-28-29-51-4-146-1-53-25,307858318,35742,37679,73421
ls-random,kroA150,78-17-23-35-58-140-16-31-92-27-107-24-13-40-127-122-82-6-42-135-111-134-68-55-25-128-65-69-133-87-93-110-101-98-126-73-0-66-39-113-72-84-106-100-115-137-88-79-132-147-50-144-34-85-8-81-94-12-145-146-38-95-36-4-51-120-149-61-109-97-71-112-62-48-83,46-9-37-103-136-52-18-5-108-90-44-22-59-76-124-143-1-43-125-75-32-102-67-80-60-57-7-138-118-3-139-131-28-116-86-41-121-63-53-30-142-96-74-91-56-119-114-70-99-2-45-148-26-19-11-54-33-29-47-77-49-117-123-64-21-15-105-89-20-14-10-129-141-104-130,277871049,33553,37407,70960
ls-random,kroA150,106-116-8-86-124-57-104-141-74-65-128-88-36-145-12-30-79-41-0-46-108-90-44-109-76-149-85-34-122-127-42-2-135-40-70-99-47-51-111-6-26-148-82-134-84-67-60-31-14-78-136-87-17-23-98-140-20-27-24-80-107-147-55-142-18-133-105-89-62-53-143-43-72-38-100,138-118-117-123-25-64-3-121-137-146-95-77-4-102-32-75-130-73-58-83-93-15-52-48-5-129-66-63-113-68-33-114-119-11-56-92-96-69-21-9-71-10-16-126-35-101-110-103-37-112-7-132-39-1-125-94-81-115-49-50-144-139-120-29-13-131-28-45-54-19-61-59-22-97-91,324387383,33883,33645,67528
ls-random,kroA150,114-44-14-58-83-87-15-18-96-118-142-79-30-121-41-88-132-137-77-99-29-120-100-49-43-113-53-39-107-46-35-103-110-37-23-17-65-128-123-64-3-138-1-125-12-145-36-146-109-31-9-78-136-52-89-76-61-19-56-6-82-11-26-34-5-48-91-7-141-50-124-139-28-2-45,95-4-102-32-75-55-117-25-74-62-97-22-59-149-122-42-57-92-27-66-104-130-71-20-73-10-108-60-24-67-84-134-116-148-54-33-111-106-38-72-80-86-144-8-131-13-70-40-127-119-16-140-126-98-101-133-105-0-129-147-68-115-94-81-143-63-69-21-93-112-90-85-135-47-51,200552580,34006,37623,71629
ls-random,kroA150,43-113-76-109-0-62-5-18-65-123-3-96-7-27-8-82-45-40-70-99-28-54-34-14-58-126-73-20-71-17-93-21-69-142-79-30-121-132-137-53-38-120-29-2-42-122-119-148-26-149-61-59-48-133-87-15-74-66-146-36-86-130-46-112-10-90-97-24-49-115-81-145-32-12-125,51-77-95-106-52-136-23-37-103-110-101-98-35-9-129-39-1-94-75-13-135-127-114-33-116-139-134-84-67-72-143-63-88-41-55-138-16-140-83-78-105-89-91-141-104-102-4-100-57-92-118-64-128-25-117-147-107-68-80-60-108-31-44-22-85-11-19-56-6-144-50-124-111-131-47,299746842,34614,35548,70162
ls-random,kroA150,8-6-19-85-22-90-46-5-118-65-25-128-93-17-78-52-105-48-129-139-28-99-70-135-2-45-121-79-55-96-74-9-35-37-23-103-101-126-16-44-56-116-82-148-122-13-47-32-75-12-94-68-104-141-27-84-111-106-29-77-95-38-115-43-113-132-112-73-58-140-31-60-50-124-86,142-41-147-66-149-11-26-34-61-59-21-69-123-117-83-71-10-14-20-98-110-136-138-30-88-137-107-24-144-54-119-114-33-134-67-72-49-81-102-145-125-1-53-7-91-0-92-57-146-36-4-51-133-15-87-130-42-127-40-131-120-100-143-39-63-80-76-109-97-108-62-89-18-3-64,291567061,32967,39272,72239
ls-random,kroA150,30-138-74-89-105-78-87-128-123-137-53-125-94-29-28-114-34-90-71-112-130-92-107-72-80-24-50-56-6-8-139-84-49-143-66-129-0-7-41-132-109-149-85-11-116-106-120-95-36-12-75-102-47-99-40-42-122-61-59-5-3-64-65-69-15-17-110-35-20-140-16-10-31-108-121,131-9-136-93-21-25-117-88-1-43-113-134-33-45-127-119-14-58-73-83-37-23-18-96-118-142-55-79-147-141-104-27-57-60-67-4-145-32-146-81-115-38-100-77-51-111-22-44-126-98-101-103-97-76-86-144-124-68-39-63-82-54-148-26-19-46-62-48-133-52-91-2-135-70-13,234070461,33178,37631,70809
ls-random,kroA150,99-47-13-134-116-6-72-43-113-143-63-91-5-48-89-112-22-59-34-114-122-45-33-54-56-90-108-9-136-52-142-55-30-121-87-17-23-37-110-35-71-4-51-77-29-106-84-80-104-141-0-57-60-124-86-67-146-102-94-81-115-88-117-64-65-128-25-123-73-16-44-19-148-135-70,107-140-58-126-98-101-103-83-20-14-149-85-26-119-11-61-10-31-97-76-109-46-62-105-78-93-21-69-15-133-18-3-96-147-66-24-111-120-100-95-40-127-42-2-82-8-144-139-12-75-125-1-137-132-27-92-129-7-138-74-130-50-28-131-41-118-79-32-145-36-38-49-53-39-68,274501480,35287,37440,72727
ls-random,kroA150,7-91-48-129-43-146-32-102-77-51-47-131-11-76-112-9-136-21-15-87-78-89-45-99-70-135-2-127-119-54-148-26-149-44-35-98-101-103-18-96-79-30-53-1-125-94-81-49-134-144-86-8-33-28-111-104-141-41-117-3-133-83-126-140-73-90-57-80-72-113-143-68-107-66-147,12-75-145-84-139-19-85-34-61-59-108-31-10-20-17-93-69-65-52-105-130-92-60-106-29-120-132-121-118-142-55-138-27-6-116-82-114-122-42-40-13-56-71-23-37-110-58-16-14-109-100-95-4-36-38-67-124-50-74-64-128-25-123-88-137-39-63-0-5-62-46-97-22-24-115,251523622,35384,37813,73197
ls-random,kroA150,60-52-87-93-17-110-101-103-71-108-44-97-76-12-94-81-43-24-86-56-6-119-45-40-4-36-102-1-118-117-123-128-64-83-73-58-10-46-130-129-121-132-141-27-19-148-28-131-33-82-54-66-55-142-30-88-53-143-63-39-96-74-18-105-107-68-38-95-77-51-100-120-29-106-111,34-85-26-11-114-122-42-127-135-13-2-134-139-90-20-37-23-136-78-133-15-21-69-147-75-32-145-47-99-70-146-125-115-49-113-72-124-50-144-8-116-149-22-31-14-16-112-5-138-79-137-41-7-91-0-104-92-109-61-59-62-48-3-65-25-67-84-80-57-89-9-35-98-126-140,237928008,37847,35364,73211
ls-random,kroA150,19-59-22-96-64-21-110-101-7-147-39-63-143-125-94-12-66-9-103-23-17-128-25-123-118-142-132-75-32-102-146-38-27-46-105-133-89-48-5-73-58-14-56-116-28-13-47-4-36-95-29-113-53-137-88-55-136-78-31-90-97-57-60-50-124-84-139-6-85-34-119-42-135-45-82,100-145-81-115-43-1-68-141-41-121-117-65-3-74-62-0-92-80-24-86-144-8-54-148-114-122-127-40-70-99-2-134-18-52-69-93-98-126-35-37-15-87-83-112-72-49-67-111-131-33-76-109-108-130-30-79-138-91-129-104-107-77-51-120-106-10-71-20-140-16-44-61-149-26-11,316743988,39721,36006,75727
ls-random,kroA150,15-87-136-73-140-16-14-62-121-30-88-137-56-6-116-111-146-115-43-113-50-22-108-10-112-0-104-66-72-67-139-144-92-55-142-91-85-26-11-54-82-148-114-42-45-28-131-47-36-75-94-125-81-143-129-5-48-105-78-65-128-25-123-3-120-29-51-77-95-9-37-103-101-93-21,110-98-35-126-59-61-149-19-76-109-60-24-80-134-33-8-86-124-7-74-18-96-138-41-63-49-38-100-106-84-57-89-133-52-69-17-83-127-40-70-99-135-2-68-107-132-147-141-27-130-97-44-58-20-71-31-90-46-64-117-118-79-53-39-1-12-32-145-102-4-13-122-119-34-23,252480184,35615,37199,72814
ls-random,kroA150,129-91-121-79-88-141-86-11-122-127-114-34-149-14-16-31-60-143-113-49-67-145-36-4-77-95-28-85-22-97-0-87-93-17-23-37-103-110-78-52-89-83-71-73-58-126-98-35-108-90-6-116-111-106-100-84-96-15-69-64-25-117-138-2-40-47-29-120-139-144-24-63-53-27-92,124-50-8-56-59-44-46-130-134-38-146-102-32-75-12-94-125-81-115-1-30-118-142-55-41-132-107-33-45-135-13-131-82-54-19-76-109-57-147-137-39-51-99-70-42-119-148-26-61-10-105-133-3-123-128-65-21-136-101-140-20-9-112-62-5-48-18-74-7-104-66-68-43-72-80,280963741,36882,31881,68763
ls-random,kroA150,109-22-90-46-93-69-128-25-123-117-55-126-140-14-31-44-34-122-13-95-4-36-100-29-148-149-59-76-144-116-45-131-106-67-72-43-115-49-139-124-24-80-66-104-132-88-137-127-135-145-75-12-94-125-1-63-37-103-110-23-17-78-105-18-48-130-57-107-68-39-53-30-79-141-27,65-74-91-129-60-84-146-102-32-81-113-143-147-62-101-98-35-58-16-56-38-77-51-120-111-82-54-6-8-86-50-92-0-5-136-87-21-15-52-133-42-2-33-138-142-118-121-41-19-11-114-119-26-112-89-9-83-71-20-73-10-108-97-61-85-28-47-99-40-70-134-7-96-3-64,334914400,35559,38278,73837
ls-nn,kroA150,57-66-74-65-69-21-48-5-53-1-12-32-36-4-67-24-18-52-15-17-23-37-35-58-73-44-61-26-42-45-28-33-54-6-8-72-49-38-51-29-11-19-16-14-34-2-13-70-40-47-43-39-63-68-60-50-56-59-22-31-10-9-64-25-3-55-30-41-7-0-62-71-20-46-27,148-97-90-86-144-120-77-95-100-89-133-87-93-136-78-105-83-140-108-149-85-119-114-127-122-126-98-101-110-103-112-129-124-139-84-146-94-125-81-115-143-137-138-96-142-79-121-88-132-147-92-130-109-76-116-134-131-111-106-80-107-128-123-117-118-91-141-104-113-75-145-102-99-135-82,272299125,35844,37889,73733
ls-nn,kroA150,57-66-74-65-69-21-48-5-53-1-12-32-36-4-67-24-18-52-15-17-23-37-35-58-73-44-61-26-42-45-28-33-54-6-8-72-49-38-51-29-11-19-16-14-34-2-13-70-40-47-43-39-63-68-60-50-56-59-22-31-10-9-64-25-3-55-30-41-7-0-62-71-20-46-27,148-97-90-86-144-120-77-95-100-89-133-87-93-136-78-105-83-140-108-149-85-119-114-127-122-126-98-101-110-103-112-129-124-139-84-146-94-125-81-115-143-137-138-96-142-79-121-88-132-147-92-130-109-76-116-134-131-111-106-80-107-128-123-117-118-91-141-104-113-75-145-102-99-135-82,274659869,35844,37889,73733
ls-nn,kroA150,57-66-74-65-69-21-48-5-53-1-12-32-36-4-67-24-18-52-15-17-23-37-35-58-73-44-61-26-42-45-28-33-54-6-8-72-49-38-51-29-11-19-16-14-34-2-13-70-40-47-43-39-63-68-60-50-56-59-22-31-10-9-64-25-3-55-30-41-7-0-62-71-20-46-27,148-97-90-86-144-120-77-95-100-89-133-87-93-136-78-105-83-140-108-149-85-119-114-127-122-126-98-101-110-103-112-129-124-139-84-146-94-125-81-115-143-137-138-96-142-79-121-88-132-147-92-130-109-76-116-134-131-111-106-80-107-128-123-117-118-91-141-104-113-75-145-102-99-135-82,313587806,35844,37889,73733
ls-nn,kroA150,57-66-74-65-69-21-48-5-53-1-12-32-36-4-67-24-18-52-15-17-23-37-35-58-73-44-61-26-42-45-28-33-54-6-8-72-49-38-51-29-11-19-16-14-34-2-13-70-40-47-43-39-63-68-60-50-56-59-22-31-10-9-64-25-3-55-30-41-7-0-62-71-20-46-27,148-97-90-86-144-120-77-95-100-89-133-87-93-136-78-105-83-140-108-149-85-119-114-127-122-126-98-101-110-103-112-129-124-139-84-146-94-125-81-115-143-137-138-96-142-79-121-88-132-147-92-130-109-76-116-134-131-111-106-80-107-128-123-117-118-91-141-104-113-75-145-102-99-135-82,289493925,35844,37889,73733
ls-nn,kroA150,57-66-74-65-69-21-48-5-53-1-12-32-36-4-67-24-18-52-15-17-23-37-35-58-73-44-61-26-42-45-28-33-54-6-8-72-49-38-51-29-11-19-16-14-34-2-13-70-40-47-43-39-63-68-60-50-56-59-22-31-10-9-64-25-3-55-30-41-7-0-62-71-20-46-27,148-97-90-86-144-120-77-95-100-89-133-87-93-136-78-105-83-140-108-149-85-119-114-127-122-126-98-101-110-103-112-129-124-139-84-146-94-125-81-115-143-137-138-96-142-79-121-88-132-147-92-130-109-76-116-134-131-111-106-80-107-128-123-117-118-91-141-104-113-75-145-102-99-135-82,290274659,35844,37889,73733
ls-nn,kroA150,57-66-74-65-69-21-48-5-53-1-12-32-36-4-67-24-18-52-15-17-23-37-35-58-73-44-61-26-42-45-28-33-54-6-8-72-49-38-51-29-11-19-16-14-34-2-13-70-40-47-43-39-63-68-60-50-56-59-22-31-10-9-64-25-3-55-30-41-7-0-62-71-20-46-27,148-97-90-86-144-120-77-95-100-89-133-87-93-136-78-105-83-140-108-149-85-119-114-127-122-126-98-101-110-103-112-129-124-139-84-146-94-125-81-115-143-137-138-96-142-79-121-88-132-147-92-130-109-76-116-134-131-111-106-80-107-128-123-117-118-91-141-104-113-75-145-102-99-135-82,289870241,35844,37889,73733
ls-nn,kroA150,57-66-74-65-69-21-48-5-53-1-12-32-36-4-67-24-18-52-15-17-23-37-35-58-73-44-61-26-42-45-28-33-54-6-8-72-49-38-51-29-11-19-16-14-34-2-13-70-40-47-43-39-63-68-60-50-56-59-22-31-10-9-64-25-3-55-30-41-7-0-62-71-20-46-27,148-97-90-86-144-120-77-95-100-89-133-87-93-136-78-105-83-140-108-149-85-119-114-127-122-126-98-101-110-103-112-129-124-139-84-146-94-125-81-115-143-137-138-96-142-79-121-88-132-147-92-130-109-76-116-134-131-111-106-80-107-128-123-117-118-91-141-104-113-75-145-102-99-135-82,288200103,35844,37889,73733
ls-nn,kroA150,57-66-74-65-69-21-48-5-53-1-12-32-36-4-67-24-18-52-15-17-23-37-35-58-73-44-61-26-42-45-28-33-54-6-8-72-49-38-51-29-11-19-16-14-34-2-13-70-40-47-43-39-63-68-60-50-56-59-22-31-10-9-64-25-3-55-30-41-7-0-62-71-20-46-27,148-97-90-86-144-120-77-95-100-89-133-87-93-136-78-105-83-140-108-149-85-119-114-127-122-126-98-101-110-103-112-129-124-139-84-146-94-125-81-115-143-137-138-96-142-79-121-88-132-147-92-130-109-76-116-134-131-111-106-80-107-128-123-117-118-91-141-104-113-75-145-102-99-135-82,298348498,35844,37889,73733
ls-nn,kroA150,57-66-74-65-69-21-48-5-53-1-12-32-36-4-67-24-18-52-15-17-23-37-35-58-73-44-61-26-42-45-28-33-54-6-8-72-49-38-51-29-11-19-16-14-34-2-13-70-40-47-43-39-63-68-60-50-56-59-22-31-10-9-64-25-3-55-30-41-7-0-62-71-20-46-27,148-97-90-86-144-120-77-95-100-89-133-87-93-136-78-105-83-140-108-149-85-119-114-127-122-126-98-101-110-103-112-129-124-139-84-146-94-125-81-115-143-137-138-96-142-79-121-88-132-147-92-130-109-76-116-134-131-111-106-80-107-128-123-117-118-91-141-104-113-75-145-102-99-135-82,286801518,35844,37889,73733
ls-nn,kroA150,57-66-74-65-69-21-48-5-53-1-12-32-36-4-67-24-18-52-15-17-23-37-35-58-73-44-61-26-42-45-28-33-54-6-8-72-49-38-51-29-11-19-16-14-34-2-13-70-40-47-43-39-63-68-60-50-56-59-22-31-10-9-64-25-3-55-30-41-7-0-62-71-20-46-27,148-97-90-86-144-120-77-95-100-89-133-87-93-136-78-105-83-140-108-149-85-119-114-127-122-126-98-101-110-103-112-129-124-139-84-146-94-125-81-115-143-137-138-96-142-79-121-88-132-147-92-130-109-76-116-134-131-111-106-80-107-128-123-117-118-91-141-104-113-75-145-102-99-135-82,301755522,35844,37889,73733
ls-nn,kroA150,57-66-74-65-69-21-48-5-53-1-12-32-36-4-67-24-18-52-15-17-23-37-35-58-73-44-61-26-42-45-28-33-54-6-8-72-49-38-51-29-11-19-16-14-34-2-13-70-40-47-43-39-63-68-60-50-56-59-22-31-10-9-64-25-3-55-30-41-7-0-62-71-20-46-27,148-97-90-86-144-120-77-95-100-89-133-87-93-136-78-105-83-140-108-149-85-119-114-127-122-126-98-101-110-103-112-129-124-139-84-146-94-125-81-115-143-137-138-96-142-79-121-88-132-147-92-130-109-76-116-134-131-111-106-80-107-128-123-117-118-91-141-104-113-75-145-102-99-135-82,286284138,35844,37889,73733
ls-nn,kroA150,57-66-74-65-69-21-48-5-53-1-12-32-36-4-67-24-18-52-15-17-23-37-35-58-73-44-61-26-42-45-28-33-54-6-8-72-49-38-51-29-11-19-16-14-34-2-13-70-40-47-43-39-63-68-60-50-56-59-22-31-10-9-64-25-3-55-30-41-7-0-62-71-20-46-27,148-97-90-86-144-120-77-95-100-89-133-87-93-136-78-105-83-140-108-149-85-119-114-127-122-126-98-101-110-103-112-129-124-139-84-146-94-125-81-115-143-137-138-96-142-79-121-88-132-147-92-130-109-76-116-134-131-111-106-80-107-128-123-117-118-91-141-104-113-75-145-102-99-135-82,286999048,35844,37889,73733
ls-nn,kroA150,57-66-74-65-69-21-48-5-53-1-12-32-36-4-67-24-18-52-15-17-23-37-35-58-73-44-61-26-42-45-28-33-54-6-8-72-49-38-51-29-11-19-16-14-34-2-13-70-40-47-43-39-63-68-60-50-56-59-22-31-10-9-64-25-3-55-30-41-7-0-62-71-20-46-27,148-97-90-86-144-120-77-95-100-89-133-87-93-136-78-105-83-140-108-149-85-119-114-127-122-126-98-101-110-103-112-129-124-139-84-146-94-125-81-115-143-137-138-96-142-79-121-88-132-147-92-130-109-76-116-134-131-111-106-80-107-128-123-117-118-91-141-104-113-75-145-102-99-135-82,273912491,35844,37889,73733
ls-nn,kroA150,57-66-74-65-69-21-48-5-53-1-12-32-36-4-67-24-18-52-15-17-23-37-35-58-73-44-61-26-42-45-28-33-54-6-8-72-49-38-51-29-11-19-16-14-34-2-13-70-40-47-43-39-63-68-60-50-56-59-22-31-10-9-64-25-3-55-30-41-7-0-62-71-20-46-27,148-97-90-86-144-120-77-95-100-89-133-87-93-136-78-105-83-140-108-149-85-119-114-127-122-126-98-101-110-103-112-129-124-139-84-146-94-125-81-115-143-137-138-96-142-79-121-88-132-147-92-130-109-76-116-134-131-111-106-80-107-128-123-117-118-91-141-104-113-75-145-102-99-135-82,291977700,35844,37889,73733
ls-nn,kroA150,57-66-74-65-69-21-48-5-53-1-12-32-36-4-67-24-18-52-15-17-23-37-35-58-73-44-61-26-42-45-28-33-54-6-8-72-49-38-51-29-11-19-16-14-34-2-13-70-40-47-43-39-63-68-60-50-56-59-22-31-10-9-64-25-3-55-30-41-7-0-62-71-20-46-27,148-97-90-86-144-120-77-95-100-89-133-87-93-136-78-105-83-140-108-149-85-119-114-127-122-126-98-101-110-103-112-129-124-139-84-146-94-125-81-115-143-137-138-96-142-79-121-88-132-147-92-130-109-76-116-134-131-111-106-80-107-128-123-117-118-91-141-104-113-75-145-102-99-135-82,298362279,35844,37889,73733
ls-nn,kroA150,57-66-74-65-69-21-48-5-53-1-12-32-36-4-67-24-18-52-15-17-23-37-35-58-73-44-61-26-42-45-28-33-54-6-8-72-49-38-51-29-11-19-16-14-34-2-13-70-40-47-43-39-63-68-60-50-56-59-22-31-10-9-64-25-3-55-30-41-7-0-62-71-20-46-27,148-97-90-86-144-120-77-95-100-89-133-87-93-136-78-105-83-140-108-149-85-119-114-127-122-126-98-101-110-103-112-129-124-139-84-146-94-125-81-115-143-137-138-96-142-79-121-88-132-147-92-130-109-76-116-134-131-111-106-80-107-128-123-117-118-91-141-104-113-75-145-102-99-135-82,274915044,35844,37889,73733
ls-nn,kroA150,57-66-74-65-69-21-48-5-53-1-12-32-36-4-67-24-18-52-15-17-23-37-35-58-73-44-61-26-42-45-28-33-54-6-8-72-49-38-51-29-11-19-16-14-34-2-13-70-40-47-43-39-63-68-60-50-56-59-22-31-10-9-64-25-3-55-30-41-7-0-62-71-20-46-27,148-97-90-86-144-120-77-95-100-89-133-87-93-136-78-105-83-140-108-149-85-119-114-127-122-126-98-101-110-103-112-129-124-139-84-146-94-125-81-115-143-137-138-96-142-79-121-88-132-147-92-130-109-76-116-134-131-111-106-80-107-128-123-117-118-91-141-104-113-75-145-102-99-135-82,277264035,35844,37889,73733
ls-nn,kroA150,57-66-74-65-69-21-48-5-53-1-12-32-36-4-67-24-18-52-15-17-23-37-35-58-73-44-61-26-42-45-28-33-54-6-8-72-49-38-51-29-11-19-16-14-34-2-13-70-40-47-43-39-63-68-60-50-56-59-22-31-10-9-64-25-3-55-30-41-7-0-62-71-20-46-27,148-97-90-86-144-120-77-95-100-89-133-87-93-136-78-105-83-140-108-149-85-119-114-127-122-126-98-101-110-103-112-129-124-139-84-146-94-125-81-115-143-137-138-96-142-79-121-88-132-147-92-130-109-76-116-134-131-111-106-80-107-128-123-117-118-91-141-104-113-75-145-102-99-135-82,273333253,35844,37889,73733
ls-nn,kroA150,57-66-74-65-69-21-48-5-53-1-12-32-36-4-67-24-18-52-15-17-23-37-35-58-73-44-61-26-42-45-28-33-54-6-8-72-49-38-51-29-11-19-16-14-34-2-13-70-40-47-43-39-63-68-60-50-56-59-22-31-10-9-64-25-3-55-30-41-7-0-62-71-20-46-27,148-97-90-86-144-120-77-95-100-89-133-87-93-136-78-105-83-140-108-149-85-119-114-127-122-126-98-101-110-103-112-129-124-139-84-146-94-125-81-115-143-137-138-96-142-79-121-88-132-147-92-130-109-76-116-134-131-111-106-80-107-128-123-117-118-91-141-104-113-75-145-102-99-135-82,274211602,35844,37889,73733
ls-nn,kroA150,57-66-74-65-69-21-48-5-53-1-12-32-36-4-67-24-18-52-15-17-23-37-35-58-73-44-61-26-42-45-28-33-54-6-8-72-49-38-51-29-11-19-16-14-34-2-13-70-40-47-43-39-63-68-60-50-56-59-22-31-10-9-64-25-3-55-30-41-7-0-62-71-20-46-27,148-97-90-86-144-120-77-95-100-89-133-87-93-136-78-105-83-140-108-149-85-119-114-127-122-126-98-101-110-103-112-129-124-139-84-146-94-125-81-115-143-137-138-96-142-79-121-88-132-147-92-130-109-76-116-134-131-111-106-80-107-128-123-117-118-91-141-104-113-75-145-102-99-135-82,272441960,35844,37889,73733
ls-nn,kroA150,57-66-74-65-69-21-48-5-53-1-12-32-36-4-67-24-18-52-15-17-23-37-35-58-73-44-61-26-42-45-28-33-54-6-8-72-49-38-51-29-11-19-16-14-34-2-13-70-40-47-43-39-63-68-60-50-56-59-22-31-10-9-64-25-3-55-30-41-7-0-62-71-20-46-27,148-97-90-86-144-120-77-95-100-89-133-87-93-136-78-105-83-140-108-149-85-119-114-127-122-126-98-101-110-103-112-129-124-139-84-146-94-125-81-115-143-137-138-96-142-79-121-88-132-147-92-130-109-76-116-134-131-111-106-80-107-128-123-117-118-91-141-104-113-75-145-102-99-135-82,276381179,35844,37889,73733
ls-nn,kroA150,57-66-74-65-69-21-48-5-53-1-12-32-36-4-67-24-18-52-15-17-23-37-35-58-73-44-61-26-42-45-28-33-54-6-8-72-49-38-51-29-11-19-16-14-34-2-13-70-40-47-43-39-63-68-60-50-56-59-22-31-10-9-64-25-3-55-30-41-7-0-62-71-20-46-27,148-97-90-86-144-120-77-95-100-89-133-87-93-136-78-105-83-140-108-149-85-119-114-127-122-126-98-101-110-103-112-129-124-139-84-146-94-125-81-115-143-137-138-96-142-79-121-88-132-147-92-130-109-76-116-134-131-111-106-80-107-128-123-117-118-91-141-104-113-75-145-102-99-135-82,278846933,35844,37889,73733
ls-nn,kroA150,57-66-74-65-69-21-48-5-53-1-12-32-36-4-67-24-18-52-15-17-23-37-35-58-73-44-61-26-42-45-28-33-54-6-8-72-49-38-51-29-11-19-16-14-34-2-13-70-40-47-43-39-63-68-60-50-56-59-22-31-10-9-64-25-3-55-30-41-7-0-62-71-20-46-27,148-97-90-86-144-120-77-95-100-89-133-87-93-136-78-105-83-140-108-149-85-119-114-127-122-126-98-101-110-103-112-129-124-139-84-146-94-125-81-115-143-137-138-96-142-79-121-88-132-147-92-130-109-76-116-134-131-111-106-80-107-128-123-117-118-91-141-104-113-75-145-102-99-135-82,278846112,35844,37889,73733
ls-nn,kroA150,57-66-74-65-69-21-48-5-53-1-12-32-36-4-67-24-18-52-15-17-23-37-35-58-73-44-61-26-42-45-28-33-54-6-8-72-49-38-51-29-11-19-16-14-34-2-13-70-40-47-43-39-63-68-60-50-56-59-22-31-10-9-64-25-3-55-30-41-7-0-62-71-20-46-27,148-97-90-86-144-120-77-95-100-89-133-87-93-136-78-105-83-140-108-149-85-119-114-127-122-126-98-101-110-103-112-129-124-139-84-146-94-125-81-115-143-137-138-96-142-79-121-88-132-147-92-130-109-76-116-134-131-111-106-80-107-128-123-117-118-91-141-104-113-75-145-102-99-135-82,271416264,35844,37889,73733
ls-nn,kroA150,57-66-74-65-69-21-48-5-53-1-12-32-36-4-67-24-18-52-15-17-23-37-35-58-73-44-61-26-42-45-28-33-54-6-8-72-49-38-51-29-11-19-16-14-34-2-13-70-40-47-43-39-63-68-60-50-56-59-22-31-10-9-64-25-3-55-30-41-7-0-62-71-20-46-27,148-97-90-86-144-120-77-95-100-89-133-87-93-136-78-105-83-140-108-149-85-119-114-127-122-126-98-101-110-103-112-129-124-139-84-146-94-125-81-115-143-137-138-96-142-79-121-88-132-147-92-130-109-76-116-134-131-111-106-80-107-128-123-117-118-91-141-104-113-75-145-102-99-135-82,274641882,35844,37889,73733
ls-nn,kroA150,57-66-74-65-69-21-48-5-53-1-12-32-36-4-67-24-18-52-15-17-23-37-35-58-73-44-61-26-42-45-28-33-54-6-8-72-49-38-51-29-11-19-16-14-34-2-13-70-40-47-43-39-63-68-60-50-56-59-22-31-10-9-64-25-3-55-30-41-7-0-62-71-20-46-27,148-97-90-86-144-120-77-95-100-89-133-87-93-136-78-105-83-140-108-149-85-119-114-127-122-126-98-101-110-103-112-129-124-139-84-146-94-125-81-115-143-137-138-96-142-79-121-88-132-147-92-130-109-76-116-134-131-111-106-80-107-128-123-117-118-91-141-104-113-75-145-102-99-135-82,273663128,35844,37889,73733
ls-nn,kroA150,57-66-74-65-69-21-48-5-53-1-12-32-36-4-67-24-18-52-15-17-23-37-35-58-73-44-61-26-42-45-28-33-54-6-8-72-49-38-51-29-11-19-16-14-34-2-13-70-40-47-43-39-63-68-60-50-56-59-22-31-10-9-64-25-3-55-30-41-7-0-62-71-20-46-27,148-97-90-86-144-120-77-95-100-89-133-87-93-136-78-105-83-140-108-149-85-119-114-127-122-126-98-101-110-103-112-129-124-139-84-146-94-125-81-115-143-137-138-96-142-79-121-88-132-147-92-130-109-76-116-134-131-111-106-80-107-128-123-117-118-91-141-104-113-75-145-102-99-135-82,279163276,35844,37889,73733
ls-nn,kroA150,57-66-74-65-69-21-48-5-53-1-12-32-36-4-67-24-18-52-15-17-23-37-35-58-73-44-61-26-42-45-28-33-54-6-8-72-49-38-51-29-11-19-16-14-34-2-13-70-40-47-43-39-63-68-60-50-56-59-22-31-10-9-64-25-3-55-30-41-7-0-62-71-20-46-27,148-97-90-86-144-120-77-95-100-89-133-87-93-136-78-105-83-140-108-149-85-119-114-127-122-126-98-101-110-103-112-129-124-139-84-146-94-125-81-115-143-137-138-96-142-79-121-88-132-147-92-130-109-76-116-134-131-111-106-80-107-128-123-117-118-91-141-104-113-75-145-102-99-135-82,273165836,35844,37889,73733
ls-nn,kroA150,57-66-74-65-69-21-48-5-53-1-12-32-36-4-67-24-18-52-15-17-23-37-35-58-73-44-61-26-42-45-28-33-54-6-8-72-49-38-51-29-11-19-16-14-34-2-13-70-40-47-43-39-63-68-60-50-56-59-22-31-10-9-64-25-3-55-30-41-7-0-62-71-20-46-27,148-97-90-86-144-120-77-95-100-89-133-87-93-136-78-105-83-140-108-149-85-119-114-127-122-126-98-101-110-103-112-129-124-139-84-146-94-125-81-115-143-137-138-96-142-79-121-88-132-147-92-130-109-76-116-134-131-111-106-80-107-128-123-117-118-91-141-104-113-75-145-102-99-135-82,277286166,35844,37889,73733
ls-nn,kroA150,57-66-74-65-69-21-48-5-53-1-12-32-36-4-67-24-18-52-15-17-23-37-35-58-73-44-61-26-42-45-28-33-54-6-8-72-49-38-51-29-11-19-16-14-34-2-13-70-40-47-43-39-63-68-60-50-56-59-22-31-10-9-64-25-3-55-30-41-7-0-62-71-20-46-27,148-97-90-86-144-120-77-95-100-89-133-87-93-136-78-105-83-140-108-149-85-119-114-127-122-126-98-101-110-103-112-129-124-139-84-146-94-125-81-115-143-137-138-96-142-79-121-88-132-147-92-130-109-76-116-134-131-111-106-80-107-128-123-117-118-91-141-104-113-75-145-102-99-135-82,272889383,35844,37889,73733
ls-nn,kroA150,57-66-74-65-69-21-48-5-53-1-12-32-36-4-67-24-18-52-15-17-23-37-35-58-73-44-61-26-42-45-28-33-54-6-8-72-49-38-51-29-11-19-16-14-34-2-13-70-40-47-43-39-63-68-60-50-56-59-22-31-10-9-64-25-3-55-30-41-7-0-62-71-20-46-27,148-97-90-86-144-120-77-95-100-89-133-87-93-136-78-105-83-140-108-149-85-119-114-127-122-126-98-101-110-103-112-129-124-139-84-146-94-125-81-115-143-137-138-96-142-79-121-88-132-147-92-130-109-76-116-134-131-111-106-80-107-128-123-117-118-91-141-104-113-75-145-102-99-135-82,274227658,35844,37889,73733
ls-nn,kroA150,57-66-74-65-69-21-48-5-53-1-12-32-36-4-67-24-18-52-15-17-23-37-35-58-73-44-61-26-42-45-28-33-54-6-8-72-49-38-51-29-11-19-16-14-34-2-13-70-40-47-43-39-63-68-60-50-56-59-22-31-10-9-64-25-3-55-30-41-7-0-62-71-20-46-27,148-97-90-86-144-120-77-95-100-89-133-87-93-136-78-105-83-140-108-149-85-119-114-127-122-126-98-101-110-103-112-129-124-139-84-146-94-125-81-115-143-137-138-96-142-79-121-88-132-147-92-130-109-76-116-134-131-111-106-80-107-128-123-117-118-91-141-104-113-75-145-102-99-135-82,279031149,35844,37889,73733
ls-nn,kroA150,57-66-74-65-69-21-48-5-53-1-12-32-36-4-67-24-18-52-15-17-23-37-35-58-73-44-61-26-42-45-28-33-54-6-8-72-49-38-51-29-11-19-16-14-34-2-13-70-40-47-43-39-63-68-60-50-56-59-22-31-10-9-64-25-3-55-30-41-7-0-62-71-20-46-27,148-97-90-86-144-120-77-95-100-89-133-87-93-136-78-105-83-140-108-149-85-119-114-127-122-126-98-101-110-103-112-129-124-139-84-146-94-125-81-115-143-137-138-96-142-79-121-88-132-147-92-130-109-76-116-134-131-111-106-80-107-128-123-117-118-91-141-104-113-75-145-102-99-135-82,278620144,35844,37889,73733
ls-nn,kroA150,57-66-74-65-69-21-48-5-53-1-12-32-36-4-67-24-18-52-15-17-23-37-35-58-73-44-61-26-42-45-28-33-54-6-8-72-49-38-51-29-11-19-16-14-34-2-13-70-40-47-43-39-63-68-60-50-56-59-22-31-10-9-64-25-3-55-30-41-7-0-62-71-20-46-27,148-97-90-86-144-120-77-95-100-89-133-87-93-136-78-105-83-140-108-149-85-119-114-127-122-126-98-101-110-103-112-129-124-139-84-146-94-125-81-115-143-137-138-96-142-79-121-88-132-147-92-130-109-76-116-134-131-111-106-80-107-128-123-117-118-91-141-104-113-75-145-102-99-135-82,280866356,35844,37889,73733
ls-nn,kroA150,57-66-74-65-69-21-48-5-53-1-12-32-36-4-67-24-18-52-15-17-23-37-35-58-73-44-61-26-42-45-28-33-54-6-8-72-49-38-51-29-11-19-16-14-34-2-13-70-40-47-43-39-63-68-60-50-56-59-22-31-10-9-64-25-3-55-30-41-7-0-62-71-20-46-27,148-97-90-86-144-120-77-95-100-89-133-87-93-136-78-105-83-140-108-149-85-119-114-127-122-126-98-101-110-103-112-129-124-139-84-146-94-125-81-115-143-137-138-96-142-79-121-88-132-147-92-130-109-76-116-134-131-111-106-80-107-128-123-117-118-91-141-104-113-75-145-102-99-135-82,275743157,35844,37889,73733
ls-nn,kroA150,57-66-74-65-69-21-48-5-53-1-12-32-36-4-67-24-18-52-15-17-23-37-35-58-73-44-61-26-42-45-28-33-54-6-8-72-49-38-51-29-11-19-16-14-34-2-13-70-40-47-43-39-63-68-60-50-56-59-22-31-10-9-64-25-3-55-30-41-7-0-62-71-20-46-27,148-97-90-86-144-120-77-95-100-89-133-87-93-136-78-105-83-140-108-149-85-119-114-127-122-126-98-101-110-103-112-129-124-139-84-146-94-125-81-115-143-137-138-96-142-79-121-88-132-147-92-130-109-76-116-134-131-111-106-80-107-128-123-117-118-91-141-104-113-75-145-102-99-135-82,276772810,35844,37889,73733
ls-nn,kroA150,57-66-74-65-69-21-48-5-53-1-12-32-36-4-67-24-18-52-15-17-23-37-35-58-73-44-61-26-42-45-28-33-54-6-8-72-49-38-51-29-11-19-16-14-34-2-13-70-40-47-43-39-63-68-60-50-56-59-22-31-10-9-64-25-3-55-30-41-7-0-62-71-20-46-27,148-97-90-86-144-120-77-95-100-89-133-87-93-136-78-105-83-140-108-149-85-119-114-127-122-126-98-101-110-103-112-129-124-139-84-146-94-125-81-115-143-137-138-96-142-79-121-88-132-147-92-130-109-76-116-134-131-111-106-80-107-128-123-117-118-91-141-104-113-75-145-102-99-135-82,277745811,35844,37889,73733
ls-nn,kroA150,57-66-74-65-69-21-48-5-53-1-12-32-36-4-67-24-18-52-15-17-23-37-35-58-73-44-61-26-42-45-28-33-54-6-8-72-49-38-51-29-11-19-16-14-34-2-13-70-40-47-43-39-63-68-60-50-56-59-22-31-10-9-64-25-3-55-30-41-7-0-62-71-20-46-27,148-97-90-86-144-120-77-95-100-89-133-87-93-136-78-105-83-140-108-149-85-119-114-127-122-126-98-101-110-103-112-129-124-139-84-146-94-125-81-115-143-137-138-96-142-79-121-88-132-147-92-130-109-76-116-134-131-111-106-80-107-128-123-117-118-91-141-104-113-75-145-102-99-135-82,277756123,35844,37889,73733
ls-nn,kroA150,57-66-74-65-69-21-48-5-53-1-12-32-36-4-67-24-18-52-15-17-23-37-35-58-73-44-61-26-42-45-28-33-54-6-8-72-49-38-51-29-11-19-16-14-34-2-13-70-40-47-43-39-63-68-60-50-56-59-22-31-10-9-64-25-3-55-30-41-7-0-62-71-20-46-27,148-97-90-86-144-120-77-95-100-89-133-87-93-136-78-105-83-140-108-149-85-119-114-127-122-126-98-101-110-103-112-129-124-139-84-146-94-125-81-115-143-137-138-96-142-79-121-88-132-147-92-130-109-76-116-134-131-111-106-80-107-128-123-117-118-91-141-104-113-75-145-102-99-135-82,276446158,35844,37889,73733
ls-nn,kroA150,57-66-74-65-69-21-48-5-53-1-12-32-36-4-67-24-18-52-15-17-23-37-35-58-73-44-61-26-42-45-28-33-54-6-8-72-49-38-51-29-11-19-16-14-34-2-13-70-40-47-43-39-63-68-60-50-56-59-22-31-10-9-64-25-3-55-30-41-7-0-62-71-20-46-27,148-97-90-86-144-120-77-95-100-89-133-87-93-136-78-105-83-140-108-149-85-119-114-127-122-126-98-101-110-103-112-129-124-139-84-146-94-125-81-115-143-137-138-96-142-79-121-88-132-147-92-130-109-76-116-134-131-111-106-80-107-128-123-117-118-91-141-104-113-75-145-102-99-135-82,303238603,35844,37889,73733
ls-nn,kroA150,57-66-74-65-69-21-48-5-53-1-12-32-36-4-67-24-18-52-15-17-23-37-35-58-73-44-61-26-42-45-28-33-54-6-8-72-49-38-51-29-11-19-16-14-34-2-13-70-40-47-43-39-63-68-60-50-56-59-22-31-10-9-64-25-3-55-30-41-7-0-62-71-20-46-27,148-97-90-86-144-120-77-95-100-89-133-87-93-136-78-105-83-140-108-149-85-119-114-127-122-126-98-101-110-103-112-129-124-139-84-146-94-125-81-115-143-137-138-96-142-79-121-88-132-147-92-130-109-76-116-134-131-111-106-80-107-128-123-117-118-91-141-104-113-75-145-102-99-135-82,275441631,35844,37889,73733
ls-nn,kroA150,57-66-74-65-69-21-48-5-53-1-12-32-36-4-67-24-18-52-15-17-23-37-35-58-73-44-61-26-42-45-28-33-54-6-8-72-49-38-51-29-11-19-16-14-34-2-13-70-40-47-43-39-63-68-60-50-56-59-22-31-10-9-64-25-3-55-30-41-7-0-62-71-20-46-27,148-97-90-86-144-120-77-95-100-89-133-87-93-136-78-105-83-140-108-149-85-119-114-127-122-126-98-101-110-103-112-129-124-139-84-146-94-125-81-115-143-137-138-96-142-79-121-88-132-147-92-130-109-76-116-134-131-111-106-80-107-128-123-117-118-91-141-104-113-75-145-102-99-135-82,275683440,35844,37889,73733
ls-nn,kroA150,57-66-74-65-69-21-48-5-53-1-12-32-36-4-67-24-18-52-15-17-23-37-35-58-73-44-61-26-42-45-28-33-54-6-8-72-49-38-51-29-11-19-16-14-34-2-13-70-40-47-43-39-63-68-60-50-56-59-22-31-10-9-64-25-3-55-30-41-7-0-62-71-20-46-27,148-97-90-86-144-120-77-95-100-89-133-87-93-136-78-105-83-140-108-149-85-119-114-127-122-126-98-101-110-103-112-129-124-139-84-146-94-125-81-115-143-137-138-96-142-79-121-88-132-147-92-130-109-76-116-134-131-111-106-80-107-128-123-117-118-91-141-104-113-75-145-102-99-135-82,273157889,35844,37889,73733
ls-nn,kroA150,57-66-74-65-69-21-48-5-53-1-12-32-36-4-67-24-18-52-15-17-23-37-35-58-73-44-61-26-42-45-28-33-54-6-8-72-49-38-51-29-11-19-16-14-34-2-13-70-40-47-43-39-63-68-60-50-56-59-22-31-10-9-64-25-3-55-30-41-7-0-62-71-20-46-27,148-97-90-86-144-120-77-95-100-89-133-87-93-136-78-105-83-140-108-149-85-119-114-127-122-126-98-101-110-103-112-129-124-139-84-146-94-125-81-115-143-137-138-96-142-79-121-88-132-147-92-130-109-76-116-134-131-111-106-80-107-128-123-117-118-91-141-104-113-75-145-102-99-135-82,280582502,35844,37889,73733
ls-nn,kroA150,57-66-74-65-69-21-48-5-53-1-12-32-36-4-67-24-18-52-15-17-23-37-35-58-73-44-61-26-42-45-28-33-54-6-8-72-49-38-51-29-11-19-16-14-34-2-13-70-40-47-43-39-63-68-60-50-56-59-22-31-10-9-64-25-3-55-30-41-7-0-62-71-20-46-27,148-97-90-86-144-120-77-95-100-89-133-87-93-136-78-105-83-140-108-149-85-119-114-127-122-126-98-101-110-103-112-129-124-139-84-146-94-125-81-115-143-137-138-96-142-79-121-88-132-147-92-130-109-76-116-134-131-111-106-80-107-128-123-117-118-91-141-104-113-75-145-102-99-135-82,306961980,35844,37889,73733
ls-nn,kroA150,57-66-74-65-69-21-48-5-53-1-12-32-36-4-67-24-18-52-15-17-23-37-35-58-73-44-61-26-42-45-28-33-54-6-8-72-49-38-51-29-11-19-16-14-34-2-13-70-40-47-43-39-63-68-60-50-56-59-22-31-10-9-64-25-3-55-30-41-7-0-62-71-20-46-27,148-97-90-86-144-120-77-95-100-89-133-87-93-136-78-105-83-140-108-149-85-119-114-127-122-126-98-101-110-103-112-129-124-139-84-146-94-125-81-115-143-137-138-96-142-79-121-88-132-147-92-130-109-76-116-134-131-111-106-80-107-128-123-117-118-91-141-104-113-75-145-102-99-135-82,287282646,35844,37889,73733
ls-nn,kroA150,57-66-74-65-69-21-48-5-53-1-12-32-36-4-67-24-18-52-15-17-23-37-35-58-73-44-61-26-42-45-28-33-54-6-8-72-49-38-51-29-11-19-16-14-34-2-13-70-40-47-43-39-63-68-60-50-56-59-22-31-10-9-64-25-3-55-30-41-7-0-62-71-20-46-27,148-97-90-86-144-120-77-95-100-89-133-87-93-136-78-105-83-140-108-149-85-119-114-127-122-126-98-101-110-103-112-129-124-139-84-146-94-125-81-115-143-137-138-96-142-79-121-88-132-147-92-130-109-76-116-134-131-111-106-80-107-128-123-117-118-91-141-104-113-75-145-102-99-135-82,289014588,35844,37889,73733
ls-nn,kroA150,57-66-74-65-69-21-48-5-53-1-12-32-36-4-67-24-18-52-15-17-23-37-35-58-73-44-61-26-42-45-28-33-54-6-8-72-49-38-51-29-11-19-16-14-34-2-13-70-40-47-43-39-63-68-60-50-56-59-22-31-10-9-64-25-3-55-30-41-7-0-62-71-20-46-27,148-97-90-86-144-120-77-95-100-89-133-87-93-136-78-105-83-140-108-149-85-119-114-127-122-126-98-101-110-103-112-129-124-139-84-146-94-125-81-115-143-137-138-96-142-79-121-88-132-147-92-130-109-76-116-134-131-111-106-80-107-128-123-117-118-91-141-104-113-75-145-102-99-135-82,298106965,35844,37889,73733
ls-nn,kroA150,57-66-74-65-69-21-48-5-53-1-12-32-36-4-67-24-18-52-15-17-23-37-35-58-73-44-61-26-42-45-28-33-54-6-8-72-49-38-51-29-11-19-16-14-34-2-13-70-40-47-43-39-63-68-60-50-56-59-22-31-10-9-64-25-3-55-30-41-7-0-62-71-20-46-27,148-97-90-86-144-120-77-95-100-89-133-87-93-136-78-105-83-140-108-149-85-119-114-127-122-126-98-101-110-103-112-129-124-139-84-146-94-125-81-115-143-137-138-96-142-79-121-88-132-147-92-130-109-76-116-134-131-111-106-80-107-128-123-117-118-91-141-104-113-75-145-102-99-135-82,279775124,35844,37889,73733
ls-nn,kroA150,57-66-74-65-69-21-48-5-53-1-12-32-36-4-67-24-18-52-15-17-23-37-35-58-73-44-61-26-42-45-28-33-54-6-8-72-49-38-51-29-11-19-16-14-34-2-13-70-40-47-43-39-63-68-60-50-56-59-22-31-10-9-64-25-3-55-30-41-7-0-62-71-20-46-27,148-97-90-86-144-120-77-95-100-89-133-87-93-136-78-105-83-140-108-149-85-119-114-127-122-126-98-101-110-103-112-129-124-139-84-146-94-125-81-115-143-137-138-96-142-79-121-88-132-147-92-130-109-76-116-134-131-111-106-80-107-128-123-117-118-91-141-104-113-75-145-102-99-135-82,277225354,35844,37889,73733
ls-nn,kroA150,57-66-74-65-69-21-48-5-53-1-12-32-36-4-67-24-18-52-15-17-23-37-35-58-73-44-61-26-42-45-28-33-54-6-8-72-49-38-51-29-11-19-16-14-34-2-13-70-40-47-43-39-63-68-60-50-56-59-22-31-10-9-64-25-3-55-30-41-7-0-62-71-20-46-27,148-97-90-86-144-120-77-95-100-89-133-87-93-136-78-105-83-140-108-149-85-119-114-127-122-126-98-101-110-103-112-129-124-139-84-146-94-125-81-115-143-137-138-96-142-79-121-88-132-147-92-130-109-76-116-134-131-111-106-80-107-128-123-117-118-91-141-104-113-75-145-102-99-135-82,277394491,35844,37889,73733
ls-nn,kroA150,57-66-74-65-69-21-48-5-53-1-12-32-36-4-67-24-18-52-15-17-23-37-35-58-73-44-61-26-42-45-28-33-54-6-8-72-49-38-51-29-11-19-16-14-34-2-13-70-40-47-43-39-63-68-60-50-56-59-22-31-10-9-64-25-3-55-30-41-7-0-62-71-20-46-27,148-97-90-86-144-120-77-95-100-89-133-87-93-136-78-105-83-140-108-149-85-119-114-127-122-126-98-101-110-103-112-129-124-139-84-146-94-125-81-115-143-137-138-96-142-79-121-88-132-147-92-130-109-76-116-134-131-111-106-80-107-128-123-117-118-91-141-104-113-75-145-102-99-135-82,296909331,35844,37889,73733
ls-nn,kroA150,57-66-74-65-69-21-48-5-53-1-12-32-36-4-67-24-18-52-15-17-23-37-35-58-73-44-61-26-42-45-28-33-54-6-8-72-49-38-51-29-11-19-16-14-34-2-13-70-40-47-43-39-63-68-60-50-56-59-22-31-10-9-64-25-3-55-30-41-7-0-62-71-20-46-27,148-97-90-86-144-120-77-95-100-89-133-87-93-136-78-105-83-140-108-149-85-119-114-127-122-126-98-101-110-103-112-129-124-139-84-146-94-125-81-115-143-137-138-96-142-79-121-88-132-147-92-130-109-76-116-134-131-111-106-80-107-128-123-117-118-91-141-104-113-75-145-102-99-135-82,287383002,35844,37889,73733
ls-nn,kroA150,57-66-74-65-69-21-48-5-53-1-12-32-36-4-67-24-18-52-15-17-23-37-35-58-73-44-61-26-42-45-28-33-54-6-8-72-49-38-51-29-11-19-16-14-34-2-13-70-40-47-43-39-63-68-60-50-56-59-22-31-10-9-64-25-3-55-30-41-7-0-62-71-20-46-27,148-97-90-86-144-120-77-95-100-89-133-87-93-136-78-105-83-140-108-149-85-119-114-127-122-126-98-101-110-103-112-129-124-139-84-146-94-125-81-115-143-137-138-96-142-79-121-88-132-147-92-130-109-76-116-134-131-111-106-80-107-128-123-117-118-91-141-104-113-75-145-102-99-135-82,282782381,35844,37889,73733
ls-nn,kroA150,57-66-74-65-69-21-48-5-53-1-12-32-36-4-67-24-18-52-15-17-23-37-35-58-73-44-61-26-42-45-28-33-54-6-8-72-49-38-51-29-11-19-16-14-34-2-13-70-40-47-43-39-63-68-60-50-56-59-22-31-10-9-64-25-3-55-30-41-7-0-62-71-20-46-27,148-97-90-86-144-120-77-95-100-89-133-87-93-136-78-105-83-140-108-149-85-119-114-127-122-126-98-101-110-103-112-129-124-139-84-146-94-125-81-115-143-137-138-96-142-79-121-88-132-147-92-130-109-76-116-134-131-111-106-80-107-128-123-117-118-91-141-104-113-75-145-102-99-135-82,273610493,35844,37889,73733
ls-nn,kroA150,57-66-74-65-69-21-48-5-53-1-12-32-36-4-67-24-18-52-15-17-23-37-35-58-73-44-61-26-42-45-28-33-54-6-8-72-49-38-51-29-11-19-16-14-34-2-13-70-40-47-43-39-63-68-60-50-56-59-22-31-10-9-64-25-3-55-30-41-7-0-62-71-20-46-27,148-97-90-86-144-120-77-95-100-89-133-87-93-136-78-105-83-140-108-149-85-119-114-127-122-126-98-101-110-103-112-129-124-139-84-146-94-125-81-115-143-137-138-96-142-79-121-88-132-147-92-130-109-76-116-134-131-111-106-80-107-128-123-117-118-91-141-104-113-75-145-102-99-135-82,278340742,35844,37889,73733
ls-nn,kroA150,57-66-74-65-69-21-48-5-53-1-12-32-36-4-67-24-18-52-15-17-23-37-35-58-73-44-61-26-42-45-28-33-54-6-8-72-49-38-51-29-11-19-16-14-34-2-13-70-40-47-43-39-63-68-60-50-56-59-22-31-10-9-64-25-3-55-30-41-7-0-62-71-20-46-27,148-97-90-86-144-120-77-95-100-89-133-87-93-136-78-105-83-140-108-149-85-119-114-127-122-126-98-101-110-103-112-129-124-139-84-146-94-125-81-115-143-137-138-96-142-79-121-88-132-147-92-130-109-76-116-134-131-111-106-80-107-128-123-117-118-91-141-104-113-75-145-102-99-135-82,314174419,35844,37889,73733
ls-nn,kroA150,57-66-74-65-69-21-48-5-53-1-12-32-36-4-67-24-18-52-15-17-23-37-35-58-73-44-61-26-42-45-28-33-54-6-8-72-49-38-51-29-11-19-16-14-34-2-13-70-40-47-43-39-63-68-60-50-56-59-22-31-10-9-64-25-3-55-30-41-7-0-62-71-20-46-27,148-97-90-86-144-120-77-95-100-89-133-87-93-136-78-105-83-140-108-149-85-119-114-127-122-126-98-101-110-103-112-129-124-139-84-146-94-125-81-115-143-137-138-96-142-79-121-88-132-147-92-130-109-76-116-134-131-111-106-80-107-128-123-117-118-91-141-104-113-75-145-102-99-135-82,272994387,35844,37889,73733
ls-nn,kroA150,57-66-74-65-69-21-48-5-53-1-12-32-36-4-67-24-18-52-15-17-23-37-35-58-73-44-61-26-42-45-28-33-54-6-8-72-49-38-51-29-11-19-16-14-34-2-13-70-40-47-43-39-63-68-60-50-56-59-22-31-10-9-64-25-3-55-30-41-7-0-62-71-20-46-27,148-97-90-86-144-120-77-95-100-89-133-87-93-136-78-105-83-140-108-149-85-119-114-127-122-126-98-101-110-103-112-129-124-139-84-146-94-125-81-115-143-137-138-96-142-79-121-88-132-147-92-130-109-76-116-134-131-111-106-80-107-128-123-117-118-91-141-104-113-75-145-102-99-135-82,276117796,35844,37889,73733
ls-nn,kroA150,57-66-74-65-69-21-48-5-53-1-12-32-36-4-67-24-18-52-15-17-23-37-35-58-73-44-61-26-42-45-28-33-54-6-8-72-49-38-51-29-11-19-16-14-34-2-13-70-40-47-43-39-63-68-60-50-56-59-22-31-10-9-64-25-3-55-30-41-7-0-62-71-20-46-27,148-97-90-86-144-120-77-95-100-89-133-87-93-136-78-105-83-140-108-149-85-119-114-127-122-126-98-101-110-103-112-129-124-139-84-146-94-125-81-115-143-137-138-96-142-79-121-88-132-147-92-130-109-76-116-134-131-111-106-80-107-128-123-117-118-91-141-104-113-75-145-102-99-135-82,291480924,35844,37889,73733
ls-nn,kroA150,57-66-74-65-69-21-48-5-53-1-12-32-36-4-67-24-18-52-15-17-23-37-35-58-73-44-61-26-42-45-28-33-54-6-8-72-49-38-51-29-11-19-16-14-34-2-13-70-40-47-43-39-63-68-60-50-56-59-22-31-10-9-64-25-3-55-30-41-7-0-62-71-20-46-27,148-97-90-86-144-120-77-95-100-89-133-87-93-136-78-105-83-140-108-149-85-119-114-127-122-126-98-101-110-103-112-129-124-139-84-146-94-125-81-115-143-137-138-96-142-79-121-88-132-147-92-130-109-76-116-134-131-111-106-80-107-128-123-117-118-91-141-104-113-75-145-102-99-135-82,286611269,35844,37889,73733
ls-nn,kroA150,57-66-74-65-69-21-48-5-53-1-12-32-36-4-67-24-18-52-15-17-23-37-35-58-73-44-61-26-42-45-28-33-54-6-8-72-49-38-51-29-11-19-16-14-34-2-13-70-40-47-43-39-63-68-60-50-56-59-22-31-10-9-64-25-3-55-30-41-7-0-62-71-20-46-27,148-97-90-86-144-120-77-95-100-89-133-87-93-136-78-105-83-140-108-149-85-119-114-127-122-126-98-101-110-103-112-129-124-139-84-146-94-125-81-115-143-137-138-96-142-79-121-88-132-147-92-130-109-76-116-134-131-111-106-80-107-128-123-117-118-91-141-104-113-75-145-102-99-135-82,292520146,35844,37889,73733
ls-nn,kroA150,57-66-74-65-69-21-48-5-53-1-12-32-36-4-67-24-18-52-15-17-23-37-35-58-73-44-61-26-42-45-28-33-54-6-8-72-49-38-51-29-11-19-16-14-34-2-13-70-40-47-43-39-63-68-60-50-56-59-22-31-10-9-64-25-3-55-30-41-7-0-62-71-20-46-27,148-97-90-86-144-120-77-95-100-89-133-87-93-136-78-105-83-140-108-149-85-119-114-127-122-126-98-101-110-103-112-129-124-139-84-146-94-125-81-115-143-137-138-96-142-79-121-88-132-147-92-130-109-76-116-134-131-111-106-80-107-128-123-117-118-91-141-104-113-75-145-102-99-135-82,286936729,35844,37889,73733
ls-nn,kroA150,57-66-74-65-69-21-48-5-53-1-12-32-36-4-67-24-18-52-15-17-23-37-35-58-73-44-61-26-42-45-28-33-54-6-8-72-49-38-51-29-11-19-16-14-34-2-13-70-40-47-43-39-63-68-60-50-56-59-22-31-10-9-64-25-3-55-30-41-7-0-62-71-20-46-27,148-97-90-86-144-120-77-95-100-89-133-87-93-136-78-105-83-140-108-149-85-119-114-127-122-126-98-101-110-103-112-129-124-139-84-146-94-125-81-115-143-137-138-96-142-79-121-88-132-147-92-130-109-76-116-134-131-111-106-80-107-128-123-117-118-91-141-104-113-75-145-102-99-135-82,284738954,35844,37889,73733
ls-nn,kroA150,57-66-74-65-69-21-48-5-53-1-12-32-36-4-67-24-18-52-15-17-23-37-35-58-73-44-61-26-42-45-28-33-54-6-8-72-49-38-51-29-11-19-16-14-34-2-13-70-40-47-43-39-63-68-60-50-56-59-22-31-10-9-64-25-3-55-30-41-7-0-62-71-20-46-27,148-97-90-86-144-120-77-95-100-89-133-87-93-136-78-105-83-140-108-149-85-119-114-127-122-126-98-101-110-103-112-129-124-139-84-146-94-125-81-115-143-137-138-96-142-79-121-88-132-147-92-130-109-76-116-134-131-111-106-80-107-128-123-117-118-91-141-104-113-75-145-102-99-135-82,285105760,35844,37889,73733
ls-nn,kroA150,57-66-74-65-69-21-48-5-53-1-12-32-36-4-67-24-18-52-15-17-23-37-35-58-73-44-61-26-42-45-28-33-54-6-8-72-49-38-51-29-11-19-16-14-34-2-13-70-40-47-43-39-63-68-60-50-56-59-22-31-10-9-64-25-3-55-30-41-7-0-62-71-20-46-27,148-97-90-86-144-120-77-95-100-89-133-87-93-136-78-105-83-140-108-149-85-119-114-127-122-126-98-101-110-103-112-129-124-139-84-146-94-125-81-115-143-137-138-96-142-79-121-88-132-147-92-130-109-76-116-134-131-111-106-80-107-128-123-117-118-91-141-104-113-75-145-102-99-135-82,283241421,35844,37889,73733
ls-nn,kroA150,57-66-74-65-69-21-48-5-53-1-12-32-36-4-67-24-18-52-15-17-23-37-35-58-73-44-61-26-42-45-28-33-54-6-8-72-49-38-51-29-11-19-16-14-34-2-13-70-40-47-43-39-63-68-60-50-56-59-22-31-10-9-64-25-3-55-30-41-7-0-62-71-20-46-27,148-97-90-86-144-120-77-95-100-89-133-87-93-136-78-105-83-140-108-149-85-119-114-127-122-126-98-101-110-103-112-129-124-139-84-146-94-125-81-115-143-137-138-96-142-79-121-88-132-147-92-130-109-76-116-134-131-111-106-80-107-128-123-117-118-91-141-104-113-75-145-102-99-135-82,284618865,35844,37889,73733
ls-nn,kroA150,57-66-74-65-69-21-48-5-53-1-12-32-36-4-67-24-18-52-15-17-23-37-35-58-73-44-61-26-42-45-28-33-54-6-8-72-49-38-51-29-11-19-16-14-34-2-13-70-40-47-43-39-63-68-60-50-56-59-22-31-10-9-64-25-3-55-30-41-7-0-62-71-20-46-27,148-97-90-86-144-120-77-95-100-89-133-87-93-136-78-105-83-140-108-149-85-119-114-127-122-126-98-101-110-103-112-129-124-139-84-146-94-125-81-115-143-137-138-96-142-79-121-88-132-147-92-130-109-76-116-134-131-111-106-80-107-128-123-117-118-91-141-104-113-75-145-102-99-135-82,296781052,35844,37889,73733
ls-nn,kroA150,57-66-74-65-69-21-48-5-53-1-12-32-36-4-67-24-18-52-15-17-23-37-35-58-73-44-61-26-42-45-28-33-54-6-8-72-49-38-51-29-11-19-16-14-34-2-13-70-40-47-43-39-63-68-60-50-56-59-22-31-10-9-64-25-3-55-30-41-7-0-62-71-20-46-27,148-97-90-86-144-120-77-95-100-89-133-87-93-136-78-105-83-140-108-149-85-119-114-127-122-126-98-101-110-103-112-129-124-139-84-146-94-125-81-115-143-137-138-96-142-79-121-88-132-147-92-130-109-76-116-134-131-111-106-80-107-128-123-117-118-91-141-104-113-75-145-102-99-135-82,306393624,35844,37889,73733
ls-nn,kroA150,57-66-74-65-69-21-48-5-53-1-12-32-36-4-67-24-18-52-15-17-23-37-35-58-73-44-61-26-42-45-28-33-54-6-8-72-49-38-51-29-11-19-16-14-34-2-13-70-40-47-43-39-63-68-60-50-56-59-22-31-10-9-64-25-3-55-30-41-7-0-62-71-20-46-27,148-97-90-86-144-120-77-95-100-89-133-87-93-136-78-105-83-140-108-149-85-119-114-127-122-126-98-101-110-103-112-129-124-139-84-146-94-125-81-115-143-137-138-96-142-79-121-88-132-147-92-130-109-76-116-134-131-111-106-80-107-128-123-117-118-91-141-104-113-75-145-102-99-135-82,292643420,35844,37889,73733
ls-nn,kroA150,57-66-74-65-69-21-48-5-53-1-12-32-36-4-67-24-18-52-15-17-23-37-35-58-73-44-61-26-42-45-28-33-54-6-8-72-49-38-51-29-11-19-16-14-34-2-13-70-40-47-43-39-63-68-60-50-56-59-22-31-10-9-64-25-3-55-30-41-7-0-62-71-20-46-27,148-97-90-86-144-120-77-95-100-89-133-87-93-136-78-105-83-140-108-149-85-119-114-127-122-126-98-101-110-103-112-129-124-139-84-146-94-125-81-115-143-137-138-96-142-79-121-88-132-147-92-130-109-76-116-134-131-111-106-80-107-128-123-117-118-91-141-104-113-75-145-102-99-135-82,289416314,35844,37889,73733
ls-nn,kroA150,57-66-74-65-69-21-48-5-53-1-12-32-36-4-67-24-18-52-15-17-23-37-35-58-73-44-61-26-42-45-28-33-54-6-8-72-49-38-51-29-11-19-16-14-34-2-13-70-40-47-43-39-63-68-60-50-56-59-22-31-10-9-64-25-3-55-30-41-7-0-62-71-20-46-27,148-97-90-86-144-120-77-95-100-89-133-87-93-136-78-105-83-140-108-149-85-119-114-127-122-126-98-101-110-103-112-129-124-139-84-146-94-125-81-115-143-137-138-96-142-79-121-88-132-147-92-130-109-76-116-134-131-111-106-80-107-128-123-117-118-91-141-104-113-75-145-102-99-135-82,293334313,35844,37889,73733
ls-nn,kroA150,57-66-74-65-69-21-48-5-53-1-12-32-36-4-67-24-18-52-15-17-23-37-35-58-73-44-61-26-42-45-28-33-54-6-8-72-49-38-51-29-11-19-16-14-34-2-13-70-40-47-43-39-63-68-60-50-56-59-22-31-10-9-64-25-3-55-30-41-7-0-62-71-20-46-27,148-97-90-86-144-120-77-95-100-89-133-87-93-136-78-105-83-140-108-149-85-119-114-127-122-126-98-101-110-103-112-129-124-139-84-146-94-125-81-115-143-137-138-96-142-79-121-88-132-147-92-130-109-76-116-134-131-111-106-80-107-128-123-117-118-91-141-104-113-75-145-102-99-135-82,284832011,35844,37889,73733
ls-nn,kroA150,57-66-74-65-69-21-48-5-53-1-12-32-36-4-67-24-18-52-15-17-23-37-35-58-73-44-61-26-42-45-28-33-54-6-8-72-49-38-51-29-11-19-16-14-34-2-13-70-40-47-43-39-63-68-60-50-56-59-22-31-10-9-64-25-3-55-30-41-7-0-62-71-20-46-27,148-97-90-86-144-120-77-95-100-89-133-87-93-136-78-105-83-140-108-149-85-119-114-127-122-126-98-101-110-103-112-129-124-139-84-146-94-125-81-115-143-137-138-96-142-79-121-88-132-147-92-130-109-76-116-134-131-111-106-80-107-128-123-117-118-91-141-104-113-75-145-102-99-135-82,294883737,35844,37889,73733
ls-nn,kroA150,57-66-74-65-69-21-48-5-53-1-12-32-36-4-67-24-18-52-15-17-23-37-35-58-73-44-61-26-42-45-28-33-54-6-8-72-49-38-51-29-11-19-16-14-34-2-13-70-40-47-43-39-63-68-60-50-56-59-22-31-10-9-64-25-3-55-30-41-7-0-62-71-20-46-27,148-97-90-86-144-120-77-95-100-89-133-87-93-136-78-105-83-140-108-149-85-119-114-127-122-126-98-101-110-103-112-129-124-139-84-146-94-125-81-115-143-137-138-96-142-79-121-88-132-147-92-130-109-76-116-134-131-111-106-80-107-128-123-117-118-91-141-104-113-75-145-102-99-135-82,290644827,35844,37889,73733
ls-nn,kroA150,57-66-74-65-69-21-48-5-53-1-12-32-36-4-67-24-18-52-15-17-23-37-35-58-73-44-61-26-42-45-28-33-54-6-8-72-49-38-51-29-11-19-16-14-34-2-13-70-40-47-43-39-63-68-60-50-56-59-22-31-10-9-64-25-3-55-30-41-7-0-62-71-20-46-27,148-97-90-86-144-120-77-95-100-89-133-87-93-136-78-105-83-140-108-149-85-119-114-127-122-126-98-101-110-103-112-129-124-139-84-146-94-125-81-115-143-137-138-96-142-79-121-88-132-147-92-130-109-76-116-134-131-111-106-80-107-128-123-117-118-91-141-104-113-75-145-102-99-135-82,288178789,35844,37889,73733
ls-nn,kroA150,57-66-74-65-69-21-48-5-53-1-12-32-36-4-67-24-18-52-15-17-23-37-35-58-73-44-61-26-42-45-28-33-54-6-8-72-49-38-51-29-11-19-16-14-34-2-13-70-40-47-43-39-63-68-60-50-56-59-22-31-10-9-64-25-3-55-30-41-7-0-62-71-20-46-27,148-97-90-86-144-120-77-95-100-89-133-87-93-136-78-105-83-140-108-149-85-119-114-127-122-126-98-101-110-103-112-129-124-139-84-146-94-125-81-115-143-137-138-96-142-79-121-88-132-147-92-130-109-76-116-134-131-111-106-80-107-128-123-117-118-91-141-104-113-75-145-102-99-135-82,273181952,35844,37889,73733
ls-nn,kroA150,57-66-74-65-69-21-48-5-53-1-12-32-36-4-67-24-18-52-15-17-23-37-35-58-73-44-61-26-42-45-28-33-54-6-8-72-49-38-51-29-11-19-16-14-34-2-13-70-40-47-43-39-63-68-60-50-56-59-22-31-10-9-64-25-3-55-30-41-7-0-62-71-20-46-27,148-97-90-86-144-120-77-95-100-89-133-87-93-136-78-105-83-140-108-149-85-119-114-127-122-126-98-101-110-103-112-129-124-139-84-146-94-125-81-115-143-137-138-96-142-79-121-88-132-147-92-130-109-76-116-134-131-111-106-80-107-128-123-117-118-91-141-104-113-75-145-102-99-135-82,280649619,35844,37889,73733
ls-nn,kroA150,57-66-74-65-69-21-48-5-53-1-12-32-36-4-67-24-18-52-15-17-23-37-35-58-73-44-61-26-42-45-28-33-54-6-8-72-49-38-51-29-11-19-16-14-34-2-13-70-40-47-43-39-63-68-60-50-56-59-22-31-10-9-64-25-3-55-30-41-7-0-62-71-20-46-27,148-97-90-86-144-120-77-95-100-89-133-87-93-136-78-105-83-140-108-149-85-119-114-127-122-126-98-101-110-103-112-129-124-139-84-146-94-125-81-115-143-137-138-96-142-79-121-88-132-147-92-130-109-76-116-134-131-111-106-80-107-128-123-117-118-91-141-104-113-75-145-102-99-135-82,287275452,35844,37889,73733
ls-nn,kroA150,57-66-74-65-69-21-48-5-53-1-12-32-36-4-67-24-18-52-15-17-23-37-35-58-73-44-61-26-42-45-28-33-54-6-8-72-49-38-51-29-11-19-16-14-34-2-13-70-40-47-43-39-63-68-60-50-56-59-22-31-10-9-64-25-3-55-30-41-7-0-62-71-20-46-27,148-97-90-86-144-120-77-95-100-89-133-87-93-136-78-105-83-140-108-149-85-119-114-127-122-126-98-101-110-103-112-129-124-139-84-146-94-125-81-115-143-137-138-96-142-79-121-88-132-147-92-130-109-76-116-134-131-111-106-80-107-128-123-117-118-91-141-104-113-75-145-102-99-135-82,291596388,35844,37889,73733
ls-nn,kroA150,57-66-74-65-69-21-48-5-53-1-12-32-36-4-67-24-18-52-15-17-23-37-35-58-73-44-61-26-42-45-28-33-54-6-8-72-49-38-51-29-11-19-16-14-34-2-13-70-40-47-43-39-63-68-60-50-56-59-22-31-10-9-64-25-3-55-30-41-7-0-62-71-20-46-27,148-97-90-86-144-120-77-95-100-89-133-87-93-136-78-105-83-140-108-149-85-119-114-127-122-126-98-101-110-103-112-129-124-139-84-146-94-125-81-115-143-137-138-96-142-79-121-88-132-147-92-130-109-76-116-134-131-111-106-80-107-128-123-117-118-91-141-104-113-75-145-102-99-135-82,289935512,35844,37889,73733
ls-nn,kroA150,57-66-74-65-69-21-48-5-53-1-12-32-36-4-67-24-18-52-15-17-23-37-35-58-73-44-61-26-42-45-28-33-54-6-8-72-49-38-51-29-11-19-16-14-34-2-13-70-40-47-43-39-63-68-60-50-56-59-22-31-10-9-64-25-3-55-30-41-7-0-62-71-20-46-27,148-97-90-86-144-120-77-95-100-89-133-87-93-136-78-105-83-140-108-149-85-119-114-127-122-126-98-101-110-103-112-129-124-139-84-146-94-125-81-115-143-137-138-96-142-79-121-88-132-147-92-130-109-76-116-134-131-111-106-80-107-128-123-117-118-91-141-104-113-75-145-102-99-135-82,277136378,35844,37889,73733
ls-nn,kroA150,57-66-74-65-69-21-48-5-53-1-12-32-36-4-67-24-18-52-15-17-23-37-35-58-73-44-61-26-42-45-28-33-54-6-8-72-49-38-51-29-11-19-16-14-34-2-13-70-40-47-43-39-63-68-60-50-56-59-22-31-10-9-64-25-3-55-30-41-7-0-62-71-20-46-27,148-97-90-86-144-120-77-95-100-89-133-87-93-136-78-105-83-140-108-149-85-119-114-127-122-126-98-101-110-103-112-129-124-139-84-146-94-125-81-115-143-137-138-96-142-79-121-88-132-147-92-130-109-76-116-134-131-111-106-80-107-128-123-117-118-91-141-104-113-75-145-102-99-135-82,281825632,35844,37889,73733
ls-nn,kroA150,57-66-74-65-69-21-48-5-53-1-12-32-36-4-67-24-18-52-15-17-23-37-35-58-73-44-61-26-42-45-28-33-54-6-8-72-49-38-51-29-11-19-16-14-34-2-13-70-40-47-43-39-63-68-60-50-56-59-22-31-10-9-64-25-3-55-30-41-7-0-62-71-20-46-27,148-97-90-86-144-120-77-95-100-89-133-87-93-136-78-105-83-140-108-149-85-119-114-127-122-126-98-101-110-103-112-129-124-139-84-146-94-125-81-115-143-137-138-96-142-79-121-88-132-147-92-130-109-76-116-134-131-111-106-80-107-128-123-117-118-91-141-104-113-75-145-102-99-135-82,289337207,35844,37889,73733
ls-nn,kroA150,57-66-74-65-69-21-48-5-53-1-12-32-36-4-67-24-18-52-15-17-23-37-35-58-73-44-61-26-42-45-28-33-54-6-8-72-49-38-51-29-11-19-16-14-34-2-13-70-40-47-43-39-63-68-60-50-56-59-22-31-10-9-64-25-3-55-30-41-7-0-62-71-20-46-27,148-97-90-86-144-120-77-95-100-89-133-87-93-136-78-105-83-140-108-149-85-119-114-127-122-126-98-101-110-103-112-129-124-139-84-146-94-125-81-115-143-137-138-96-142-79-121-88-132-147-92-130-109-76-116-134-131-111-106-80-107-128-123-117-118-91-141-104-113-75-145-102-99-135-82,285656510,35844,37889,73733
ls-nn,kroA150,57-66-74-65-69-21-48-5-53-1-12-32-36-4-67-24-18-52-15-17-23-37-35-58-73-44-61-26-42-45-28-33-54-6-8-72-49-38-51-29-11-19-16-14-34-2-13-70-40-47-43-39-63-68-60-50-56-59-22-31-10-9-64-25-3-55-30-41-7-0-62-71-20-46-27,148-97-90-86-144-120-77-95-100-89-133-87-93-136-78-105-83-140-108-149-85-119-114-127-122-126-98-101-110-103-112-129-124-139-84-146-94-125-81-115-143-137-138-96-142-79-121-88-132-147-92-130-109-76-116-134-131-111-106-80-107-128-123-117-118-91-141-104-113-75-145-102-99-135-82,285028374,35844,37889,73733
ls-nn,kroA150,57-66-74-65-69-21-48-5-53-1-12-32-36-4-67-24-18-52-15-17-23-37-35-58-73-44-61-26-42-45-28-33-54-6-8-72-49-38-51-29-11-19-16-14-34-2-13-70-40-47-43-39-63-68-60-50-56-59-22-31-10-9-64-25-3-55-30-41-7-0-62-71-20-46-27,148-97-90-86-144-120-77-95-100-89-133-87-93-136-78-105-83-140-108-149-85-119-114-127-122-126-98-101-110-103-112-129-124-139-84-146-94-125-81-115-143-137-138-96-142-79-121-88-132-147-92-130-109-76-116-134-131-111-106-80-107-128-123-117-118-91-141-104-113-75-145-102-99-135-82,276609209,35844,37889,73733
ls-nn,kroA150,57-66-74-65-69-21-48-5-53-1-12-32-36-4-67-24-18-52-15-17-23-37-35-58-73-44-61-26-42-45-28-33-54-6-8-72-49-38-51-29-11-19-16-14-34-2-13-70-40-47-43-39-63-68-60-50-56-59-22-31-10-9-64-25-3-55-30-41-7-0-62-71-20-46-27,148-97-90-86-144-120-77-95-100-89-133-87-93-136-78-105-83-140-108-149-85-119-114-127-122-126-98-101-110-103-112-129-124-139-84-146-94-125-81-115-143-137-138-96-142-79-121-88-132-147-92-130-109-76-116-134-131-111-106-80-107-128-123-117-118-91-141-104-113-75-145-102-99-135-82,292855185,35844,37889,73733
ls-nn,kroA150,57-66-74-65-69-21-48-5-53-1-12-32-36-4-67-24-18-52-15-17-23-37-35-58-73-44-61-26-42-45-28-33-54-6-8-72-49-38-51-29-11-19-16-14-34-2-13-70-40-47-43-39-63-68-60-50-56-59-22-31-10-9-64-25-3-55-30-41-7-0-62-71-20-46-27,148-97-90-86-144-120-77-95-100-89-133-87-93-136-78-105-83-140-108-149-85-119-114-127-122-126-98-101-110-103-112-129-124-139-84-146-94-125-81-115-143-137-138-96-142-79-121-88-132-147-92-130-109-76-116-134-131-111-106-80-107-128-123-117-118-91-141-104-113-75-145-102-99-135-82,275593651,35844,37889,73733
ls-nn,kroA150,57-66-74-65-69-21-48-5-53-1-12-32-36-4-67-24-18-52-15-17-23-37-35-58-73-44-61-26-42-45-28-33-54-6-8-72-49-38-51-29-11-19-16-14-34-2-13-70-40-47-43-39-63-68-60-50-56-59-22-31-10-9-64-25-3-55-30-41-7-0-62-71-20-46-27,148-97-90-86-144-120-77-95-100-89-133-87-93-136-78-105-83-140-108-149-85-119-114-127-122-126-98-101-110-103-112-129-124-139-84-146-94-125-81-115-143-137-138-96-142-79-121-88-132-147-92-130-109-76-116-134-131-111-106-80-107-128-123-117-118-91-141-104-113-75-145-102-99-135-82,285216723,35844,37889,73733
ls-nn,kroA150,57-66-74-65-69-21-48-5-53-1-12-32-36-4-67-24-18-52-15-17-23-37-35-58-73-44-61-26-42-45-28-33-54-6-8-72-49-38-51-29-11-19-16-14-34-2-13-70-40-47-43-39-63-68-60-50-56-59-22-31-10-9-64-25-3-55-30-41-7-0-62-71-20-46-27,148-97-90-86-144-120-77-95-100-89-133-87-93-136-78-105-83-140-108-149-85-119-114-127-122-126-98-101-110-103-112-129-124-139-84-146-94-125-81-115-143-137-138-96-142-79-121-88-132-147-92-130-109-76-116-134-131-111-106-80-107-128-123-117-118-91-141-104-113-75-145-102-99-135-82,278108216,35844,37889,73733
ls-nn,kroA150,57-66-74-65-69-21-48-5-53-1-12-32-36-4-67-24-18-52-15-17-23-37-35-58-73-44-61-26-42-45-28-33-54-6-8-72-49-38-51-29-11-19-16-14-34-2-13-70-40-47-43-39-63-68-60-50-56-59-22-31-10-9-64-25-3-55-30-41-7-0-62-71-20-46-27,148-97-90-86-144-120-77-95-100-89-133-87-93-136-78-105-83-140-108-149-85-119-114-127-122-126-98-101-110-103-112-129-124-139-84-146-94-125-81-115-143-137-138-96-142-79-121-88-132-147-92-130-109-76-116-134-131-111-106-80-107-128-123-117-118-91-141-104-113-75-145-102-99-135-82,287020057,35844,37889,73733
ls-nn,kroA150,57-66-74-65-69-21-48-5-53-1-12-32-36-4-67-24-18-52-15-17-23-37-35-58-73-44-61-26-42-45-28-33-54-6-8-72-49-38-51-29-11-19-16-14-34-2-13-70-40-47-43-39-63-68-60-50-56-59-22-31-10-9-64-25-3-55-30-41-7-0-62-71-20-46-27,148-97-90-86-144-120-77-95-100-89-133-87-93-136-78-105-83-140-108-149-85-119-114-127-122-126-98-101-110-103-112-129-124-139-84-146-94-125-81-115-143-137-138-96-142-79-121-88-132-147-92-130-109-76-116-134-131-111-106-80-107-128-123-117-118-91-141-104-113-75-145-102-99-135-82,293244389,35844,37889,73733
ls-nn,kroA150,57-66-74-65-69-21-48-5-53-1-12-32-36-4-67-24-18-52-15-17-23-37-35-58-73-44-61-26-42-45-28-33-54-6-8-72-49-38-51-29-11-19-16-14-34-2-13-70-40-47-43-39-63-68-60-50-56-59-22-31-10-9-64-25-3-55-30-41-7-0-62-71-20-46-27,148-97-90-86-144-120-77-95-100-89-133-87-93-136-78-105-83-140-108-149-85-119-114-127-122-126-98-101-110-103-112-129-124-139-84-146-94-125-81-115-143-137-138-96-142-79-121-88-132-147-92-130-109-76-116-134-131-111-106-80-107-128-123-117-118-91-141-104-113-75-145-102-99-135-82,280968404,35844,37889,73733
ls-nn,kroA150,57-66-74-65-69-21-48-5-53-1-12-32-36-4-67-24-18-52-15-17-23-37-35-58-73-44-61-26-42-45-28-33-54-6-8-72-49-38-51-29-11-19-16-14-34-2-13-70-40-47-43-39-63-68-60-50-56-59-22-31-10-9-64-25-3-55-30-41-7-0-62-71-20-46-27,148-97-90-86-144-120-77-95-100-89-133-87-93-136-78-105-83-140-108-149-85-119-114-127-122-126-98-101-110-103-112-129-124-139-84-146-94-125-81-115-143-137-138-96-142-79-121-88-132-147-92-130-109-76-116-134-131-111-106-80-107-128-123-117-118-91-141-104-113-75-145-102-99-135-82,278594276,35844,37889,73733
ls-nn,kroA150,57-66-74-65-69-21-48-5-53-1-12-32-36-4-67-24-18-52-15-17-23-37-35-58-73-44-61-26-42-45-28-33-54-6-8-72-49-38-51-29-11-19-16-14-34-2-13-70-40-47-43-39-63-68-60-50-56-59-22-31-10-9-64-25-3-55-30-41-7-0-62-71-20-46-27,148-97-90-86-144-120-77-95-100-89-133-87-93-136-78-105-83-140-108-149-85-119-114-127-122-126-98-101-110-103-112-129-124-139-84-146-94-125-81-115-143-137-138-96-142-79-121-88-132-147-92-130-109-76-116-134-131-111-106-80-107-128-123-117-118-91-141-104-113-75-145-102-99-135-82,276115509,35844,37889,73733
ls-nn,kroA150,57-66-74-65-69-21-48-5-53-1-12-32-36-4-67-24-18-52-15-17-23-37-35-58-73-44-61-26-42-45-28-33-54-6-8-72-49-38-51-29-11-19-16-14-34-2-13-70-40-47-43-39-63-68-60-50-56-59-22-31-10-9-64-25-3-55-30-41-7-0-62-71-20-46-27,148-97-90-86-144-120-77-95-100-89-133-87-93-136-78-105-83-140-108-149-85-119-114-127-122-126-98-101-110-103-112-129-124-139-84-146-94-125-81-115-143-137-138-96-142-79-121-88-132-147-92-130-109-76-116-134-131-111-106-80-107-128-123-117-118-91-141-104-113-75-145-102-99-135-82,275745898,35844,37889,73733
ls-nn,kroA150,57-66-74-65-69-21-48-5-53-1-12-32-36-4-67-24-18-52-15-17-23-37-35-58-73-44-61-26-42-45-28-33-54-6-8-72-49-38-51-29-11-19-16-14-34-2-13-70-40-47-43-39-63-68-60-50-56-59-22-31-10-9-64-25-3-55-30-41-7-0-62-71-20-46-27,148-97-90-86-144-120-77-95-100-89-133-87-93-136-78-105-83-140-108-149-85-119-114-127-122-126-98-101-110-103-112-129-124-139-84-146-94-125-81-115-143-137-138-96-142-79-121-88-132-147-92-130-109-76-116-134-131-111-106-80-107-128-123-117-118-91-141-104-113-75-145-102-99-135-82,282572346,35844,37889,73733
ls-nn,kroA150,57-66-74-65-69-21-48-5-53-1-12-32-36-4-67-24-18-52-15-17-23-37-35-58-73-44-61-26-42-45-28-33-54-6-8-72-49-38-51-29-11-19-16-14-34-2-13-70-40-47-43-39-63-68-60-50-56-59-22-31-10-9-64-25-3-55-30-41-7-0-62-71-20-46-27,148-97-90-86-144-120-77-95-100-89-133-87-93-136-78-105-83-140-108-149-85-119-114-127-122-126-98-101-110-103-112-129-124-139-84-146-94-125-81-115-143-137-138-96-142-79-121-88-132-147-92-130-109-76-116-134-131-111-106-80-107-128-123-117-118-91-141-104-113-75-145-102-99-135-82,290247127,35844,37889,73733
ls-nn,kroA150,57-66-74-65-69-21-48-5-53-1-12-32-36-4-67-24-18-52-15-17-23-37-35-58-73-44-61-26-42-45-28-33-54-6-8-72-49-38-51-29-11-19-16-14-34-2-13-70-40-47-43-39-63-68-60-50-56-59-22-31-10-9-64-25-3-55-30-41-7-0-62-71-20-46-27,148-97-90-86-144-120-77-95-100-89-133-87-93-136-78-105-83-140-108-149-85-119-114-127-122-126-98-101-110-103-112-129-124-139-84-146-94-125-81-115-143-137-138-96-142-79-121-88-132-147-92-130-109-76-116-134-131-111-106-80-107-128-123-117-118-91-141-104-113-75-145-102-99-135-82,283560899,35844,37889,73733
ils,kroA150,40-70-47-51-49-43-72-67-134-139-50-60-66-141-147-142-118-117-123-128-69-65-64-55-138-71-73-140-130-57-115-125-145-146-38-120-131-119-114-122-127-135-42-45-54-116-56-144-124-68-113-143-63-39-53-137-132-149-61-59-44-58-126-37-136-133-52-121-41-129-62-48-112-46-148,84-100-102-32-75-94-7-74-96-25-3-18-78-17-83-9-5-91-79-30-88-104-107-80-24-86-8-6-33-82-11-19-76-109-90-20-35-98-101-110-103-23-0-28-13-99-2-26-85-34-22-97-89-105-93-21-15-87-16-14-10-31-108-92-27-1-81-12-36-4-77-95-29-106-111,28526495710,30463,30582,61045
ils,kroA150,40-70-47-51-49-43-72-67-134-139-50-60-66-141-147-142-118-117-123-128-69-65-64-55-138-71-73-140-130-57-115-125-145-146-38-120-131-119-114-122-127-135-42-45-54-116-56-144-124-68-113-143-63-39-53-137-132-149-61-59-44-58-126-37-136-133-52-121-41-129-62-48-112-46-148,84-100-102-32-75-94-7-74-96-25-3-18-78-17-83-9-5-91-79-30-88-104-107-80-24-86-8-6-33-82-11-19-76-109-90-20-35-98-101-110-103-23-0-28-13-99-2-26-85-34-22-97-89-105-93-21-15-87-16-14-10-31-108-92-27-1-81-12-36-4-77-95-29-106-111,31104188682,30463,30582,61045
ils,kroA150,40-70-47-51-49-43-72-67-134-139-50-60-66-141-147-142-118-117-123-128-69-65-64-55-138-71-73-140-130-57-115-125-145-146-38-120-131-119-114-122-127-135-42-45-54-116-56-144-124-68-113-143-63-39-53-137-132-149-61-59-44-58-126-37-136-133-52-121-41-129-62-48-112-46-148,84-100-102-32-75-94-7-74-96-25-3-18-78-17-83-9-5-91-79-30-88-104-107-80-24-86-8-6-33-82-11-19-76-109-90-20-35-98-101-110-103-23-0-28-13-99-2-26-85-34-22-97-89-105-93-21-15-87-16-14-10-31-108-92-27-1-81-12-36-4-77-95-29-106-111,30366443542,30463,30582,61045
ils,kroA150,40-70-47-51-49-43-72-67-134-139-50-60-66-141-147-142-118-117-123-128-69-65-64-55-138-71-73-140-130-57-115-125-145-146-38-120-131-119-114-122-127-135-42-45-54-116-56-144-124-68-113-143-63-39-53-137-132-149-61-59-44-58-126-37-136-133-52-121-41-129-62-48-112-46-148,84-100-102-32-75-94-7-74-96-25-3-18-78-17-83-9-5-91-79-30-88-104-107-80-24-86-8-6-33-82-11-19-76-109-90-20-35-98-101-110-103-23-0-28-13-99-2-26-85-34-22-97-89-105-93-21-15-87-16-14-10-31-108-92-27-1-81-12-36-4-77-95-29-106-111,28938923925,30463,30582,61045
ils,kroA150,40-70-47-51-49-43-72-67-134-139-50-60-66-141-147-142-118-117-123-128-69-65-64-55-138-71-73-140-130-57-115-125-145-146-38-120-131-119-114-122-127-135-42-45-54-116-56-144-124-68-113-143-63-39-53-137-132-149-61-59-44-58-126-37-136-133-52-121-41-129-62-48-112-46-148,84-100-102-32-75-94-7-74-96-25-3-18-78-17-83-9-5-91-79-30-88-104-107-80-24-86-8-6-33-82-11-19-76-109-90-20-35-98-101-110-103-23-0-28-13-99-2-26-85-34-22-97-89-105-93-21-15-87-16-14-10-31-108-92-27-1-81-12-36-4-77-95-29-106-111,39543673659,30463,30582,61045
ils,kroA150,40-70-47-51-49-43-72-67-134-139-50-60-66-141-147-142-118-117-123-128-69-65-64-55-138-71-73-140-130-57-115-125-145-146-38-120-131-119-114-122-127-135-42-45-54-116-56-144-124-68-113-143-63-39-53-137-132-149-61-59-44-58-126-37-136-133-52-121-41-129-62-48-112-46-148,84-100-102-32-75-94-7-74-96-25-3-18-78-17-83-9-5-91-79-30-88-104-107-80-24-86-8-6-33-82-11-19-76-109-90-20-35-98-101-110-103-23-0-28-13-99-2-26-85-34-22-97-89-105-93-21-15-87-16-14-10-31-108-92-27-1-81-12-36-4-77-95-29-106-111,32207759684,30463,30582,61045
ils,kroA150,40-70-47-51-49-43-72-67-134-139-50-60-66-141-147-142-118-117-123-128-69-65-64-55-138-71-73-140-130-57-115-125-145-146-38-120-131-119-114-122-127-135-42-45-54-116-56-144-124-68-113-143-63-39-53-137-132-149-61-59-44-58-126-37-136-133-52-121-41-129-62-48-112-46-148,84-100-102-32-75-94-7-74-96-25-3-18-78-17-83-9-5-91-79-30-88-104-107-80-24-86-8-6-33-82-11-19-76-109-90-20-35-98-101-110-103-23-0-28-13-99-2-26-85-34-22-97-89-105-93-21-15-87-16-14-10-31-108-92-27-1-81-12-36-4-77-95-29-106-111,30954382230,30463,30582,61045
ils,kroA150,40-70-47-51-49-43-72-67-134-139-50-60-66-141-147-142-118-117-123-128-69-65-64-55-138-71-73-140-130-57-115-125-145-146-38-120-131-119-114-122-127-135-42-45-54-116-56-144-124-68-113-143-63-39-53-137-132-149-61-59-44-58-126-37-136-133-52-121-41-129-62-48-112-46-148,84-100-102-32-75-94-7-74-96-25-3-18-78-17-83-9-5-91-79-30-88-104-107-80-24-86-8-6-33-82-11-19-76-109-90-20-35-98-101-110-103-23-0-28-13-99-2-26-85-34-22-97-89-105-93-21-15-87-16-14-10-31-108-92-27-1-81-12-36-4-77-95-29-106-111,34096498249,30463,30582,61045
ils,kroA150,40-70-47-51-49-43-72-67-134-139-50-60-66-141-147-142-118-117-123-128-69-65-64-55-138-71-73-140-130-57-115-125-145-146-38-120-131-119-114-122-127-135-42-45-54-116-56-144-124-68-113-143-63-39-53-137-132-149-61-59-44-58-126-37-136-133-52-121-41-129-62-48-112-46-148,84-100-102-32-75-94-7-74-96-25-3-18-78-17-83-9-5-91-79-30-88-104-107-80-24-86-8-6-33-82-11-19-76-109-90-20-35-98-101-110-103-23-0-28-13-99-2-26-85-34-22-97-89-105-93-21-15-87-16-14-10-31-108-92-27-1-81-12-36-4-77-95-29-106-111,31703156343,30463,30582,61045
ils,kroA150,40-70-47-51-49-43-72-67-134-139-50-60-66-141-147-142-118-117-123-128-69-65-64-55-138-71-73-140-130-57-115-125-145-146-38-120-131-119-114-122-127-135-42-45-54-116-56-144-124-68-113-143-63-39-53-137-132-149-61-59-44-58-126-37-136-133-52-121-41-129-62-48-112-46-148,84-100-102-32-75-94-7-74-96-25-3-18-78-17-83-9-5-91-79-30-88-104-107-80-24-86-8-6-33-82-11-19-76-109-90-20-35-98-101-110-103-23-0-28-13-99-2-26-85-34-22-97-89-105-93-21-15-87-16-14-10-31-108-92-27-1-81-12-36-4-77-95-29-106-111,33476305328,30463,30582,61045
ils,kroA150,40-70-47-51-49-43-72-67-134-139-50-60-66-141-147-142-118-117-123-128-69-65-64-55-138-71-73-140-130-57-115-125-145-146-38-120-131-119-114-122-127-135-42-45-54-116-56-144-124-68-113-143-63-39-53-137-132-149-61-59-44-58-126-37-136-133-52-121-41-129-62-48-112-46-148,84-100-102-32-75-94-7-74-96-25-3-18-78-17-83-9-5-91-79-30-88-104-107-80-24-86-8-6-33-82-11-19-76-109-90-20-35-98-101-110-103-23-0-28-13-99-2-26-85-34-22-97-89-105-93-21-15-87-16-14-10-31-108-92-27-1-81-12-36-4-77-95-29-106-111,37186509407,30463,30582,61045
ils,kroA150,40-70-47-51-49-43-72-67-134-139-50-60-66-141-147-142-118-117-123-128-69-65-64-55-138-71-73-140-130-57-115-125-145-146-38-120-131-119-114-122-127-135-42-45-54-116-56-144-124-68-113-143-63-39-53-137-132-149-61-59-44-58-126-37-136-133-52-121-41-129-62-48-112-46-148,84-100-102-32-75-94-7-74-96-25-3-18-78-17-83-9-5-91-79-30-88-104-107-80-24-86-8-6-33-82-11-19-76-109-90-20-35-98-101-110-103-23-0-28-13-99-2-26-85-34-22-97-89-105-93-21-15-87-16-14-10-31-108-92-27-1-81-12-36-4-77-95-29-106-111,33752021752,30463,30582,61045
ils,kroA150,40-70-47-51-49-43-72-67-134-139-50-60-66-141-147-142-118-117-123-128-69-65-64-55-138-71-73-140-130-57-115-125-145-146-38-120-131-119-114-122-127-135-42-45-54-116-56-144-124-68-113-143-63-39-53-137-132-149-61-59-44-58-126-37-136-133-52-121-41-129-62-48-112-46-148,84-100-102-32-75-94-7-74-96-25-3-18-78-17-83-9-5-91-79-30-88-104-107-80-24-86-8-6-33-82-11-19-76-109-90-20-35-98-101-110-103-23-0-28-13-99-2-26-85-34-22-97-89-105-93-21-15-87-16-14-10-31-108-92-27-1-81-12-36-4-77-95-29-106-111,32206303664,30463,30582,61045
ils,kroA150,40-70-47-51-49-43-72-67-134-139-50-60-66-141-147-142-118-117-123-128-69-65-64-55-138-71-73-140-130-57-115-125-145-146-38-120-131-119-114-122-127-135-42-45-54-116-56-144-124-68-113-143-63-39-53-137-132-149-61-59-44-58-126-37-136-133-52-121-41-129-62-48-112-46-148,84-100-102-32-75-94-7-74-96-25-3-18-78-17-83-9-5-91-79-30-88-104-107-80-24-86-8-6-33-82-11-19-76-109-90-20-35-98-101-110-103-23-0-28-13-99-2-26-85-34-22-97-89-105-93-21-15-87-16-14-10-31-108-92-27-1-81-12-36-4-77-95-29-106-111,33099653618,30463,30582,61045
ils,kroA150,40-70-47-51-49-43-72-67-134-139-50-60-66-141-147-142-118-117-123-128-69-65-64-55-138-71-73-140-130-57-115-125-145-146-38-120-131-119-114-122-127-135-42-45-54-116-56-144-124-68-113-143-63-39-53-137-132-149-61-59-44-58-126-37-136-133-52-121-41-129-62-48-112-46-148,84-100-102-32-75-94-7-74-96-25-3-18-78-17-83-9-5-91-79-30-88-104-107-80-24-86-8-6-33-82-11-19-76-109-90-20-35-98-101-110-103-23-0-28-13-99-2-26-85-34-22-97-89-105-93-21-15-87-16-14-10-31-108-92-27-1-81-12-36-4-77-95-29-106-111,33714334413,30463,30582,61045
ils,kroA150,40-70-47-51-49-43-72-67-134-139-50-60-66-141-147-142-118-117-123-128-69-65-64-55-138-71-73-140-130-57-115-125-145-146-38-120-131-119-114-122-127-135-42-45-54-116-56-144-124-68-113-143-63-39-53-137-132-149-61-59-44-58-126-37-136-133-52-121-41-129-62-48-112-46-148,84-100-102-32-75-94-7-74-96-25-3-18-78-17-83-9-5-91-79-30-88-104-107-80-24-86-8-6-33-82-11-19-76-109-90-20-35-98-101-110-103-23-0-28-13-99-2-26-85-34-22-97-89-105-93-21-15-87-16-14-10-31-108-92-27-1-81-12-36-4-77-95-29-106-111,30062520863,30463,30582,61045
ils,kroA150,40-70-47-51-49-43-72-67-134-139-50-60-66-141-147-142-118-117-123-128-69-65-64-55-138-71-73-140-130-57-115-125-145-146-38-120-131-119-114-122-127-135-42-45-54-116-56-144-124-68-113-143-63-39-53-137-132-149-61-59-44-58-126-37-136-133-52-121-41-129-62-48-112-46-148,84-100-102-32-75-94-7-74-96-25-3-18-78-17-83-9-5-91-79-30-88-104-107-80-24-86-8-6-33-82-11-19-76-109-90-20-35-98-101-110-103-23-0-28-13-99-2-26-85-34-22-97-89-105-93-21-15-87-16-14-10-31-108-92-27-1-81-12-36-4-77-95-29-106-111,29667487193,30463,30582,61045
ils,kroA150,40-70-47-51-49-43-72-67-134-139-50-60-66-141-147-142-118-117-123-128-69-65-64-55-138-71-73-140-130-57-115-125-145-146-38-120-131-119-114-122-127-135-42-45-54-116-56-144-124-68-113-143-63-39-53-137-132-149-61-59-44-58-126-37-136-133-52-121-41-129-62-48-112-46-148,84-100-102-32-75-94-7-74-96-25-3-18-78-17-83-9-5-91-79-30-88-104-107-80-24-86-8-6-33-82-11-19-76-109-90-20-35-98-101-110-103-23-0-28-13-99-2-26-85-34-22-97-89-105-93-21-15-87-16-14-10-31-108-92-27-1-81-12-36-4-77-95-29-106-111,31012985960,30463,30582,61045
ils,kroA150,40-70-47-51-49-43-72-67-134-139-50-60-66-141-147-142-118-117-123-128-69-65-64-55-138-71-73-140-130-57-115-125-145-146-38-120-131-119-114-122-127-135-42-45-54-116-56-144-124-68-113-143-63-39-53-137-132-149-61-59-44-58-126-37-136-133-52-121-41-129-62-48-112-46-148,84-100-102-32-75-94-7-74-96-25-3-18-78-17-83-9-5-91-79-30-88-104-107-80-24-86-8-6-33-82-11-19-76-109-90-20-35-98-101-110-103-23-0-28-13-99-2-26-85-34-22-97-89-105-93-21-15-87-16-14-10-31-108-92-27-1-81-12-36-4-77-95-29-106-111,32221260661,30463,30582,61045
ils,kroA150,40-70-47-51-49-43-72-67-134-139-50-60-66-141-147-142-118-117-123-128-69-65-64-55-138-71-73-140-130-57-115-125-145-146-38-120-131-119-114-122-127-135-42-45-54-116-56-144-124-68-113-143-63-39-53-137-132-149-61-59-44-58-126-37-136-133-52-121-41-129-62-48-112-46-148,84-100-102-32-75-94-7-74-96-25-3-18-78-17-83-9-5-91-79-30-88-104-107-80-24-86-8-6-33-82-11-19-76-109-90-20-35-98-101-110-103-23-0-28-13-99-2-26-85-34-22-97-89-105-93-21-15-87-16-14-10-31-108-92-27-1-81-12-36-4-77-95-29-106-111,31089239703,30463,30582,61045
ils,kroA150,40-70-47-51-49-43-72-67-134-139-50-60-66-141-147-142-118-117-123-128-69-65-64-55-138-71-73-140-130-57-115-125-145-146-38-120-131-119-114-122-127-135-42-45-54-116-56-144-124-68-113-143-63-39-53-137-132-149-61-59-44-58-126-37-136-133-52-121-41-129-62-48-112-46-148,84-100-102-32-75-94-7-74-96-25-3-18-78-17-83-9-5-91-79-30-88-104-107-80-24-86-8-6-33-82-11-19-76-109-90-20-35-98-101-110-103-23-0-28-13-99-2-26-85-34-22-97-89-105-93-21-15-87-16-14-10-31-108-92-27-1-81-12-36-4-77-95-29-106-111,32787322378,30463,30582,61045
ils,kroA150,40-70-47-51-49-43-72-67-134-139-50-60-66-141-147-142-118-117-123-128-69-65-64-55-138-71-73-140-130-57-115-125-145-146-38-120-131-119-114-122-127-135-42-45-54-116-56-144-124-68-113-143-63-39-53-137-132-149-61-59-44-58-126-37-136-133-52-121-41-129-62-48-112-46-148,84-100-102-32-75-94-7-74-96-25-3-18-78-17-83-9-5-91-79-30-88-104-107-80-24-86-8-6-33-82-11-19-76-109-90-20-35-98-101-110-103-23-0-28-13-99-2-26-85-34-22-97-89-105-93-21-15-87-16-14-10-31-108-92-27-1-81-12-36-4-77-95-29-106-111,32879659331,30463,30582,61045
ils,kroA150,40-70-47-51-49-43-72-67-134-139-50-60-66-141-147-142-118-117-123-128-69-65-64-55-138-71-73-140-130-57-115-125-145-146-38-120-131-119-114-122-127-135-42-45-54-116-56-144-124-68-113-143-63-39-53-137-132-149-61-59-44-58-126-37-136-133-52-121-41-129-62-48-112-46-148,84-100-102-32-75-94-7-74-96-25-3-18-78-17-83-9-5-91-79-30-88-104-107-80-24-86-8-6-33-82-11-19-76-109-90-20-35-98-101-110-103-23-0-28-13-99-2-26-85-34-22-97-89-105-93-21-15-87-16-14-10-31-108-92-27-1-81-12-36-4-77-95-29-106-111,31517108919,30463,30582,61045
ils,kroA150,40-70-47-51-49-43-72-67-134-139-50-60-66-141-147-142-118-117-123-128-69-65-64-55-138-71-73-140-130-57-115-125-145-146-38-120-131-119-114-122-127-135-42-45-54-116-56-144-124-68-113-143-63-39-53-137-132-149-61-59-44-58-126-37-136-133-52-121-41-129-62-48-112-46-148,84-100-102-32-75-94-7-74-96-25-3-18-78-17-83-9-5-91-79-30-88-104-107-80-24-86-8-6-33-82-11-19-76-109-90-20-35-98-101-110-103-23-0-28-13-99-2-26-85-34-22-97-89-105-93-21-15-87-16-14-10-31-108-92-27-1-81-12-36-4-77-95-29-106-111,30441297086,30463,30582,61045
ils,kroA150,40-70-47-51-49-43-72-67-134-139-50-60-66-141-147-142-118-117-123-128-69-65-64-55-138-71-73-140-130-57-115-125-145-146-38-120-131-119-114-122-127-135-42-45-54-116-56-144-124-68-113-143-63-39-53-137-132-149-61-59-44-58-126-37-136-133-52-121-41-129-62-48-112-46-148,84-100-102-32-75-94-7-74-96-25-3-18-78-17-83-9-5-91-79-30-88-104-107-80-24-86-8-6-33-82-11-19-76-109-90-20-35-98-101-110-103-23-0-28-13-99-2-26-85-34-22-97-89-105-93-21-15-87-16-14-10-31-108-92-27-1-81-12-36-4-77-95-29-106-111,30355671176,30463,30582,61045
ils,kroA150,40-70-47-51-49-43-72-67-134-139-50-60-66-141-147-142-118-117-123-128-69-65-64-55-138-71-73-140-130-57-115-125-145-146-38-120-131-119-114-122-127-135-42-45-54-116-56-144-124-68-113-143-63-39-53-137-132-149-61-59-44-58-126-37-136-133-52-121-41-129-62-48-112-46-148,84-100-102-32-75-94-7-74-96-25-3-18-78-17-83-9-5-91-79-30-88-104-107-80-24-86-8-6-33-82-11-19-76-109-90-20-35-98-101-110-103-23-0-28-13-99-2-26-85-34-22-97-89-105-93-21-15-87-16-14-10-31-108-92-27-1-81-12-36-4-77-95-29-106-111,36456734522,30463,30582,61045
ils,kroA150,68-124-50-144-139-120-38-51-47-70-40-135-127-42-122-45-131-134-60-57-130-46-62-48-37-136-65-64-142-121-137-53-39-132-41-138-55-74-129-141-63-143-113-43-49-67-116-54-114-119-148-56-66-147-118-117-123-128-69-52-133-112-71-73-126-58-140-44-59-61-146-145-125-115-72,98-101-110-23-17-5-27-80-24-8-6-26-85-34-149-92-91-96-25-3-18-20-10-16-14-86-106-29-100-12-75-32-102-36-4-77-95-94-81-1-88-30-79-7-0-90-108-31-93-21-15-87-78-105-89-83-9-104-107-84-111-28-13-99-2-33-82-11-19-76-109-22-97-35-103,34232269369,29614,30282,59896
ils,kroA150,40-70-47-51-49-43-72-67-134-139-50-60-66-141-147-142-118-117-123-128-69-65-64-55-138-71-73-140-130-57-115-125-145-146-38-120-131-119-114-122-127-135-42-45-54-116-56-144-124-68-113-143-63-39-53-137-132-149-61-59-44-58-126-37-136-133-52-121-41-129-62-48-112-46-148,84-100-102-32-75-94-7-74-96-25-3-18-78-17-83-9-5-91-79-30-88-104-107-80-24-86-8-6-33-82-11-19-76-109-90-20-35-98-101-110-103-23-0-28-13-99-2-26-85-34-22-97-89-105-93-21-15-87-16-14-10-31-108-92-27-1-81-12-36-4-77-95-29-106-111,31710961239,30463,30582,61045
ils,kroA150,40-70-47-51-49-43-72-67-134-139-50-60-66-141-147-142-118-117-123-128-69-65-64-55-138-71-73-140-130-57-115-125-145-146-38-120-131-119-114-122-127-135-42-45-54-116-56-144-124-68-113-143-63-39-53-137-132-149-61-59-44-58-126-37-136-133-52-121-41-129-62-48-112-46-148,84-100-102-32-75-94-7-74-96-25-3-18-78-17-83-9-5-91-79-30-88-104-107-80-24-86-8-6-33-82-11-19-76-109-90-20-35-98-101-110-103-23-0-28-13-99-2-26-85-34-22-97-89-105-93-21-15-87-16-14-10-31-108-92-27-1-81-12-36-4-77-95-29-106-111,31195222007,30463,30582,61045
ils,kroA150,40-70-47-51-49-43-72-67-134-139-50-60-66-141-147-142-118-117-123-128-69-65-64-55-138-71-73-140-130-57-115-125-145-146-38-120-131-119-114-122-127-135-42-45-54-116-56-144-124-68-113-143-63-39-53-137-132-149-61-59-44-58-126-37-136-133-52-121-41-129-62-48-112-46-148,84-100-102-32-75-94-7-74-96-25-3-18-78-17-83-9-5-91-79-30-88-104-107-80-24-86-8-6-33-82-11-19-76-109-90-20-35-98-101-110-103-23-0-28-13-99-2-26-85-34-22-97-89-105-93-21-15-87-16-14-10-31-108-92-27-1-81-12-36-4-77-95-29-106-111,36510405425,30463,30582,61045
ils,kroA150,40-70-47-51-49-43-72-67-134-139-50-60-66-141-147-142-118-117-123-128-69-65-64-55-138-71-73-140-130-57-115-125-145-146-38-120-131-119-114-122-127-135-42-45-54-116-56-144-124-68-113-143-63-39-53-137-132-149-61-59-44-58-126-37-136-133-52-121-41-129-62-48-112-46-148,84-100-102-32-75-94-7-74-96-25-3-18-78-17-83-9-5-91-79-30-88-104-107-80-24-86-8-6-33-82-11-19-76-109-90-20-35-98-101-110-103-23-0-28-13-99-2-26-85-34-22-97-89-105-93-21-15-87-16-14-10-31-108-92-27-1-81-12-36-4-77-95-29-106-111,28527736530,30463,30582,61045
ils,kroA150,40-70-47-51-49-43-72-67-134-139-50-60-66-141-147-142-118-117-123-128-69-65-64-55-138-71-73-140-130-57-115-125-145-146-38-120-131-119-114-122-127-135-42-45-54-116-56-144-124-68-113-143-63-39-53-137-132-149-61-59-44-58-126-37-136-133-52-121-41-129-62-48-112-46-148,84-100-102-32-75-94-7-74-96-25-3-18-78-17-83-9-5-91-79-30-88-104-107-80-24-86-8-6-33-82-11-19-76-109-90-20-35-98-101-110-103-23-0-28-13-99-2-26-85-34-22-97-89-105-93-21-15-87-16-14-10-31-108-92-27-1-81-12-36-4-77-95-29-106-111,27494544112,30463,30582,61045
ils,kroA150,40-70-47-51-49-43-72-67-134-139-50-60-66-141-147-142-118-117-123-128-69-65-64-55-138-71-73-140-130-57-115-125-145-146-38-120-131-119-114-122-127-135-42-45-54-116-56-144-124-68-113-143-63-39-53-137-132-149-61-59-44-58-126-37-136-133-52-121-41-129-62-48-112-46-148,84-100-102-32-75-94-7-74-96-25-3-18-78-17-83-9-5-91-79-30-88-104-107-80-24-86-8-6-33-82-11-19-76-109-90-20-35-98-101-110-103-23-0-28-13-99-2-26-85-34-22-97-89-105-93-21-15-87-16-14-10-31-108-92-27-1-81-12-36-4-77-95-29-106-111,32640695560,30463,30582,61045
ils,kroA150,40-70-47-51-49-43-72-67-134-139-50-60-66-141-147-142-118-117-123-128-69-65-64-55-138-71-73-140-130-57-115-125-145-146-38-120-131-119-114-122-127-135-42-45-54-116-56-144-124-68-113-143-63-39-53-137-132-149-61-59-44-58-126-37-136-133-52-121-41-129-62-48-112-46-148,84-100-102-32-75-94-7-74-96-25-3-18-78-17-83-9-5-91-79-30-88-104-107-80-24-86-8-6-33-82-11-19-76-109-90-20-35-98-101-110-103-23-0-28-13-99-2-26-85-34-22-97-89-105-93-21-15-87-16-14-10-31-108-92-27-1-81-12-36-4-77-95-29-106-111,29366562834,30463,30582,61045
ils,kroA150,40-70-47-51-49-43-72-67-134-139-50-60-66-141-147-142-118-117-123-128-69-65-64-55-138-71-73-140-130-57-115-125-145-146-38-120-131-119-114-122-127-135-42-45-54-116-56-144-124-68-113-143-63-39-53-137-132-149-61-59-44-58-126-37-136-133-52-121-41-129-62-48-112-46-148,84-100-102-32-75-94-7-74-96-25-3-18-78-17-83-9-5-91-79-30-88-104-107-80-24-86-8-6-33-82-11-19-76-109-90-20-35-98-101-110-103-23-0-28-13-99-2-26-85-34-22-97-89-105-93-21-15-87-16-14-10-31-108-92-27-1-81-12-36-4-77-95-29-106-111,29164163505,30463,30582,61045
ils,kroA150,40-70-47-51-49-43-72-67-134-139-50-60-66-141-147-142-118-117-123-128-69-65-64-55-138-71-73-140-130-57-115-125-145-146-38-120-131-119-114-122-127-135-42-45-54-116-56-144-124-68-113-143-63-39-53-137-132-149-61-59-44-58-126-37-136-133-52-121-41-129-62-48-112-46-148,84-100-102-32-75-94-7-74-96-25-3-18-78-17-83-9-5-91-79-30-88-104-107-80-24-86-8-6-33-82-11-19-76-109-90-20-35-98-101-110-103-23-0-28-13-99-2-26-85-34-22-97-89-105-93-21-15-87-16-14-10-31-108-92-27-1-81-12-36-4-77-95-29-106-111,28726832954,30463,30582,61045
ils,kroA150,40-70-47-51-49-43-72-67-134-139-50-60-66-141-147-142-118-117-123-128-69-65-64-55-138-71-73-140-130-57-115-125-145-146-38-120-131-119-114-122-127-135-42-45-54-116-56-144-124-68-113-143-63-39-53-137-132-149-61-59-44-58-126-37-136-133-52-121-41-129-62-48-112-46-148,84-100-102-32-75-94-7-74-96-25-3-18-78-17-83-9-5-91-79-30-88-104-107-80-24-86-8-6-33-82-11-19-76-109-90-20-35-98-101-110-103-23-0-28-13-99-2-26-85-34-22-97-89-105-93-21-15-87-16-14-10-31-108-92-27-1-81-12-36-4-77-95-29-106-111,28466411353,30463,30582,61045
ils,kroA150,40-70-47-51-49-43-72-67-134-139-50-60-66-141-147-142-118-117-123-128-69-65-64-55-138-71-73-140-130-57-115-125-145-146-38-120-131-119-114-122-127-135-42-45-54-116-56-144-124-68-113-143-63-39-53-137-132-149-61-59-44-58-126-37-136-133-52-121-41-129-62-48-112-46-148,84-100-102-32-75-94-7-74-96-25-3-18-78-17-83-9-5-91-79-30-88-104-107-80-24-86-8-6-33-82-11-19-76-109-90-20-35-98-101-110-103-23-0-28-13-99-2-26-85-34-22-97-89-105-93-21-15-87-16-14-10-31-108-92-27-1-81-12-36-4-77-95-29-106-111,29055614941,30463,30582,61045
ils,kroA150,40-70-47-51-49-43-72-67-134-139-50-60-66-141-147-142-118-117-123-128-69-65-64-55-138-71-73-140-130-57-115-125-145-146-38-120-131-119-114-122-127-135-42-45-54-116-56-144-124-68-113-143-63-39-53-137-132-149-61-59-44-58-126-37-136-133-52-121-41-129-62-48-112-46-148,84-100-102-32-75-94-7-74-96-25-3-18-78-17-83-9-5-91-79-30-88-104-107-80-24-86-8-6-33-82-11-19-76-109-90-20-35-98-101-110-103-23-0-28-13-99-2-26-85-34-22-97-89-105-93-21-15-87-16-14-10-31-108-92-27-1-81-12-36-4-77-95-29-106-111,36465247160,30463,30582,61045
ils,kroA150,40-70-47-51-49-43-72-67-134-139-50-60-66-141-147-142-118-117-123-128-69-65-64-55-138-71-73-140-130-57-115-125-145-146-38-120-131-119-114-122-127-135-42-45-54-116-56-144-124-68-113-143-63-39-53-137-132-149-61-59-44-58-126-37-136-133-52-121-41-129-62-48-112-46-148,84-100-102-32-75-94-7-74-96-25-3-18-78-17-83-9-5-91-79-30-88-104-107-80-24-86-8-6-33-82-11-19-76-109-90-20-35-98-101-110-103-23-0-28-13-99-2-26-85-34-22-97-89-105-93-21-15-87-16-14-10-31-108-92-27-1-81-12-36-4-77-95-29-106-111,30626911168,30463,30582,61045
ils,kroA150,40-70-47-51-49-43-72-67-134-139-50-60-66-141-147-142-118-117-123-128-69-65-64-55-138-71-73-140-130-57-115-125-145-146-38-120-131-119-114-122-127-135-42-45-54-116-56-144-124-68-113-143-63-39-53-137-132-149-61-59-44-58-126-37-136-133-52-121-41-129-62-48-112-46-148,84-100-102-32-75-94-7-74-96-25-3-18-78-17-83-9-5-91-79-30-88-104-107-80-24-86-8-6-33-82-11-19-76-109-90-20-35-98-101-110-103-23-0-28-13-99-2-26-85-34-22-97-89-105-93-21-15-87-16-14-10-31-108-92-27-1-81-12-36-4-77-95-29-106-111,33976972689,30463,30582,61045
ils,kroA150,40-70-47-51-49-43-72-67-134-139-50-60-66-141-147-142-118-117-123-128-69-65-64-55-138-71-73-140-130-57-115-125-145-146-38-120-131-119-114-122-127-135-42-45-54-116-56-144-124-68-113-143-63-39-53-137-132-149-61-59-44-58-126-37-136-133-52-121-41-129-62-48-112-46-148,84-100-102-32-75-94-7-74-96-25-3-18-78-17-83-9-5-91-79-30-88-104-107-80-24-86-8-6-33-82-11-19-76-109-90-20-35-98-101-110-103-23-0-28-13-99-2-26-85-34-22-97-89-105-93-21-15-87-16-14-10-31-108-92-27-1-81-12-36-4-77-95-29-106-111,29562759353,30463,30582,61045
ils,kroA150,40-70-47-51-49-43-72-67-134-139-50-60-66-141-147-142-118-117-123-128-69-65-64-55-138-71-73-140-130-57-115-125-145-146-38-120-131-119-114-122-127-135-42-45-54-116-56-144-124-68-113-143-63-39-53-137-132-149-61-59-44-58-126-37-136-133-52-121-41-129-62-48-112-46-148,84-100-102-32-75-94-7-74-96-25-3-18-78-17-83-9-5-91-79-30-88-104-107-80-24-86-8-6-33-82-11-19-76-109-90-20-35-98-101-110-103-23-0-28-13-99-2-26-85-34-22-97-89-105-93-21-15-87-16-14-10-31-108-92-27-1-81-12-36-4-77-95-29-106-111,28768048165,30463,30582,61045
ils,kroA150,40-70-47-51-49-43-72-67-134-139-50-60-66-141-147-142-118-117-123-128-69-65-64-55-138-71-73-140-130-57-115-125-145-146-38-120-131-119-114-122-127-135-42-45-54-116-56-144-124-68-113-143-63-39-53-137-132-149-61-59-44-58-126-37-136-133-52-121-41-129-62-48-112-46-148,84-100-102-32-75-94-7-74-96-25-3-18-78-17-83-9-5-91-79-30-88-104-107-80-24-86-8-6-33-82-11-19-76-109-90-20-35-98-101-110-103-23-0-28-13-99-2-26-85-34-22-97-89-105-93-21-15-87-16-14-10-31-108-92-27-1-81-12-36-4-77-95-29-106-111,29458843758,30463,30582,61045
ils,kroA150,40-70-47-51-49-43-72-67-134-139-50-60-66-141-147-142-118-117-123-128-69-65-64-55-138-71-73-140-130-57-115-125-145-146-38-120-131-119-114-122-127-135-42-45-54-116-56-144-124-68-113-143-63-39-53-137-132-149-61-59-44-58-126-37-136-133-52-121-41-129-62-48-112-46-148,84-100-102-32-75-94-7-74-96-25-3-18-78-17-83-9-5-91-79-30-88-104-107-80-24-86-8-6-33-82-11-19-76-109-90-20-35-98-101-110-103-23-0-28-13-99-2-26-85-34-22-97-89-105-93-21-15-87-16-14-10-31-108-92-27-1-81-12-36-4-77-95-29-106-111,28583759912,30463,30582,61045
ils,kroA150,40-70-47-51-49-43-72-67-134-139-50-60-66-141-147-142-118-117-123-128-69-65-64-55-138-71-73-140-130-57-115-125-145-146-38-120-131-119-114-122-127-135-42-45-54-116-56-144-124-68-113-143-63-39-53-137-132-149-61-59-44-58-126-37-136-133-52-121-41-129-62-48-112-46-148,84-100-102-32-75-94-7-74-96-25-3-18-78-17-83-9-5-91-79-30-88-104-107-80-24-86-8-6-33-82-11-19-76-109-90-20-35-98-101-110-103-23-0-28-13-99-2-26-85-34-22-97-89-105-93-21-15-87-16-14-10-31-108-92-27-1-81-12-36-4-77-95-29-106-111,28243278498,30463,30582,61045
ils,kroA150,40-70-47-51-49-43-72-67-134-139-50-60-66-141-147-142-118-117-123-128-69-65-64-55-138-71-73-140-130-57-115-125-145-146-38-120-131-119-114-122-127-135-42-45-54-116-56-144-124-68-113-143-63-39-53-137-132-149-61-59-44-58-126-37-136-133-52-121-41-129-62-48-112-46-148,84-100-102-32-75-94-7-74-96-25-3-18-78-17-83-9-5-91-79-30-88-104-107-80-24-86-8-6-33-82-11-19-76-109-90-20-35-98-101-110-103-23-0-28-13-99-2-26-85-34-22-97-89-105-93-21-15-87-16-14-10-31-108-92-27-1-81-12-36-4-77-95-29-106-111,28430410532,30463,30582,61045
ils,kroA150,40-70-47-51-49-43-72-67-134-139-50-60-66-141-147-142-118-117-123-128-69-65-64-55-138-71-73-140-130-57-115-125-145-146-38-120-131-119-114-122-127-135-42-45-54-116-56-144-124-68-113-143-63-39-53-137-132-149-61-59-44-58-126-37-136-133-52-121-41-129-62-48-112-46-148,84-100-102-32-75-94-7-74-96-25-3-18-78-17-83-9-5-91-79-30-88-104-107-80-24-86-8-6-33-82-11-19-76-109-90-20-35-98-101-110-103-23-0-28-13-99-2-26-85-34-22-97-89-105-93-21-15-87-16-14-10-31-108-92-27-1-81-12-36-4-77-95-29-106-111,28710911167,30463,30582,61045
ils,kroA150,40-70-47-51-49-43-72-67-134-139-50-60-66-141-147-142-118-117-123-128-69-65-64-55-138-71-73-140-130-57-115-125-145-146-38-120-131-119-114-122-127-135-42-45-54-116-56-144-124-68-113-143-63-39-53-137-132-149-61-59-44-58-126-37-136-133-52-121-41-129-62-48-112-46-148,84-100-102-32-75-94-7-74-96-25-3-18-78-17-83-9-5-91-79-30-88-104-107-80-24-86-8-6-33-82-11-19-76-109-90-20-35-98-101-110-103-23-0-28-13-99-2-26-85-34-22-97-89-105-93-21-15-87-16-14-10-31-108-92-27-1-81-12-36-4-77-95-29-106-111,29456101699,30463,30582,61045
ils,kroA150,40-70-47-51-49-43-72-67-134-139-50-60-66-141-147-142-118-117-123-128-69-65-64-55-138-71-73-140-130-57-115-125-145-146-38-120-131-119-114-122-127-135-42-45-54-116-56-144-124-68-113-143-63-39-53-137-132-149-61-59-44-58-126-37-136-133-52-121-41-129-62-48-112-46-148,84-100-102-32-75-94-7-74-96-25-3-18-78-17-83-9-5-91-79-30-88-104-107-80-24-86-8-6-33-82-11-19-76-109-90-20-35-98-101-110-103-23-0-28-13-99-2-26-85-34-22-97-89-105-93-21-15-87-16-14-10-31-108-92-27-1-81-12-36-4-77-95-29-106-111,29706952307,30463,30582,61045
ils,kroA150,40-70-47-51-49-43-72-67-134-139-50-60-66-141-147-142-118-117-123-128-69-65-64-55-138-71-73-140-130-57-115-125-145-146-38-120-131-119-114-122-127-135-42-45-54-116-56-144-124-68-113-143-63-39-53-137-132-149-61-59-44-58-126-37-136-133-52-121-41-129-62-48-112-46-148,84-100-102-32-75-94-7-74-96-25-3-18-78-17-83-9-5-91-79-30-88-104-107-80-24-86-8-6-33-82-11-19-76-109-90-20-35-98-101-110-103-23-0-28-13-99-2-26-85-34-22-97-89-105-93-21-15-87-16-14-10-31-108-92-27-1-81-12-36-4-77-95-29-106-111,29456679660,30463,30582,61045
ils,kroA150,40-70-47-51-49-43-72-67-134-139-50-60-66-141-147-142-118-117-123-128-69-65-64-55-138-71-73-140-130-57-115-125-145-146-38-120-131-119-114-122-127-135-42-45-54-116-56-144-124-68-113-143-63-39-53-137-132-149-61-59-44-58-126-37-136-133-52-121-41-129-62-48-112-46-148,84-100-102-32-75-94-7-74-96-25-3-18-78-17-83-9-5-91-79-30-88-104-107-80-24-86-8-6-33-82-11-19-76-109-90-20-35-98-101-110-103-23-0-28-13-99-2-26-85-34-22-97-89-105-93-21-15-87-16-14-10-31-108-92-27-1-81-12-36-4-77-95-29-106-111,37081411960,30463,30582,61045
ils,kroA150,40-70-47-51-49-43-72-67-134-139-50-60-66-141-147-142-118-117-123-128-69-65-64-55-138-71-73-140-130-57-115-125-145-146-38-120-131-119-114-122-127-135-42-45-54-116-56-144-124-68-113-143-63-39-53-137-132-149-61-59-44-58-126-37-136-133-52-121-41-129-62-48-112-46-148,84-100-102-32-75-94-7-74-96-25-3-18-78-17-83-9-5-91-79-30-88-104-107-80-24-86-8-6-33-82-11-19-76-109-90-20-35-98-101-110-103-23-0-28-13-99-2-26-85-34-22-97-89-105-93-21-15-87-16-14-10-31-108-92-27-1-81-12-36-4-77-95-29-106-111,31734972299,30463,30582,61045
ils,kroA150,40-70-47-51-49-43-72-67-134-139-50-60-66-141-147-142-118-117-123-128-69-65-64-55-138-71-73-140-130-57-115-125-145-146-38-120-131-119-114-122-127-135-42-45-54-116-56-144-124-68-113-143-63-39-53-137-132-149-61-59-44-58-126-37-136-133-52-121-41-129-62-48-112-46-148,84-100-102-32-75-94-7-74-96-25-3-18-78-17-83-9-5-91-79-30-88-104-107-80-24-86-8-6-33-82-11-19-76-109-90-20-35-98-101-110-103-23-0-28-13-99-2-26-85-34-22-97-89-105-93-21-15-87-16-14-10-31-108-92-27-1-81-12-36-4-77-95-29-106-111,30410688396,30463,30582,61045
ils,kroA150,40-70-47-51-49-43-72-67-134-139-50-60-66-141-147-142-118-117-123-128-69-65-64-55-138-71-73-140-130-57-115-125-145-146-38-120-131-119-114-122-127-135-42-45-54-116-56-144-124-68-113-143-63-39-53-137-132-149-61-59-44-58-126-37-136-133-52-121-41-129-62-48-112-46-148,84-100-102-32-75-94-7-74-96-25-3-18-78-17-83-9-5-91-79-30-88-104-107-80-24-86-8-6-33-82-11-19-76-109-90-20-35-98-101-110-103-23-0-28-13-99-2-26-85-34-22-97-89-105-93-21-15-87-16-14-10-31-108-92-27-1-81-12-36-4-77-95-29-106-111,28821375875,30463,30582,61045
ils,kroA150,40-70-47-51-49-43-72-67-134-139-50-60-66-141-147-142-118-117-123-128-69-65-64-55-138-71-73-140-130-57-115-125-145-146-38-120-131-119-114-122-127-135-42-45-54-116-56-144-124-68-113-143-63-39-53-137-132-149-61-59-44-58-126-37-136-133-52-121-41-129-62-48-112-46-148,84-100-102-32-75-94-7-74-96-25-3-18-78-17-83-9-5-91-79-30-88-104-107-80-24-86-8-6-33-82-11-19-76-109-90-20-35-98-101-110-103-23-0-28-13-99-2-26-85-34-22-97-89-105-93-21-15-87-16-14-10-31-108-92-27-1-81-12-36-4-77-95-29-106-111,29660941558,30463,30582,61045
ils,kroA150,40-70-47-51-49-43-72-67-134-139-50-60-66-141-147-142-118-117-123-128-69-65-64-55-138-71-73-140-130-57-115-125-145-146-38-120-131-119-114-122-127-135-42-45-54-116-56-144-124-68-113-143-63-39-53-137-132-149-61-59-44-58-126-37-136-133-52-121-41-129-62-48-112-46-148,84-100-102-32-75-94-7-74-96-25-3-18-78-17-83-9-5-91-79-30-88-104-107-80-24-86-8-6-33-82-11-19-76-109-90-20-35-98-101-110-103-23-0-28-13-99-2-26-85-34-22-97-89-105-93-21-15-87-16-14-10-31-108-92-27-1-81-12-36-4-77-95-29-106-111,32716216407,30463,30582,61045
ils,kroA150,40-70-47-51-49-43-72-67-134-139-50-60-66-141-147-142-118-117-123-128-69-65-64-55-138-71-73-140-130-57-115-125-145-146-38-120-131-119-114-122-127-135-42-45-54-116-56-144-124-68-113-143-63-39-53-137-132-149-61-59-44-58-126-37-136-133-52-121-41-129-62-48-112-46-148,84-100-102-32-75-94-7-74-96-25-3-18-78-17-83-9-5-91-79-30-88-104-107-80-24-86-8-6-33-82-11-19-76-109-90-20-35-98-101-110-103-23-0-28-13-99-2-26-85-34-22-97-89-105-93-21-15-87-16-14-10-31-108-92-27-1-81-12-36-4-77-95-29-106-111,31242208128,30463,30582,61045
ils,kroA150,40-70-47-51-49-43-72-67-134-139-50-60-66-141-147-142-118-117-123-128-69-65-64-55-138-71-73-140-130-57-115-125-145-146-38-120-131-119-114-122-127-135-42-45-54-116-56-144-124-68-113-143-63-39-53-137-132-149-61-59-44-58-126-37-136-133-52-121-41-129-62-48-112-46-148,84-100-102-32-75-94-7-74-96-25-3-18-78-17-83-9-5-91-79-30-88-104-107-80-24-86-8-6-33-82-11-19-76-109-90-20-35-98-101-110-103-23-0-28-13-99-2-26-85-34-22-97-89-105-93-21-15-87-16-14-10-31-108-92-27-1-81-12-36-4-77-95-29-106-111,32221698871,30463,30582,61045
ils,kroA150,40-70-47-51-49-43-72-67-134-139-50-60-66-141-147-142-118-117-123-128-69-65-64-55-138-71-73-140-130-57-115-125-145-146-38-120-131-119-114-122-127-135-42-45-54-116-56-144-124-68-113-143-63-39-53-137-132-149-61-59-44-58-126-37-136-133-52-121-41-129-62-48-112-46-148,84-100-102-32-75-94-7-74-96-25-3-18-78-17-83-9-5-91-79-30-88-104-107-80-24-86-8-6-33-82-11-19-76-109-90-20-35-98-101-110-103-23-0-28-13-99-2-26-85-34-22-97-89-105-93-21-15-87-16-14-10-31-108-92-27-1-81-12-36-4-77-95-29-106-111,33302184342,30463,30582,61045
ils,kroA150,40-70-47-51-49-43-72-67-134-139-50-60-66-141-147-142-118-117-123-128-69-65-64-55-138-71-73-140-130-57-115-125-145-146-38-120-131-119-114-122-127-135-42-45-54-116-56-144-124-68-113-143-63-39-53-137-132-149-61-59-44-58-126-37-136-133-52-121-41-129-62-48-112-46-148,84-100-102-32-75-94-7-74-96-25-3-18-78-17-83-9-5-91-79-30-88-104-107-80-24-86-8-6-33-82-11-19-76-109-90-20-35-98-101-110-103-23-0-28-13-99-2-26-85-34-22-97-89-105-93-21-15-87-16-14-10-31-108-92-27-1-81-12-36-4-77-95-29-106-111,39817254181,30463,30582,61045
ils,kroA150,40-70-47-51-49-43-72-67-134-139-50-60-66-141-147-142-118-117-123-128-69-65-64-55-138-71-73-140-130-57-115-125-145-146-38-120-131-119-114-122-127-135-42-45-54-116-56-144-124-68-113-143-63-39-53-137-132-149-61-59-44-58-126-37-136-133-52-121-41-129-62-48-112-46-148,84-100-102-32-75-94-7-74-96-25-3-18-78-17-83-9-5-91-79-30-88-104-107-80-24-86-8-6-33-82-11-19-76-109-90-20-35-98-101-110-103-23-0-28-13-99-2-26-85-34-22-97-89-105-93-21-15-87-16-14-10-31-108-92-27-1-81-12-36-4-77-95-29-106-111,40003201306,30463,30582,61045
ils,kroA150,40-70-47-51-49-43-72-67-134-139-50-60-66-141-147-142-118-117-123-128-69-65-64-55-138-71-73-140-130-57-115-125-145-146-38-120-131-119-114-122-127-135-42-45-54-116-56-144-124-68-113-143-63-39-53-137-132-149-61-59-44-58-126-37-136-133-52-121-41-129-62-48-112-46-148,84-100-102-32-75-94-7-74-96-25-3-18-78-17-83-9-5-91-79-30-88-104-107-80-24-86-8-6-33-82-11-19-76-109-90-20-35-98-101-110-103-23-0-28-13-99-2-26-85-34-22-97-89-105-93-21-15-87-16-14-10-31-108-92-27-1-81-12-36-4-77-95-29-106-111,39567870404,30463,30582,61045
ils,kroA150,40-70-47-51-49-43-72-67-134-139-50-60-66-141-147-142-118-117-123-128-69-65-64-55-138-71-73-140-130-57-115-125-145-146-38-120-131-119-114-122-127-135-42-45-54-116-56-144-124-68-113-143-63-39-53-137-132-149-61-59-44-58-126-37-136-133-52-121-41-129-62-48-112-46-148,84-100-102-32-75-94-7-74-96-25-3-18-78-17-83-9-5-91-79-30-88-104-107-80-24-86-8-6-33-82-11-19-76-109-90-20-35-98-101-110-103-23-0-28-13-99-2-26-85-34-22-97-89-105-93-21-15-87-16-14-10-31-108-92-27-1-81-12-36-4-77-95-29-106-111,36128054505,30463,30582,61045
ils,kroA150,40-70-47-51-49-43-72-67-134-139-50-60-66-141-147-142-118-117-123-128-69-65-64-55-138-71-73-140-130-57-115-125-145-146-38-120-131-119-114-122-127-135-42-45-54-116-56-144-124-68-113-143-63-39-53-137-132-149-61-59-44-58-126-37-136-133-52-121-41-129-62-48-112-46-148,84-100-102-32-75-94-7-74-96-25-3-18-78-17-83-9-5-91-79-30-88-104-107-80-24-86-8-6-33-82-11-19-76-109-90-20-35-98-101-110-103-23-0-28-13-99-2-26-85-34-22-97-89-105-93-21-15-87-16-14-10-31-108-92-27-1-81-12-36-4-77-95-29-106-111,31807269332,30463,30582,61045
ils,kroA150,40-70-47-51-49-43-72-67-134-139-50-60-66-141-147-142-118-117-123-128-69-65-64-55-138-71-73-140-130-57-115-125-145-146-38-120-131-119-114-122-127-135-42-45-54-116-56-144-124-68-113-143-63-39-53-137-132-149-61-59-44-58-126-37-136-133-52-121-41-129-62-48-112-46-148,84-100-102-32-75-94-7-74-96-25-3-18-78-17-83-9-5-91-79-30-88-104-107-80-24-86-8-6-33-82-11-19-76-109-90-20-35-98-101-110-103-23-0-28-13-99-2-26-85-34-22-97-89-105-93-21-15-87-16-14-10-31-108-92-27-1-81-12-36-4-77-95-29-106-111,33748572435,30463,30582,61045
ils,kroA150,40-70-47-51-49-43-72-67-134-139-50-60-66-141-147-142-118-117-123-128-69-65-64-55-138-71-73-140-130-57-115-125-145-146-38-120-131-119-114-122-127-135-42-45-54-116-56-144-124-68-113-143-63-39-53-137-132-149-61-59-44-58-126-37-136-133-52-121-41-129-62-48-112-46-148,84-100-102-32-75-94-7-74-96-25-3-18-78-17-83-9-5-91-79-30-88-104-107-80-24-86-8-6-33-82-11-19-76-109-90-20-35-98-101-110-103-23-0-28-13-99-2-26-85-34-22-97-89-105-93-21-15-87-16-14-10-31-108-92-27-1-81-12-36-4-77-95-29-106-111,31652705765,30463,30582,61045
ils,kroA150,40-70-47-51-49-43-72-67-134-139-50-60-66-141-147-142-118-117-123-128-69-65-64-55-138-71-73-140-130-57-115-125-145-146-38-120-131-119-114-122-127-135-42-45-54-116-56-144-124-68-113-143-63-39-53-137-132-149-61-59-44-58-126-37-136-133-52-121-41-129-62-48-112-46-148,84-100-102-32-75-94-7-74-96-25-3-18-78-17-83-9-5-91-79-30-88-104-107-80-24-86-8-6-33-82-11-19-76-109-90-20-35-98-101-110-103-23-0-28-13-99-2-26-85-34-22-97-89-105-93-21-15-87-16-14-10-31-108-92-27-1-81-12-36-4-77-95-29-106-111,33762835839,30463,30582,61045
ils,kroA150,40-70-47-51-49-43-72-67-134-139-50-60-66-141-147-142-118-117-123-128-69-65-64-55-138-71-73-140-130-57-115-125-145-146-38-120-131-119-114-122-127-135-42-45-54-116-56-144-124-68-113-143-63-39-53-137-132-149-61-59-44-58-126-37-136-133-52-121-41-129-62-48-112-46-148,84-100-102-32-75-94-7-74-96-25-3-18-78-17-83-9-5-91-79-30-88-104-107-80-24-86-8-6-33-82-11-19-76-109-90-20-35-98-101-110-103-23-0-28-13-99-2-26-85-34-22-97-89-105-93-21-15-87-16-14-10-31-108-92-27-1-81-12-36-4-77-95-29-106-111,39092765250,30463,30582,61045
ils,kroA150,40-70-47-51-49-43-72-67-134-139-50-60-66-141-147-142-118-117-123-128-69-65-64-55-138-71-73-140-130-57-115-125-145-146-38-120-131-119-114-122-127-135-42-45-54-116-56-144-124-68-113-143-63-39-53-137-132-149-61-59-44-58-126-37-136-133-52-121-41-129-62-48-112-46-148,84-100-102-32-75-94-7-74-96-25-3-18-78-17-83-9-5-91-79-30-88-104-107-80-24-86-8-6-33-82-11-19-76-109-90-20-35-98-101-110-103-23-0-28-13-99-2-26-85-34-22-97-89-105-93-21-15-87-16-14-10-31-108-92-27-1-81-12-36-4-77-95-29-106-111,35160928768,30463,30582,61045
ils,kroA150,40-70-47-51-49-43-72-67-134-139-50-60-66-141-147-142-118-117-123-128-69-65-64-55-138-71-73-140-130-57-115-125-145-146-38-120-131-119-114-122-127-135-42-45-54-116-56-144-124-68-113-143-63-39-53-137-132-149-61-59-44-58-126-37-136-133-52-121-41-129-62-48-112-46-148,84-100-102-32-75-94-7-74-96-25-3-18-78-17-83-9-5-91-79-30-88-104-107-80-24-86-8-6-33-82-11-19-76-109-90-20-35-98-101-110-103-23-0-28-13-99-2-26-85-34-22-97-89-105-93-21-15-87-16-14-10-31-108-92-27-1-81-12-36-4-77-95-29-106-111,31061175361,30463,30582,61045
ils,kroA150,40-70-47-51-49-43-72-67-134-139-50-60-66-141-147-142-118-117-123-128-69-65-64-55-138-71-73-140-130-57-115-125-145-146-38-120-131-119-114-122-127-135-42-45-54-116-56-144-124-68-113-143-63-39-53-137-132-149-61-59-44-58-126-37-136-133-52-121-41-129-62-48-112-46-148,84-100-102-32-75-94-7-74-96-25-3-18-78-17-83-9-5-91-79-30-88-104-107-80-24-86-8-6-33-82-11-19-76-109-90-20-35-98-101-110-103-23-0-28-13-99-2-26-85-34-22-97-89-105-93-21-15-87-16-14-10-31-108-92-27-1-81-12-36-4-77-95-29-106-111,34113238333,30463,30582,61045
ils,kroA150,40-70-47-51-49-43-72-67-134-139-50-60-66-141-147-142-118-117-123-128-69-65-64-55-138-71-73-140-130-57-115-125-145-146-38-120-131-119-114-122-127-135-42-45-54-116-56-144-124-68-113-143-63-39-53-137-132-149-61-59-44-58-126-37-136-133-52-121-41-129-62-48-112-46-148,84-100-102-32-75-94-7-74-96-25-3-18-78-17-83-9-5-91-79-30-88-104-107-80-24-86-8-6-33-82-11-19-76-109-90-20-35-98-101-110-103-23-0-28-13-99-2-26-85-34-22-97-89-105-93-21-15-87-16-14-10-31-108-92-27-1-81-12-36-4-77-95-29-106-111,30565993607,30463,30582,61045
ils,kroA150,40-70-47-51-49-43-72-67-134-139-50-60-66-141-147-142-118-117-123-128-69-65-64-55-138-71-73-140-130-57-115-125-145-146-38-120-131-119-114-122-127-135-42-45-54-116-56-144-124-68-113-143-63-39-53-137-132-149-61-59-44-58-126-37-136-133-52-121-41-129-62-48-112-46-148,84-100-102-32-75-94-7-74-96-25-3-18-78-17-83-9-5-91-79-30-88-104-107-80-24-86-8-6-33-82-11-19-76-109-90-20-35-98-101-110-103-23-0-28-13-99-2-26-85-34-22-97-89-105-93-21-15-87-16-14-10-31-108-92-27-1-81-12-36-4-77-95-29-106-111,27552587114,30463,30582,61045
ils,kroA150,40-70-47-51-49-43-72-67-134-139-50-60-66-141-147-142-118-117-123-128-69-65-64-55-138-71-73-140-130-57-115-125-145-146-38-120-131-119-114-122-127-135-42-45-54-116-56-144-124-68-113-143-63-39-53-137-132-149-61-59-44-58-126-37-136-133-52-121-41-129-62-48-112-46-148,84-100-102-32-75-94-7-74-96-25-3-18-78-17-83-9-5-91-79-30-88-104-107-80-24-86-8-6-33-82-11-19-76-109-90-20-35-98-101-110-103-23-0-28-13-99-2-26-85-34-22-97-89-105-93-21-15-87-16-14-10-31-108-92-27-1-81-12-36-4-77-95-29-106-111,31524728207,30463,30582,61045
ils,kroA150,40-70-47-51-49-43-72-67-134-139-50-60-66-141-147-142-118-117-123-128-69-65-64-55-138-71-73-140-130-57-115-125-145-146-38-120-131-119-114-122-127-135-42-45-54-116-56-144-124-68-113-143-63-39-53-137-132-149-61-59-44-58-126-37-136-133-52-121-41-129-62-48-112-46-148,84-100-102-32-75-94-7-74-96-25-3-18-78-17-83-9-5-91-79-30-88-104-107-80-24-86-8-6-33-82-11-19-76-109-90-20-35-98-101-110-103-23-0-28-13-99-2-26-85-34-22-97-89-105-93-21-15-87-16-14-10-31-108-92-27-1-81-12-36-4-77-95-29-106-111,34173116846,30463,30582,61045
ils,kroA150,40-70-47-51-49-43-72-67-134-139-50-60-66-141-147-142-118-117-123-128-69-65-64-55-138-71-73-140-130-57-115-125-145-146-38-120-131-119-114-122-127-135-42-45-54-116-56-144-124-68-113-143-63-39-53-137-132-149-61-59-44-58-126-37-136-133-52-121-41-129-62-48-112-46-148,84-100-102-32-75-94-7-74-96-25-3-18-78-17-83-9-5-91-79-30-88-104-107-80-24-86-8-6-33-82-11-19-76-109-90-20-35-98-101-110-103-23-0-28-13-99-2-26-85-34-22-97-89-105-93-21-15-87-16-14-10-31-108-92-27-1-81-12-36-4-77-95-29-106-111,36861640184,30463,30582,61045
ils,kroA150,40-70-47-51-49-43-72-67-134-139-50-60-66-141-147-142-118-117-123-128-69-65-64-55-138-71-73-140-130-57-115-125-145-146-38-120-131-119-114-122-127-135-42-45-54-116-56-144-124-68-113-143-63-39-53-137-132-149-61-59-44-58-126-37-136-133-52-121-41-129-62-48-112-46-148,84-100-102-32-75-94-7-74-96-25-3-18-78-17-83-9-5-91-79-30-88-104-107-80-24-86-8-6-33-82-11-19-76-109-90-20-35-98-101-110-103-23-0-28-13-99-2-26-85-34-22-97-89-105-93-21-15-87-16-14-10-31-108-92-27-1-81-12-36-4-77-95-29-106-111,30701021636,30463,30582,61045
ils,kroA150,40-70-47-51-49-43-72-67-134-139-50-60-66-141-147-142-118-117-123-128-69-65-64-55-138-71-73-140-130-57-115-125-145-146-38-120-131-119-114-122-127-135-42-45-54-116-56-144-124-68-113-143-63-39-53-137-132-149-61-59-44-58-126-37-136-133-52-121-41-129-62-48-112-46-148,84-100-102-32-75-94-7-74-96-25-3-18-78-17-83-9-5-91-79-30-88-104-107-80-24-86-8-6-33-82-11-19-76-109-90-20-35-98-101-110-103-23-0-28-13-99-2-26-85-34-22-97-89-105-93-21-15-87-16-14-10-31-108-92-27-1-81-12-36-4-77-95-29-106-111,28819422802,30463,30582,61045
ils,kroA150,40-70-47-51-49-43-72-67-134-139-50-60-66-141-147-142-118-117-123-128-69-65-64-55-138-71-73-140-130-57-115-125-145-146-38-120-131-119-114-122-127-135-42-45-54-116-56-144-124-68-113-143-63-39-53-137-132-149-61-59-44-58-126-37-136-133-52-121-41-129-62-48-112-46-148,84-100-102-32-75-94-7-74-96-25-3-18-78-17-83-9-5-91-79-30-88-104-107-80-24-86-8-6-33-82-11-19-76-109-90-20-35-98-101-110-103-23-0-28-13-99-2-26-85-34-22-97-89-105-93-21-15-87-16-14-10-31-108-92-27-1-81-12-36-4-77-95-29-106-111,32347356853,30463,30582,61045
ils,kroA150,40-70-47-51-49-43-72-67-134-139-50-60-66-141-147-142-118-117-123-128-69-65-64-55-138-71-73-140-130-57-115-125-145-146-38-120-131-119-114-122-127-135-42-45-54-116-56-144-124-68-113-143-63-39-53-137-132-149-61-59-44-58-126-37-136-133-52-121-41-129-62-48-112-46-148,84-100-102-32-75-94-7-74-96-25-3-18-78-17-83-9-5-91-79-30-88-104-107-80-24-86-8-6-33-82-11-19-76-109-90-20-35-98-101-110-103-23-0-28-13-99-2-26-85-34-22-97-89-105-93-21-15-87-16-14-10-31-108-92-27-1-81-12-36-4-77-95-29-106-111,34794382143,30463,30582,61045
ils,kroA150,40-70-47-51-49-43-72-67-134-139-50-60-66-141-147-142-118-117-123-128-69-65-64-55-138-71-73-140-130-57-115-125-145-146-38-120-131-119-114-122-127-135-42-45-54-116-56-144-124-68-113-143-63-39-53-137-132-149-61-59-44-58-126-37-136-133-52-121-41-129-62-48-112-46-148,84-100-102-32-75-94-7-74-96-25-3-18-78-17-83-9-5-91-79-30-88-104-107-80-24-86-8-6-33-82-11-19-76-109-90-20-35-98-101-110-103-23-0-28-13-99-2-26-85-34-22-97-89-105-93-21-15-87-16-14-10-31-108-92-27-1-81-12-36-4-77-95-29-106-111,34104252091,30463,30582,61045
ils,kroA150,40-70-47-51-49-43-72-67-134-139-50-60-66-141-147-142-118-117-123-128-69-65-64-55-138-71-73-140-130-57-115-125-145-146-38-120-131-119-114-122-127-135-42-45-54-116-56-144-124-68-113-143-63-39-53-137-132-149-61-59-44-58-126-37-136-133-52-121-41-129-62-48-112-46-148,84-100-102-32-75-94-7-74-96-25-3-18-78-17-83-9-5-91-79-30-88-104-107-80-24-86-8-6-33-82-11-19-76-109-90-20-35-98-101-110-103-23-0-28-13-99-2-26-85-34-22-97-89-105-93-21-15-87-16-14-10-31-108-92-27-1-81-12-36-4-77-95-29-106-111,30935506088,30463,30582,61045
ils,kroA150,40-70-47-51-49-43-72-67-134-139-50-60-66-141-147-142-118-117-123-128-69-65-64-55-138-71-73-140-130-57-115-125-145-146-38-120-131-119-114-122-127-135-42-45-54-116-56-144-124-68-113-143-63-39-53-137-132-149-61-59-44-58-126-37-136-133-52-121-41-129-62-48-112-46-148,84-100-102-32-75-94-7-74-96-25-3-18-78-17-83-9-5-91-79-30-88-104-107-80-24-86-8-6-33-82-11-19-76-109-90-20-35-98-101-110-103-23-0-28-13-99-2-26-85-34-22-97-89-105-93-21-15-87-16-14-10-31-108-92-27-1-81-12-36-4-77-95-29-106-111,32577939597,30463,30582,61045
ils,kroA150,40-70-47-51-49-43-72-67-134-139-50-60-66-141-147-142-118-117-123-128-69-65-64-55-138-71-73-140-130-57-115-125-145-146-38-120-131-119-114-122-127-135-42-45-54-116-56-144-124-68-113-143-63-39-53-137-132-149-61-59-44-58-126-37-136-133-52-121-41-129-62-48-112-46-148,84-100-102-32-75-94-7-74-96-25-3-18-78-17-83-9-5-91-79-30-88-104-107-80-24-86-8-6-33-82-11-19-76-109-90-20-35-98-101-110-103-23-0-28-13-99-2-26-85-34-22-97-89-105-93-21-15-87-16-14-10-31-108-92-27-1-81-12-36-4-77-95-29-106-111,44598965537,30463,30582,61045
ils,kroA150,40-70-47-51-49-43-72-67-134-139-50-60-66-141-147-142-118-117-123-128-69-65-64-55-138-71-73-140-130-57-115-125-145-146-38-120-131-119-114-122-127-135-42-45-54-116-56-144-124-68-113-143-63-39-53-137-132-149-61-59-44-58-126-37-136-133-52-121-41-129-62-48-112-46-148,84-100-102-32-75-94-7-74-96-25-3-18-78-17-83-9-5-91-79-30-88-104-107-80-24-86-8-6-33-82-11-19-76-109-90-20-35-98-101-110-103-23-0-28-13-99-2-26-85-34-22-97-89-105-93-21-15-87-16-14-10-31-108-92-27-1-81-12-36-4-77-95-29-106-111,37795375454,30463,30582,61045
ils,kroA150,40-70-47-51-49-43-72-67-134-139-50-60-66-141-147-142-118-117-123-128-69-65-64-55-138-71-73-140-130-57-115-125-145-146-38-120-131-119-114-122-127-135-42-45-54-116-56-144-124-68-113-143-63-39-53-137-132-149-61-59-44-58-126-37-136-133-52-121-41-129-62-48-112-46-148,84-100-102-32-75-94-7-74-96-25-3-18-78-17-83-9-5-91-79-30-88-104-107-80-24-86-8-6-33-82-11-19-76-109-90-20-35-98-101-110-103-23-0-28-13-99-2-26-85-34-22-97-89-105-93-21-15-87-16-14-10-31-108-92-27-1-81-12-36-4-77-95-29-106-111,44525227708,30463,30582,61045
ils,kroA150,40-70-47-51-49-43-72-67-134-139-50-60-66-141-147-142-118-117-123-128-69-65-64-55-138-71-73-140-130-57-115-125-145-146-38-120-131-119-114-122-127-135-42-45-54-116-56-144-124-68-113-143-63-39-53-137-132-149-61-59-44-58-126-37-136-133-52-121-41-129-62-48-112-46-148,84-100-102-32-75-94-7-74-96-25-3-18-78-17-83-9-5-91-79-30-88-104-107-80-24-86-8-6-33-82-11-19-76-109-90-20-35-98-101-110-103-23-0-28-13-99-2-26-85-34-22-97-89-105-93-21-15-87-16-14-10-31-108-92-27-1-81-12-36-4-77-95-29-106-111,35983988624,30463,30582,61045
ils,kroA150,40-70-47-51-49-43-72-67-134-139-50-60-66-141-147-142-118-117-123-128-69-65-64-55-138-71-73-140-130-57-115-125-145-146-38-120-131-119-114-122-127-135-42-45-54-116-56-144-124-68-113-143-63-39-53-137-132-149-61-59-44-58-126-37-136-133-52-121-41-129-62-48-112-46-148,84-100-102-32-75-94-7-74-96-25-3-18-78-17-83-9-5-91-79-30-88-104-107-80-24-86-8-6-33-82-11-19-76-109-90-20-35-98-101-110-103-23-0-28-13-99-2-26-85-34-22-97-89-105-93-21-15-87-16-14-10-31-108-92-27-1-81-12-36-4-77-95-29-106-111,30851014108,30463,30582,61045
ils,kroA150,40-70-47-51-49-43-72-67-134-139-50-60-66-141-147-142-118-117-123-128-69-65-64-55-138-71-73-140-130-57-115-125-145-146-38-120-131-119-114-122-127-135-42-45-54-116-56-144-124-68-113-143-63-39-53-137-132-149-61-59-44-58-126-37-136-133-52-121-41-129-62-48-112-46-148,84-100-102-32-75-94-7-74-96-25-3-18-78-17-83-9-5-91-79-30-88-104-107-80-24-86-8-6-33-82-11-19-76-109-90-20-35-98-101-110-103-23-0-28-13-99-2-26-85-34-22-97-89-105-93-21-15-87-16-14-10-31-108-92-27-1-81-12-36-4-77-95-29-106-111,29067756209,30463,30582,61045
ils,kroA150,40-70-47-51-49-43-72-67-134-139-50-60-66-141-147-142-118-117-123-128-69-65-64-55-138-71-73-140-130-57-115-125-145-146-38-120-131-119-114-122-127-135-42-45-54-116-56-144-124-68-113-143-63-39-53-137-132-149-61-59-44-58-126-37-136-133-52-121-41-129-62-48-112-46-148,84-100-102-32-75-94-7-74-96-25-3-18-78-17-83-9-5-91-79-30-88-104-107-80-24-86-8-6-33-82-11-19-76-109-90-20-35-98-101-110-103-23-0-28-13-99-2-26-85-34-22-97-89-105-93-21-15-87-16-14-10-31-108-92-27-1-81-12-36-4-77-95-29-106-111,28697887419,30463,30582,61045
ils,kroA150,40-70-47-51-49-43-72-67-134-139-50-60-66-141-147-142-118-117-123-128-69-65-64-55-138-71-73-140-130-57-115-125-145-146-38-120-131-119-114-122-127-135-42-45-54-116-56-144-124-68-113-143-63-39-53-137-132-149-61-59-44-58-126-37-136-133-52-121-41-129-62-48-112-46-148,84-100-102-32-75-94-7-74-96-25-3-18-78-17-83-9-5-91-79-30-88-104-107-80-24-86-8-6-33-82-11-19-76-109-90-20-35-98-101-110-103-23-0-28-13-99-2-26-85-34-22-97-89-105-93-21-15-87-16-14-10-31-108-92-27-1-81-12-36-4-77-95-29-106-111,36128172077,30463,30582,61045
ils,kroA150,40-70-47-51-49-43-72-67-134-139-50-60-66-141-147-142-118-117-123-128-69-65-64-55-138-71-73-140-130-57-115-125-145-146-38-120-131-119-114-122-127-135-42-45-54-116-56-144-124-68-113-143-63-39-53-137-132-149-61-59-44-58-126-37-136-133-52-121-41-129-62-48-112-46-148,84-100-102-32-75-94-7-74-96-25-3-18-78-17-83-9-5-91-79-30-88-104-107-80-24-86-8-6-33-82-11-19-76-109-90-20-35-98-101-110-103-23-0-28-13-99-2-26-85-34-22-97-89-105-93-21-15-87-16-14-10-31-108-92-27-1-81-12-36-4-77-95-29-106-111,33780763397,30463,30582,61045
ils,kroA150,40-70-47-51-49-43-72-67-134-139-50-60-66-141-147-142-118-117-123-128-69-65-64-55-138-71-73-140-130-57-115-125-145-146-38-120-131-119-114-122-127-135-42-45-54-116-56-144-124-68-113-143-63-39-53-137-132-149-61-59-44-58-126-37-136-133-52-121-41-129-62-48-112-46-148,84-100-102-32-75-94-7-74-96-25-3-18-78-17-83-9-5-91-79-30-88-104-107-80-24-86-8-6-33-82-11-19-76-109-90-20-35-98-101-110-103-23-0-28-13-99-2-26-85-34-22-97-89-105-93-21-15-87-16-14-10-31-108-92-27-1-81-12-36-4-77-95-29-106-111,30958956270,30463,30582,61045
ils,kroA150,40-70-47-51-49-43-72-67-134-139-50-60-66-141-147-142-118-117-123-128-69-65-64-55-138-71-73-140-130-57-115-125-145-146-38-120-131-119-114-122-127-135-42-45-54-116-56-144-124-68-113-143-63-39-53-137-132-149-61-59-44-58-126-37-136-133-52-121-41-129-62-48-112-46-148,84-100-102-32-75-94-7-74-96-25-3-18-78-17-83-9-5-91-79-30-88-104-107-80-24-86-8-6-33-82-11-19-76-109-90-20-35-98-101-110-103-23-0-28-13-99-2-26-85-34-22-97-89-105-93-21-15-87-16-14-10-31-108-92-27-1-81-12-36-4-77-95-29-106-111,30484497732,30463,30582,61045
ils,kroA150,40-70-47-51-49-43-72-67-134-139-50-60-66-141-147-142-118-117-123-128-69-65-64-55-138-71-73-140-130-57-115-125-145-146-38-120-131-119-114-122-127-135-42-45-54-116-56-144-124-68-113-143-63-39-53-137-132-149-61-59-44-58-126-37-136-133-52-121-41-129-62-48-112-46-148,84-100-102-32-75-94-7-74-96-25-3-18-78-17-83-9-5-91-79-30-88-104-107-80-24-86-8-6-33-82-11-19-76-109-90-20-35-98-101-110-103-23-0-28-13-99-2-26-85-34-22-97-89-105-93-21-15-87-16-14-10-31-108-92-27-1-81-12-36-4-77-95-29-106-111,30348284423,30463,30582,61045
ils,kroA150,40-70-47-51-49-43-72-67-134-139-50-60-66-141-147-142-118-117-123-128-69-65-64-55-138-71-73-140-130-57-115-125-145-146-38-120-131-119-114-122-127-135-42-45-54-116-56-144-124-68-113-143-63-39-53-137-132-149-61-59-44-58-126-37-136-133-52-121-41-129-62-48-112-46-148,84-100-102-32-75-94-7-74-96-25-3-18-78-17-83-9-5-91-79-30-88-104-107-80-24-86-8-6-33-82-11-19-76-109-90-20-35-98-101-110-103-23-0-28-13-99-2-26-85-34-22-97-89-105-93-21-15-87-16-14-10-31-108-92-27-1-81-12-36-4-77-95-29-106-111,30809626855,30463,30582,61045
ils,kroA150,40-70-47-51-49-43-72-67-134-139-50-60-66-141-147-142-118-117-123-128-69-65-64-55-138-71-73-140-130-57-115-125-145-146-38-120-131-119-114-122-127-135-42-45-54-116-56-144-124-68-113-143-63-39-53-137-132-149-61-59-44-58-126-37-136-133-52-121-41-129-62-48-112-46-148,84-100-102-32-75-94-7-74-96-25-3-18-78-17-83-9-5-91-79-30-88-104-107-80-24-86-8-6-33-82-11-19-76-109-90-20-35-98-101-110-103-23-0-28-13-99-2-26-85-34-22-97-89-105-93-21-15-87-16-14-10-31-108-92-27-1-81-12-36-4-77-95-29-106-111,30682320998,30463,30582,61045
ils,kroA150,40-70-47-51-49-43-72-67-134-139-50-60-66-141-147-142-118-117-123-128-69-65-64-55-138-71-73-140-130-57-115-125-145-146-38-120-131-119-114-122-127-135-42-45-54-116-56-144-124-68-113-143-63-39-53-137-132-149-61-59-44-58-126-37-136-133-52-121-41-129-62-48-112-46-148,84-100-102-32-75-94-7-74-96-25-3-18-78-17-83-9-5-91-79-30-88-104-107-80-24-86-8-6-33-82-11-19-76-109-90-20-35-98-101-110-103-23-0-28-13-99-2-26-85-34-22-97-89-105-93-21-15-87-16-14-10-31-108-92-27-1-81-12-36-4-77-95-29-106-111,29892752343,30463,30582,61045
ils,kroA150,40-70-47-51-49-43-72-67-134-139-50-60-66-141-147-142-118-117-123-128-69-65-64-55-138-71-73-140-130-57-115-125-145-146-38-120-131-119-114-122-127-135-42-45-54-116-56-144-124-68-113-143-63-39-53-137-132-149-61-59-44-58-126-37-136-133-52-121-41-129-62-48-112-46-148,84-100-102-32-75-94-7-74-96-25-3-18-78-17-83-9-5-91-79-30-88-104-107-80-24-86-8-6-33-82-11-19-76-109-90-20-35-98-101-110-103-23-0-28-13-99-2-26-85-34-22-97-89-105-93-21-15-87-16-14-10-31-108-92-27-1-81-12-36-4-77-95-29-106-111,31959552461,30463,30582,61045
